match_id_hash,game_time,radiant_win,duration,time_remaining,next_roshan_team
a400b8f29dece5f4d266f49f1ae2e98a,155,FALSE,992,837,
b9c57c450ce74a2af79c9ce96fac144d,658,TRUE,1154,496,
6db558535151ea18ca70a6892197db41,21,TRUE,1503,1482,Radiant
46a0ddce8f7ed2a8d9bd5edcbb925682,576,TRUE,1952,1376,
b1b35ff97723d9b7ade1c9c3cf48f770,453,FALSE,2001,1548,
19c39fe2af2b547e48708ca005c6ae74,160,FALSE,2063,1903,
c96d629dc0c39f0c616d1949938a6ba6,1016,TRUE,2147,1131,Radiant
156c88bff4e9c4668b0f53df3d870f1b,582,FALSE,1927,1345,Dire
df50f738c454d430a33b2bf90cb9ef1a,636,FALSE,2059,1423,
7469e9440ea3d19b211a484647c7126e,1054,FALSE,2287,1233,
0aa1c6d7630433a93fe42da5ac810368,1797,FALSE,2423,626,
892b5d40992e4b334e159f99b2bb55e6,605,FALSE,2508,1903,Radiant
44eb0c077ca68678bb9bfead29e9c455,1514,FALSE,2570,1056,Dire
eda82a5a0ae96848e73929c643925633,852,FALSE,2737,1885,Dire
ab3cc6ccac661a1385e73a2e9f21313a,721,FALSE,2705,1984,Radiant
a3c3892648b873bb869dd81ca0f62286,11,TRUE,2575,2564,Dire
34c81a8faede0d8f1f87dcc6ee824658,1362,FALSE,2330,968,Dire
5feece770ca79e5e8cd8052198b3f533,2388,TRUE,2763,375,Dire
54aaab1cb8cc5df3c253641618673266,752,TRUE,1685,933,Radiant
c95069179039952da9db7635ee22972b,2302,FALSE,2997,695,Dire
8f56cc2468ba5c37edb79f3a7b4af6e6,2043,FALSE,2878,835,Dire
171d8515f371cdf5d03c44575cee70c7,730,TRUE,1479,749,
44cdded6d3311134563f743eb77685b2,840,FALSE,2055,1215,Dire
086e5ed8fee6258a3b6ed9127f833573,1955,TRUE,2075,120,
b6f39b49177535c9417eecd8c696674d,342,FALSE,2697,2355,Dire
8ca9e390d39160645953a682a8d6f225,154,TRUE,1917,1763,Radiant
4b6e4e511d399180776d0f23984466b2,1249,TRUE,2895,1646,Radiant
fb4860c8425b62dbe413214beb6650c8,907,TRUE,2016,1109,Radiant
06b147af8683a7973e6f431c412448b7,655,TRUE,2351,1696,Radiant
7d30c0cc9a54fbf92d3fcddcab73d794,1465,FALSE,2426,961,Dire
64ed11373bcf2cfea7a60ede637b70d2,1654,TRUE,2179,525,
95a57e13d66411aa89e23c2dafa116dd,908,FALSE,1635,727,Dire
00a7f372afae35b59ce3819155d95318,2991,TRUE,3218,227,Radiant
bf366db368cc34b63235973dd3f50b0b,1079,FALSE,3374,2295,Dire
70e55187a655b6daacbf58a832d662db,79,FALSE,1156,1077,
a26ea6c7d63eb1df557dbcae742b4705,983,FALSE,2330,1347,Dire
88f9976aa7627b1f0d3e60d4b0483956,736,TRUE,1761,1025,Radiant
466e3043a03c98361c311c58d0ecbbf1,783,FALSE,1521,738,Dire
52691d68dd7b50eddb3092220d4aabb9,1460,FALSE,2091,631,
73669c2af74776b891fb94a1d1099d25,51,FALSE,1485,1434,Dire
fa72fbcde4aaf1023c3df5dc7d739674,293,TRUE,1377,1084,
7174c98d3b2e4ac2b9f5947935cbdd52,876,FALSE,1893,1017,Dire
3c666e1759bfab4467d11010983fb13e,19,TRUE,1780,1761,Radiant
4a0fdc67b9a1e360dae065ff12fade95,843,FALSE,2452,1609,Dire
ba1e963ea091e6af635dedd4ad2e9bbd,33,TRUE,1163,1130,Radiant
86d60b73cbfdbf0a6c291dad12d967f0,945,FALSE,1434,489,Dire
de41039149b7635840f90fc302548eb5,947,TRUE,1647,700,
28497cb3f04d45a272e8b7ed9c7199bd,897,TRUE,1245,348,
bb72d40b170659cafee461fe458b5331,379,FALSE,1249,870,
5b26efd8f4573da98d7a53e6eb3bfcde,1491,TRUE,1994,503,
9360b6c02ab8b2c1ffc719423c1ebdb0,464,TRUE,3268,2804,Dire
512c0d7cf0312c0767603dd77dc42581,353,TRUE,2988,2635,Dire
7849266871db9c0605bd33872a7643fa,593,TRUE,2568,1975,Radiant
fb5c712c74f8317689e7082416b90b77,1925,FALSE,2475,550,Dire
185cbad860e2632dc088d756e3e61a1a,2750,FALSE,2864,114,
2c6ea5bc1788fd5efc72fb741bb4f3b6,2576,TRUE,3336,760,Radiant
9d59ca0a4cb2514d10f5932fc2007bd1,105,FALSE,3234,3129,Radiant
2f07b1315b85521f9641dc4dfb72b4a0,1473,FALSE,2034,561,
dc777a69b5457e32f635827d5994ac20,483,FALSE,2328,1845,
e4bae80d0f728c1198c57c6e9de948a2,429,TRUE,3222,2793,Radiant
6d8926b8ad2843de397b6ef560b53466,1925,FALSE,2118,193,
5c4cd7ba5f0b31ded435690a2a596981,68,FALSE,1696,1628,
ee0df626563ce0e39d5cd039caf141ac,2130,FALSE,2452,322,
192f19f03feda5decffa47a9fbc6ba63,561,FALSE,1283,722,Dire
9a4de866c4e057ba4cbf1c2d79210e41,783,TRUE,2762,1979,Radiant
f0cfe3b5e56e8b2f0865dfb4be2ba23f,1570,FALSE,2337,767,Dire
fc817a3b4a4cf8269fa295c786c0b9fa,1214,FALSE,1839,625,
99f889e363118fc49c6c632aad683f18,1783,FALSE,2298,515,
9be7e4163e437ce3950b8d42b0c68756,213,TRUE,2337,2124,Radiant
981a0ab91d4648f75ed78f4173e8d201,2679,FALSE,2773,94,
c59f3f76dfc3a02b77f3d2814d9b4122,472,FALSE,1962,1490,
378200e56bbb733394b45a902c0bd01a,972,TRUE,1184,212,
a0d7a946c3e51ddc96ddb2c9348f3871,1331,FALSE,1765,434,
67bdabee790d3cf4dc8663d1831beb53,1881,TRUE,2991,1110,Radiant
f3398a77b495428fc23e7621af06a027,986,TRUE,2803,1817,Radiant
175ef2d5732f4526a08fd7352dabc27f,601,FALSE,1675,1074,Dire
425871da01ddd66e3831fb690089b889,1739,FALSE,2199,460,
a7808f7dc01a959e29c4946cc98e775a,48,TRUE,2208,2160,Radiant
5b6190e89e6947e064c1fd426213f8a0,2107,TRUE,5224,3117,Radiant
85519e14c42ea6a02d2d8c73a63d6b66,2524,TRUE,2810,286,
c43bb03dd85deb8bd927921bf8598a36,1954,TRUE,3460,1506,Dire
99386fd5fa5cfe926fc4344da562b1d4,803,TRUE,2488,1685,Radiant
0c189819d5bf45f817f77693f941371c,2718,FALSE,3287,569,Radiant
5673bf13c6ecc771fb56ba93789c71cd,54,FALSE,2490,2436,Dire
2392185f7a1b6fc35f761d2dc34423c8,866,TRUE,2178,1312,Radiant
4cbe5e5a1a2c1389d549d04e2e018a9f,898,FALSE,3307,2409,Dire
064522c97acf0d4b095d038c663374aa,1626,TRUE,2097,471,Radiant
1cfa44f46b5cc24d38723894ff4577ba,349,TRUE,909,560,
6f11117db84c0585ad2e792aeae191e9,272,FALSE,2257,1985,Dire
722d71f25c1d1fa1124580d3a78e458f,1037,TRUE,1142,105,
db13e824e8c7f64cd6cdd783437d1b5c,1297,FALSE,2359,1062,Dire
05c46e17555a38bf054bdc9d207f1cf7,1427,TRUE,1983,556,
1e4c98abfc97681f46916e92502ac2b4,369,TRUE,1590,1221,Radiant
7260c8e6db4177850c02fb9825095f5c,595,TRUE,1929,1334,Radiant
538af79dd08dc1e6e278c3709bc5a665,230,TRUE,2083,1853,
66a8e40f604d9735d4127d66a46e1b2a,2443,TRUE,2545,102,
f864a881742e71db5311fbf0bdc7af91,2128,FALSE,3159,1031,Dire
66bc5c7f6f510ff44060240f01e94365,578,FALSE,2498,1920,Dire
83097723ca023da3b686e71bca02af03,779,TRUE,2478,1699,Radiant
79a0d4fe6ea6e1de856aa20539d5613d,408,FALSE,1124,716,
0e8d0c9fee551abfb47e522f76019d07,343,TRUE,2557,2214,Radiant
3ce2d282e8bcdaad73df58fb6017084c,161,FALSE,2446,2285,Radiant
7b3a012c21d254b9d85da3f74d78eb81,1106,TRUE,3373,2267,Radiant
0087083e837c64c85a3b350a03aea77c,1863,TRUE,2389,526,Radiant
ad02fe6d15cf998d5cb8f4e369baa559,1020,TRUE,2706,1686,Dire
b1484adbcd7d87e617b8d54be560e27a,848,TRUE,2406,1558,
d818ef51c0f27ef602802a4615c8d413,403,TRUE,2464,2061,Radiant
e3b48a70597706fae9bf451e6c84e42e,1812,TRUE,2322,510,
a1cf47fe00e1b5083147e651d7e90c2a,945,FALSE,3075,2130,Dire
cd4a07c41ec7a3f1938505328c734764,3291,TRUE,3358,67,
10ca3074f6f359f541d9ccb3c0bbb836,1195,TRUE,1613,418,
0d3c92c117eaeeadafe8e16453a66ad6,224,TRUE,1772,1548,
725df7955b077ab96954a6f27572c692,359,FALSE,3022,2663,Dire
70a53f7135bfa6294db4d163c1c60a80,748,TRUE,2445,1697,Radiant
0ee9778bef0831ccc9a2685c28963268,2150,FALSE,3254,1104,Dire
7b10e0ca4a9d71ca1c5085144269d1c0,394,TRUE,2992,2598,Radiant
e659fd86dcdca602465475e9dba40c98,1429,FALSE,2725,1296,
805ac9c1a76befe4315611fa555fc835,1054,FALSE,1621,567,Dire
9b2c59c8277387ae5d6ac8c9755c66ac,440,FALSE,2894,2454,Radiant
2dc398548084ccd59cb99d297a964b11,451,TRUE,1922,1471,Radiant
8cf72eab00224d1c49308db67726ab36,1453,TRUE,2298,845,Radiant
5746237fe7dd146dc771457ac919c774,1300,TRUE,2100,800,
74e9fbfd6e7b3152a23aafbbdc96095e,875,FALSE,1175,300,Dire
ebf87c7f5a6d80a969c5e2747a2e820a,214,FALSE,2192,1978,Dire
63c878a241d7bd4ba730f2043e34aff2,1527,TRUE,1692,165,
8a03e2a2f073bc64a78abc17e1791d7b,812,FALSE,2673,1861,Radiant
3370cd0dd51e0d559e01d0c7eb83899c,448,FALSE,2285,1837,Dire
32fbdefe41f0a4ab5c2d52075d41fc11,612,TRUE,2020,1408,Radiant
5ed1a446802e6a5568abab8a9669dfc8,1792,FALSE,2809,1017,Radiant
64b048f27c482eb0326e35f5b45b18fa,1315,FALSE,2616,1301,
c413766ca083aa9eaacb7f034b9091ca,1146,TRUE,2036,890,Radiant
016d9bf9e16fe8fde4b3c131defb8c92,941,TRUE,2467,1526,Radiant
f763abaead5fb7927eb0a5d82fe2ba4d,513,TRUE,1816,1303,Dire
9eab012f84c7b1f1919f72561d651d5c,1112,TRUE,2898,1786,Radiant
1ede8f0feb1e359b31f22766bbe0b16e,456,TRUE,1535,1079,Radiant
b455849cea4881f6cdb3ca81390d51b2,1766,FALSE,3012,1246,
f4e3d0f8617e8199afbdde8426608d68,1161,TRUE,1762,601,
472940077c7210694e8fcc39549db64f,374,TRUE,3689,3315,Radiant
d301b179bfb15dac34fb7d2069618848,2039,TRUE,2197,158,
7660114b72980b7f221c77c027d84df3,459,FALSE,2547,2088,Dire
31b1133d5e4f20b046e5e0e93ee46ec9,710,FALSE,2600,1890,Dire
f9d0300634ffcf8524f167fdfd737f9b,531,FALSE,2678,2147,Dire
4187345a1502af2e1ca95e4a50b4ad69,3135,FALSE,4294,1159,Dire
0c9e71953f91ea8de1f48121ab50afc3,466,TRUE,1798,1332,Radiant
7fb0c59ca677c3a175d8161b8cb13171,954,TRUE,2183,1229,
010bc4bf10a83615d964bba1ccc76ee6,1868,FALSE,2624,756,Radiant
3e4dcc124fe29202f416bd9bd8f04fa0,654,TRUE,2789,2135,Radiant
fd3431257370562fd1f73739885fb3cb,2224,TRUE,2941,717,Radiant
479e0ad44e584c0a8fdacbbc225a37df,693,TRUE,1882,1189,Radiant
426bfc428690bd0b654ed9c356751569,339,TRUE,1688,1349,
6862606271bbe62b5834103a78fb53ae,1019,FALSE,2971,1952,Dire
14b7d952e2b56c958d667be1f39f5449,1207,TRUE,2464,1257,
2ba3224bbc1555796df897686e14b5a2,1018,TRUE,3015,1997,Dire
f6ea95c12693e23be626c7571e922e82,685,FALSE,2034,1349,Dire
d4b157ff19199a099781383fed871827,280,FALSE,1225,945,
f90b9aa9cf5121e82b135e17c6ec32d9,1526,TRUE,1913,387,
0466d4054a8a97f5f57155e5e64c1835,443,FALSE,1793,1350,
fbd6fc91cead51e3fd636ff9e773971a,936,TRUE,1793,857,
3e1cb18af167d5c2b308f20e14d6a1d3,132,TRUE,2671,2539,Radiant
145f7a41cb72d100295a77d34449c7a5,751,TRUE,2634,1883,Radiant
26711191d93e8c6e931d05205d0f7fae,1049,TRUE,1306,257,Radiant
1c25f2b89164efac5a21210ef7b1401a,1721,TRUE,2591,870,Radiant
e97946b45942561eee3c883fc3620312,2232,FALSE,2629,397,Dire
dd76829c265a4ba157999150bd1bfa59,1756,TRUE,2844,1088,Radiant
4e1c417fd78deb193c08d3c9194e4b9c,387,TRUE,2340,1953,
821996195bc1fb30e8db37338651d8b9,1336,TRUE,1740,404,Radiant
46deadc43f0efb0b7fc3640570b46891,20,FALSE,2918,2898,Radiant
f77e8c3c5125cbc2607fac2c26579ec1,471,TRUE,2833,2362,
ea161e11da4611f76e592e3a2d64f253,416,FALSE,2225,1809,Dire
27796de9f4734fd5be9bc17fc8ba4c7f,2346,TRUE,2451,105,
66569c243b1aca38af58bfdcda654270,1444,FALSE,2642,1198,Dire
e92e62b67fefc3c141654f4cdd456ceb,654,FALSE,2683,2029,Radiant
9e2a74f506de0d01f9aafa8aae5e92d6,2100,FALSE,2994,894,
a414c7c2db5974046783e51d9c91cc75,2065,FALSE,2426,361,Dire
6c3538012f41562fe32a1b397252ab8a,1844,TRUE,3005,1161,Radiant
c4ec635e97e638b31fbee8b41351571c,267,FALSE,1302,1035,
7dd4918869c16efc9c8527391190eadb,727,FALSE,3114,2387,Dire
8a5b78b997da877c096f7562c9055bf2,1423,TRUE,2771,1348,Radiant
5174a13f46a5da74e352757ba4f153db,1686,FALSE,2656,970,Dire
ea3bfaa08b0434a5a49b73f54e2fbb48,1504,TRUE,2870,1366,Dire
31a0cb339bc65d31b934c7febb046b11,628,TRUE,1122,494,
bdf63399b9f40c2c7468c6b6dd7f6dba,1645,FALSE,1890,245,Dire
fa299fc1a4cf09fcd059a14efc5be57b,1000,TRUE,2928,1928,Radiant
0c2621c8f4ba7ba2f69bb509bf464188,183,FALSE,1980,1797,Dire
45981b3c411cc54e2fb223b14d80c50e,2474,TRUE,2549,75,
6bc1f7cfb85a3a1ce2499b3551f033c3,1734,FALSE,3418,1684,Dire
1ad7b78baa8bef4a1a5c63618eec3db1,1185,TRUE,2670,1485,Radiant
4fed1358c64e16de48ac89239b70d34b,617,FALSE,2136,1519,Dire
e4bbf14fae3a6cfd9b7166e229a95c1d,2043,FALSE,3347,1304,Dire
aef47b238d7a0eab38d7607bb47f1f9f,259,FALSE,1500,1241,Radiant
de7e6cee4f3b21730b45ce53d53d0a15,1674,TRUE,2866,1192,Dire
e38161118300164767f121062bfce7d2,73,FALSE,2211,2138,Radiant
28ff73e3c8c30894927540e6eae5e5b0,2166,TRUE,4115,1949,Radiant
286db67143d193feba1a54ab3c428d44,1747,TRUE,1885,138,
8224f5b34b1bd0ef8506aab25323fb02,893,TRUE,3360,2467,Radiant
b47b0bd8abcf5267755f2d15b7497126,647,FALSE,2538,1891,Dire
fe71bed4ba371289748188b7063a328d,1825,TRUE,2287,462,Radiant
e5b286fa3c2280ae59c0ff037d224dc3,1014,TRUE,3134,2120,Radiant
392c7d590ad98921dfc332a33ed0c31a,2087,FALSE,2461,374,Dire
cc0ec03becbaa45fa9ada0e1a17a20b0,2463,FALSE,2726,263,
c84253e53c3adca1f8503ce7b395c8dd,101,TRUE,2777,2676,Radiant
bab3575d65310b2595fee1a39bd89bba,2035,TRUE,3035,1000,Radiant
af003223961c99491db921cde5266939,889,TRUE,1888,999,
a02c196ce995b9c6a8063fddaabb1477,1349,FALSE,3611,2262,Radiant
d9b103a0e0b8737dff4b447a3695797f,370,FALSE,2033,1663,
beb246c40bccb39568237c22d7111db5,3281,FALSE,3573,292,
3a44f60bb3fb060a9fe577f57863e040,84,FALSE,2626,2542,Dire
b3fbab3f691e272463191689de373c6b,1631,TRUE,1723,92,
268fe6511b44a03324567b501dab3cd5,951,FALSE,2353,1402,Dire
b937cb93a26c4555d6ebea1c7485954d,144,TRUE,2730,2586,Dire
7b7013fa001801db7a8747a28a2444bc,1966,FALSE,2604,638,Radiant
3f8585570999ad627a78ebad8154a1cb,2172,FALSE,2278,106,
65cb39781bcab33c5424cc01519f0d76,1222,FALSE,1601,379,Dire
a5c10d72f7f5963db298d1941fc2983e,529,TRUE,2257,1728,Radiant
76402e0c2ed9087128c1909e45c8ab63,992,FALSE,1877,885,Dire
256929a6703fcf148a517e28212ec4a5,1736,TRUE,3101,1365,Radiant
b7cadbcde9890157b8095e8b4b7be865,97,TRUE,2305,2208,Dire
a5073cd096c5bdf39e7d70967fc1308f,386,TRUE,1476,1090,Dire
38b02dc4fe0980499575a571973c685d,218,FALSE,2613,2395,Radiant
eff4676ed5fa447bcf2f38b3b984d146,64,FALSE,2995,2931,Radiant
0d409a74fa1b28732b4be32bce57de03,1953,FALSE,2523,570,
b45303a7c32482ed144c19caede15e5a,2,TRUE,2713,2711,
6bd07c1f8c559366bfa713f58aae4237,2136,FALSE,2565,429,Dire
58c64ca512859cd04ae85576eae06ad0,46,TRUE,2179,2133,Radiant
2a8cfa86ec3b30e850b1f0535c99423f,247,FALSE,1912,1665,
50cca51c33f1e9e1a42ca6a2710be5c8,143,TRUE,2304,2161,Radiant
9900dc79024e093f0b9056052f1da0d6,2582,TRUE,3006,424,Radiant
269100ae152b0eab85527c0f3b85698d,1308,FALSE,2449,1141,Dire
19d9745159fdc0ed5cb0de03eeecb6d8,564,FALSE,1695,1131,
37c174c8b2994747ea473c5ed2806602,1482,FALSE,2750,1268,Dire
2e25bb7ec562fc5bc5c380e678f52728,2370,TRUE,3556,1186,Radiant
4a33b141cb7c95b8dc9307b83d65a38a,1927,FALSE,2545,618,Dire
41ce21895f17289b4950d2fda3c4840b,1166,FALSE,2936,1770,Dire
6ebf9cf9e5b41c7909e456701a02d360,1401,TRUE,2254,853,Radiant
db26256c3b6110de1eb5c4767ce4ab7f,1046,FALSE,3240,2194,Dire
32a2f85286a8c08697d149f6f2cb70dc,1204,TRUE,2302,1098,
a71642198d0c13d728a69ec4c78822eb,282,TRUE,1644,1362,Radiant
6915da2e9f80b2e2dd52d70b0da83d69,2096,TRUE,2174,78,
3490fee5a7788580c590fa7d0e093fd5,291,TRUE,2146,1855,Radiant
176a66aeaf8d469a1cd611495e45b552,1812,TRUE,2680,868,Radiant
1a2d413193660a85ea7e1a30b15e114c,13,TRUE,1336,1323,
5007552953e0186492a0ced4887f8ca3,1204,FALSE,4000,2796,Radiant
fc9d9971626811d8f030658c5364c954,2131,FALSE,2167,36,
a67e948605ea0bd87dbe4296b1fff71b,1026,FALSE,1845,819,Dire
c0f243c3357bde1b86f80bb3234f75ef,1603,FALSE,1861,258,
016b8834fbfa7f3fb35af9e717e0ac88,2811,TRUE,3646,835,Radiant
1c2b9621224c47a35c535e148c063282,866,TRUE,1176,310,
d881350b21966eac19058631b3649e8c,469,TRUE,1742,1273,
3843706882db9886150ef62d6f9a8c2e,1614,FALSE,2027,413,
5037abd7f3b63f55504b673543bc0061,632,FALSE,2831,2199,Radiant
8d24a69ea600421e4ee1f58ac65a258c,1298,TRUE,2768,1470,Dire
80ef18a6b007097b453d5439af2a7fd8,1206,FALSE,2357,1151,
332e70cc18aa4e1305cdff944f71f9ca,42,TRUE,1749,1707,
27f84f3e190229b68e839537786ef036,1196,FALSE,2219,1023,Dire
430a5b1efde5ac035b6e20fb4bcdfc0b,1806,TRUE,2059,253,
1fe5cff3fb0a46fdd6b0d4fbc73b36a9,382,TRUE,1255,873,Radiant
4a7b87106b087d95a8702eb7f297aeb8,1321,TRUE,2445,1124,
51f3afe8caa5acb37df0332349b41118,2090,TRUE,2439,349,Radiant
2f43464e194daf13040145156329a85a,2283,TRUE,2803,520,Radiant
48a90c042d2611dfcbacb84a342d5fb6,738,FALSE,1786,1048,
b62cde8f18f9929c3bc152021c96c065,997,FALSE,3501,2504,Radiant
967aaa92c33f2a35a16819f13b8c2cfe,2606,TRUE,2858,252,
382d355f0534cc601ef9e60a99c3ac09,1590,TRUE,2382,792,Radiant
143d7bfa701870c6065a667f3a7daaed,1494,FALSE,2164,670,Dire
d881c46fc08bf4db47637be04603d733,1414,TRUE,1630,216,
ea4013ff3dd91d38c20f48b50af5fe3f,351,TRUE,2478,2127,Radiant
7a66306f67cd0b4f2b5db56d56d9cee9,2911,TRUE,3458,547,
f8179ec212c6cdce11f7b6ea31b4e2e8,1720,TRUE,1982,262,
ccc7a92f66c3e50aae4337e4130f129e,413,FALSE,1108,695,Dire
e7203edc3090d25c1b598973c3b4319e,676,FALSE,2515,1839,Radiant
aa0f9e8136cbcbcb3fabbb55fdee91af,2118,FALSE,2608,490,
c90e0296af0670931629758188e86a68,871,TRUE,3259,2388,Dire
2d834c67f70fc56d15dee59c31277439,1590,FALSE,2313,723,Dire
f79df2d9ee2a540ef76e385723a96203,1405,TRUE,2130,725,Radiant
f63ee445d75e6369d75af3fa017c0c64,1724,FALSE,2535,811,Radiant
e24b4c5d7a2dee38693a11cbc89c2c53,229,TRUE,2013,1784,
2ceaa6db32aa66fb840368e72541a503,2934,FALSE,3490,556,Dire
658e7f29180f2a000f4f4b92f8d1fa76,829,FALSE,3051,2222,
8884cbfa43dea039949443be25b6b555,453,FALSE,3164,2711,Dire
141f7b617c8b88da3efe0b635c826961,1315,FALSE,3505,2190,Dire
dc2f79e7c3c62ce4254cdb820fc710be,940,FALSE,2230,1290,
f3faeb950682e829f544a07e76eae585,65,TRUE,1687,1622,
6dca6403b6f7821c630a51ae39d81df4,197,FALSE,4411,4214,Radiant
9deb85054ab19982dc5f15d989182889,2188,FALSE,3106,918,Dire
15f0a9da2b319359f1f13ff55affed73,909,TRUE,1151,242,Radiant
73c4be19e47602e6bf5f9b56241d7b80,140,TRUE,1287,1147,Radiant
4dfc674ce768b2138ea703326c19f03e,782,FALSE,1737,955,Dire
5f359139fc6399d1ca03624ca04e4003,2505,TRUE,3410,905,Radiant
cfb7c889a0da5179289d743cdac7d0ce,496,FALSE,2110,1614,
127ffbe88e68fc8da82f32b4b7e03633,211,FALSE,1611,1400,
2a1d4ab45275500baa37f00c3475d7bf,439,TRUE,2093,1654,Radiant
9b9d341fe9d8825c52c61ec569db5d18,1992,TRUE,3173,1181,Dire
f6fe5ab1ee83f222101d4277b2c331f2,185,FALSE,2214,2029,Dire
47fed371f15a7dc6d43086fc277c0219,1151,FALSE,1876,725,Dire
cf25f8486f84fdb256191a8763a7862f,1606,FALSE,1884,278,
e4bdd463742505dc086538da267c2389,1250,FALSE,2765,1515,Dire
962bfa61e7d3898369599fdacfda6ae5,318,FALSE,3153,2835,Radiant
4190ad326531011468394bf573dd864d,999,FALSE,1827,828,
f7c0cf3232c7d8437e13150cb172a978,632,FALSE,2369,1737,Dire
d99b6c17b41e568629732d9c90c12925,1857,TRUE,2862,1005,Radiant
2bf353b6c72c7e52e4f72ca6d480d649,2409,TRUE,2881,472,Radiant
48aeed38ce0c46c4a001ccb78893a782,2982,FALSE,3029,47,
ccc1d103c5296e22799aefe3a24e8b22,1359,FALSE,2088,729,Dire
d8938ee35236455be59cf0c7c01dca98,1766,FALSE,1996,230,
002f0606307d1c6a8ce8f758bc4c393e,1364,TRUE,2815,1451,Radiant
d1e2d585035867ee6e282c28a7b50b4d,1427,TRUE,1634,207,Radiant
3eabf3dc40840216eb9e1fcae670fc9c,1233,TRUE,1493,260,
0fc18a053ec4d6b8d47f6765138b3abf,757,TRUE,2519,1762,
1571df25856a6114a395a8a99c4c9f1f,1736,FALSE,3358,1622,Dire
3f4029527b7dd629a7aab0c4a10070db,700,TRUE,2968,2268,Dire
f00260a04b263213e3ea9acecb9eb625,1514,FALSE,3303,1789,Dire
c6ecd2e4b3b41719b9da85b7cea2cab0,1477,TRUE,3426,1949,Radiant
0e0a37be3f8181e22726d43a20fe727b,1193,TRUE,2017,824,
b575726ca7b2a4ae8c65d433caee7031,947,FALSE,2211,1264,Dire
54db5ff9e4ceb9fece39dd114d34133f,286,TRUE,1797,1511,
9911683003aca26475cbd8f5cf70a026,1346,TRUE,2529,1183,Dire
b5d94591057ca6f54f74e1de0393b6c1,1213,FALSE,3990,2777,Radiant
bef03b606974e105133405159afcc79b,1268,TRUE,1844,576,
19c1b810b3564d90fe329c06fd6aadfa,1390,TRUE,1554,164,
acd92e424ec601e174b33e2a5ababca7,2504,TRUE,2957,453,Radiant
256663776a4981e3a28b1ea7a9354cd1,2848,FALSE,2922,74,
4dc478bb52709f45d0f873a8b465841a,1860,TRUE,1991,131,
55ad79bab535399be546cb7582543c50,1630,TRUE,2504,874,Radiant
7e9ee83a71001fec75bacbe4d61b2724,147,TRUE,2802,2655,Dire
d25c4c9a96c6fb228325567c35fa51c1,2054,TRUE,2527,473,Radiant
459d003a1e1c354d957715f00eafc5ba,2008,TRUE,2546,538,Radiant
0e88e491feecdbd48bc79838a8dd42c7,1,FALSE,2222,2221,Dire
de42e8a532ec83d1f3cb4fe3ab5cb7f9,1077,TRUE,3145,2068,Radiant
51d1608d5d667f067fd5fccbdd8d1708,2545,FALSE,3181,636,Dire
b197da66e9cadccde114276067812833,2410,TRUE,3160,750,Dire
0d53ea909761f110538fd91f1ec56827,508,TRUE,3734,3226,Radiant
f5fcd6f0d0d3f7d6d381ae4615913246,266,TRUE,2589,2323,
4dde40ef95acad814f841aa904852d7c,135,FALSE,1958,1823,Dire
c9eb02449db417696b713753ce4ab29a,558,TRUE,2019,1461,
8131061a5ff47b3e7d4a288691312e40,1031,FALSE,2778,1747,Dire
7ebc8689220ee04c824839225885c65b,1298,TRUE,1688,390,Radiant
b974c90b43ef81ff455a715ef3c9d66e,2166,FALSE,2201,35,
15e3763a9ff37509edcbdbc2368fba88,1190,TRUE,3462,2272,Radiant
1b5b4760c8224c1be6556eca1b116404,1846,FALSE,3262,1416,Dire
71f6335e0336d1594b8b3ab8fc9be861,776,TRUE,1066,290,
45b318c7afefddc4336188732b812be0,661,TRUE,2145,1484,Dire
cad7b9cb5da81b01f35edcceeff0479a,1917,FALSE,3014,1097,Dire
85dc156b544c955fd3784bda48d3d256,325,FALSE,1183,858,Dire
7ae4e953dd91048f87aa8a99c02affa6,319,TRUE,2346,2027,Radiant
bba0c1b151a9f253aee00a912cb8540c,155,FALSE,4470,4315,Dire
70d55b0103eb2abfcc5b4254b6e5f640,1360,TRUE,2554,1194,Radiant
d2ecc0ab51a05ecad6850bf8ce2cde9e,154,FALSE,2220,2066,
4eae28b2aa9cc8013f4ec89f96b289d1,439,TRUE,1512,1073,
74a382969bf4643e186cdf69e332b22a,569,TRUE,2681,2112,Dire
df4eedeab2039dd3583be3160756bfd2,786,TRUE,3071,2285,Radiant
dfd38d2c175f1ea812c6851caf80f832,1824,TRUE,2886,1062,Radiant
2ef6ba28b7ceb5ec3b162fd7074d45eb,941,FALSE,3299,2358,Dire
b0af18875958257ff3c935269278636a,790,TRUE,1267,477,
bd18ff3147f0a47d5ec8f6fee31d22e2,736,TRUE,1828,1092,Radiant
6ca41da8e5576b5b472a93fdc2b13768,1986,TRUE,2770,784,Radiant
768dfa7b47c4d77fdf0c4b2b2e522e50,2019,TRUE,3500,1481,Radiant
76537899a81b7279b55cb632c92145c1,542,TRUE,1883,1341,
04bb8538ed68d9e969b598a17b8e3685,1498,FALSE,1969,471,
2a52e2735d47201d29370d1936704d20,1425,TRUE,2563,1138,Radiant
e7091926ebd92a9645f30c51d5dffc69,1664,TRUE,2188,524,
e3353c3b133cd541087ee3ea8b667739,2163,TRUE,2522,359,
f864454e2461ad959b8d57433d27a7f0,1991,FALSE,2473,482,
7999a4403b40e1c0aa4fbd07ffacd50f,1062,TRUE,2296,1234,Radiant
c249f052dcec8b481c5f226aaa9148fb,214,TRUE,2885,2671,Radiant
05d8612536c04307b54eb18c1b9e2c10,1053,FALSE,2844,1791,Dire
a8802f84f74c4bd1ed14be6ee54e4b1c,62,TRUE,2110,2048,Radiant
4000949298b2588a9d043299efbb88aa,1724,TRUE,3212,1488,Dire
ceaec1f1d4e6a27e3085d9577d074323,1966,FALSE,2130,164,
42042ddd7e409ef335f6477bc8e0c17b,855,TRUE,2599,1744,
8c5bfacc78c87739088e841c094375c4,1597,TRUE,1859,262,
ea616b5c7e10c9da6733889ce2a8efcb,2715,TRUE,3880,1165,Radiant
8c1f2e056aaed68c89b2e2c824799d73,1334,FALSE,1928,594,
dd00b6b31665551f2c3588f881317d84,164,TRUE,2073,1909,Radiant
f00298cf7fe6ab211be89bb03b47f504,184,TRUE,1007,823,
424a64f6acf84b3bd9cd29fe9bedd6ad,1453,TRUE,2048,595,Radiant
e6c35f367f7e11b92a55d13ed03afcd0,1110,TRUE,2703,1593,Radiant
c8c0ab514a65f83821bca7355d87cc4a,2146,FALSE,3155,1009,Dire
8e855950e9a39a4be7bcbd16bd9dd065,2239,TRUE,2289,50,
5489c0073a09be41ac9e24945dfa8c67,422,FALSE,1878,1456,
f6197b6396255e781432aeeb0a292baa,1466,TRUE,4107,2641,Radiant
fd64860038182d9ea4ad97094b06faa3,1348,FALSE,2211,863,Dire
2e745c67f04cb18cfe3fcc54e5cc2875,3120,FALSE,3537,417,Dire
ab083bfa47e29df89f8e6e4397782e5e,465,FALSE,1452,987,Dire
e73cd9ece2e74a9f33fb3a059ffa47d2,157,FALSE,2324,2167,Dire
56895693061772ab7c7225dabd9dadac,16,TRUE,2702,2686,Radiant
a5c8d8ec8a4a13195a03eaf52bf52408,2038,FALSE,2856,818,Dire
d2b159afc02bf4eeabc4015df171022f,1097,FALSE,1500,403,Dire
e3c0f2db8a703c0577afc9d712514131,19,FALSE,1369,1350,
a927d94d1bcd8e1718015f1600a92dd9,1251,TRUE,1315,64,
77ddb0ebfd493fe95e25c0832f4200b4,919,FALSE,2998,2079,
64bead429de2fb50dd5fba054cd35e7e,1011,FALSE,2473,1462,Dire
1cae5ff5d1740f4dddae6e3bfae2fb73,935,FALSE,2544,1609,Dire
5e266c9e45351a6fa682bcb0c83ad39d,1097,TRUE,1134,37,
5cb57d31a3a03dad454692fb6866b565,290,TRUE,2248,1958,
d987e3ddd897b795aaa4a6ab83fdac45,1168,FALSE,2332,1164,Dire
addf5de4066467e4fe6b989018f5dd40,1387,FALSE,2220,833,
c9a0c12a9e6ebf7da054a37bb115d63a,1503,TRUE,1932,429,
c374c7652db409098d0536ceab4b840c,237,TRUE,1020,783,
52b46c3e23280d8d477ca097f99fc8e6,450,TRUE,2079,1629,Dire
b8925af5114868d52a8780801de0be7a,85,FALSE,2973,2888,Dire
810d199f10d63e7e37f4995c811ab9c2,879,TRUE,1885,1006,
7481693b40d844f86d822f54b26a793a,768,TRUE,3266,2498,Radiant
e95d22270b5035148d4119ea61281b52,45,TRUE,1910,1865,
a8dcbfca3a54f9123ead128175eb47ca,567,TRUE,2312,1745,
a1e77f8fcf7a646432994e9621003bd5,162,FALSE,3123,2961,Radiant
bcca4bb385edc6f41701b9973ad94031,1485,TRUE,2550,1065,Radiant
32458686001a090dd31d343be0bde7d1,2181,FALSE,2412,231,
15d296497056608f996bcfc18bdc6c6e,1316,TRUE,1489,173,
2ab3f3ad6293a6148529ed7638973b3f,360,FALSE,2248,1888,Radiant
9aed17c621da6b7f12db8dcfe5c8e4b3,1289,TRUE,2365,1076,Radiant
5a9884312f7f681fcccb9eda4988a256,239,TRUE,2710,2471,Radiant
a15ccf3e020d5622a4d2f742621a88fb,1232,FALSE,1281,49,
cd9e77dacd231c34f6d4ab00beed2d97,2256,TRUE,2398,142,
256d501cd1a3443353424f28694cc229,546,TRUE,1113,567,
b85076d5ff3d7e4a46ac7bb1b942d00a,2691,TRUE,3424,733,Radiant
d946c8fb0328503a0211a7d8d754b88b,1319,FALSE,2025,706,
f7e00ba284e6ffad003cd9e44aea4ad9,942,TRUE,2354,1412,Radiant
3c4caf23c595a9c2310eff087c69806b,957,FALSE,2789,1832,Dire
3dfd10252b81a9c3bfe9421a7b0618e7,685,FALSE,957,272,
be9a8bb7a37c95cdce6ad7a32064520c,698,TRUE,1811,1113,
82d54d36fd0b211b492c0ae8e185e6db,1534,FALSE,2065,531,Dire
f383777b80935fbdb1dbd997c5e35edd,1946,TRUE,2128,182,
9936eab6620532c81e79e47657d81317,454,TRUE,2046,1592,Radiant
1ee4d158a18aac0b18093a2084cc67a8,2055,FALSE,3404,1349,Dire
998c46074ad02dac341a28b211eb49d7,2058,FALSE,2571,513,Dire
7ab51ebeec6a40b7326a05b1ddb48c3d,397,TRUE,2216,1819,Radiant
4fe77bdc469ca36261ed7d6be2fc5b77,730,FALSE,1903,1173,Dire
3a8e2fd2052d00e3bc60ad95e61bb0c7,3008,FALSE,3826,818,Radiant
3bfafce2922662699843a6faabaada6a,61,TRUE,1715,1654,
cb8782d6c6bc0398c228625c20617d04,2,FALSE,1311,1309,Radiant
f6bf05ae574962882613d6d4a484f94f,2338,FALSE,3043,705,Radiant
e494be6e55a60451dc75caf46d5cfc51,45,FALSE,1987,1942,Radiant
bb363351591d8aeb8f6186b6b749801b,2068,TRUE,2607,539,
2dc0ffe8998c5c9f9c174c55fa5ddf92,24,FALSE,1168,1144,Dire
ebdce0254ca38eada455afdb10db595d,1072,FALSE,1872,800,Dire
62dcef955977e1cbdfe6a6831b542b01,491,TRUE,2451,1960,Radiant
fef511ddcebcf16043bf7be1d04c20f1,1754,TRUE,2130,376,
0a88e5ad93a324493689779e0db31afa,11,TRUE,3437,3426,Radiant
18cfdbf55cf1212829afce951cf38457,1526,TRUE,2905,1379,Radiant
814279f26875d21d4982b92831ce221a,998,TRUE,2089,1091,Radiant
0deb0895c99d4c66781a98e7437f3684,1746,TRUE,2361,615,Radiant
75d6bdd631b3573f6f7ecf8e48eb0a71,1001,FALSE,2362,1361,Radiant
dc01a18a241363ddb5fd98442d5e59d3,635,TRUE,3303,2668,Radiant
b6a634402bd5612ce12645b3387ee99a,742,TRUE,1044,302,
b850a8a7931c7f5497db7c31711db8f0,610,TRUE,1381,771,
02a5a8e11d244b45c5bd9112fdd6f865,1082,FALSE,2300,1218,Radiant
7d2f445104b2504fc20e7d7961c6dc02,1485,FALSE,2127,642,
22cd57bc2e63903f4e6c022c4b75436a,1056,TRUE,1332,276,
ddf25337494f16622ef9680e6cb8a99a,1589,TRUE,2178,589,Radiant
1fde9239e381db51888d35fe0791a98e,687,TRUE,1639,952,
29ab2760115a214e1f0ca0fcd4b4358d,1076,TRUE,1768,692,Dire
4f661b76fd22396698657fb49237b325,418,TRUE,2547,2129,Radiant
58c28442aa513b84ff5efa94b9e0c36d,1855,TRUE,2300,445,Radiant
d4d269672fd2aaff9a357a638b62bc34,541,TRUE,3016,2475,
18cee81db16515ad410bf372aa4c9bc3,609,TRUE,2071,1462,
5388f9187d29f2918502f06fb0bace6c,2783,FALSE,3051,268,
e7c024fd8330beec187a5c4613715e50,422,TRUE,1959,1537,Dire
c928e1eabb348ea662e6245fafd3203f,573,TRUE,2084,1511,Radiant
0f0ef62935d44cca47b00e9f7ef34264,1745,TRUE,3477,1732,Dire
e26673099f139f92206ec288fd5d996a,1886,FALSE,3570,1684,Radiant
d06014a18ecd0ba86a9af6f52de32d9a,2390,FALSE,2449,59,
10c9a86d778d07e333419976294ab060,429,FALSE,1643,1214,
7867d64ebdad9bbb1edba18b0bcd59a3,1417,FALSE,2494,1077,Radiant
cbccdee860f3cfccfb006bc9ddbbd6aa,1334,TRUE,3647,2313,Dire
d89285ad2f4ec284927b623a25668aef,2195,TRUE,3056,861,Radiant
a4b47392ae67cd2663cfeaf2e83b3bc5,507,TRUE,2553,2046,Radiant
10b591bcd3786a6b62242619d4255023,1470,TRUE,2481,1011,Radiant
2dc7ed28fcfbf509945aefa628a9c272,1829,FALSE,2244,415,
3b4fdc07c4da5c5d31b828a7f5e8115d,454,FALSE,2198,1744,Radiant
37a2b2c7ee80e2d918058a9b61911f29,1106,TRUE,2560,1454,Radiant
a6c37dc1228f16fd582648c2ddf191f0,136,FALSE,2219,2083,Dire
a277922d370f75a288f182c91ab17a3e,832,FALSE,2454,1622,Radiant
2a5d0243d5c8b6f9771dbdb33ded36b2,1496,TRUE,2466,970,Radiant
ed41c1674ca414a82c68f0684a6c3e97,393,TRUE,1554,1161,Dire
a7eb041b9efd15bb272c1a63e9f218ad,1178,TRUE,2984,1806,Radiant
6ea0067325b7f82a8bd9e726d81267d7,2133,TRUE,2374,241,
c6b57c646c3d1a7afb33ed0968712746,848,FALSE,1916,1068,Radiant
f81f1d24fdb9bedd39f6739c93a32d50,625,FALSE,2923,2298,Dire
a9da1ef379445fd1e7bd52d7208116ba,2415,TRUE,2491,76,
8ec3464f4ef7fb20175205e8ef4312c2,160,FALSE,1453,1293,
39ccc1a298dc7866d9ef0411e75a95e0,2954,TRUE,3476,522,
562e7e2ca2acd92b202cd84f4301e3f5,1677,TRUE,2493,816,Radiant
5d5f7267d2703751bf93e94c1decf554,174,FALSE,2059,1885,Dire
6168dfaf263322b4830200ee89243c6c,153,TRUE,1118,965,
bb2b4431f07ec8a75181b7accacb1f85,808,TRUE,1813,1005,Radiant
22b6b794fb5138d8c4b23a9c01225859,1332,FALSE,3297,1965,Radiant
453014c22c5f2abd74587ccf729d1500,27,FALSE,2872,2845,Radiant
980e19ad59fd14b3931c3995c4e401a1,92,TRUE,2891,2799,Dire
b9127e01269b65c2b82cfb70b7eba5d5,1549,FALSE,2802,1253,Radiant
d678d2c2d0811273e9555ac69d101e1e,1512,TRUE,2268,756,
5703e102b7a6131c7b7269bc0ade9add,1418,FALSE,1567,149,
828a929c6a4b1db14f57722ffa20e966,2580,FALSE,3517,937,Radiant
c039a497fbefc4f159a2f2aee688a0d2,543,TRUE,2530,1987,Dire
7831d66ae01a0bb6c007873cb6f9a8f8,534,TRUE,1805,1271,Radiant
4f541a4d58e5bb4e2c4c518ef84daab6,2711,TRUE,3647,936,Dire
c2eac7ce55c464c9072769635be92f0c,2163,TRUE,2720,557,Radiant
4695821314d64a01d6a406a4add5901a,400,FALSE,2555,2155,Dire
7a499d33a05dd728c6e76dd480cf9dca,667,TRUE,1538,871,
c6ef0c90032811e15739a2ee7be08b14,1755,TRUE,1986,231,
342197d22ba8ecf0f75c20399f6eb808,1144,FALSE,1304,160,
fb23258ce693b86ebaa285c56ddf2294,1717,FALSE,2387,670,Dire
ef64090cb893dc7f4fc8ea41b7e36e34,1969,FALSE,2668,699,Dire
5d2440e4edf118a41019b8b57dc64410,1279,FALSE,2682,1403,
41abc90bd8d773a10e5203c636354b28,526,FALSE,1193,667,
82a2ace682fd612260d317f1c64ff691,1549,TRUE,1695,146,
fae94eba8c8816c1b0b3286b77154609,679,TRUE,2075,1396,Radiant
86ee73d5f245dde9df6f5e04ed36a261,1134,FALSE,2115,981,Radiant
4feabe133d65cc699b4e6dcadf8c083a,337,TRUE,2237,1900,Radiant
d4f6a106436759b6b7e066f67a5ce929,3238,FALSE,4038,800,Dire
75112757bde649d5cff1c7cd4f1275c6,2049,TRUE,2298,249,
ef88bb58611b0b685e8cfc1074a33eaf,1010,TRUE,2108,1098,Radiant
c58a609457e1761cd3429dc41b34009f,2181,FALSE,2527,346,
2e02f8554bc8d9bbeb3569aba2392273,1106,TRUE,2375,1269,Radiant
bc1a865cc73cef52985d080c7b00d210,258,TRUE,2488,2230,Radiant
4bb067a58b91add93528dde4d3bae794,1840,FALSE,1911,71,
13b661839f0d2af9921c954057a335a2,792,TRUE,1436,644,
05049948320d5fc87598d6a918b8b6aa,2260,TRUE,2625,365,Radiant
a07887f9b71f71409e6d127792e38b6d,2149,FALSE,2872,723,Dire
0d23ca5219fe12f4611edd46f5baf063,825,TRUE,1593,768,Radiant
103fc52d79efdfa2f81d1136792c7fab,356,FALSE,1649,1293,Dire
b8cd070792a3c9062107eca63909563d,1263,FALSE,2312,1049,Dire
dbb2c8e34d7271c0c42c14183cdab74c,1032,TRUE,2536,1504,Radiant
e18d396b794fefa89d3645dddccb5f7f,1694,FALSE,1802,108,
d0c6fe42205baa88cbe450ded45e26ae,256,TRUE,1867,1611,
24a1a969bb4a1fab3399d44a800c48db,1526,FALSE,1644,118,
b14251e4b9932fd82c540341b4f44297,1469,FALSE,2148,679,
ca2fe87341dea9befe801866749e3552,410,FALSE,1780,1370,Dire
4c03056d08dfc7313000b09f87741453,2869,FALSE,2913,44,
405967a0527bc5ffb475fb51cd00b2b6,1659,TRUE,2998,1339,Radiant
0ff8ab59e66c413f1f60d73fb57b3ba8,458,TRUE,1982,1524,Radiant
534fb80d390faa65b392fe20f7d2db9c,8,TRUE,1585,1577,Radiant
b1ac3e8d2ce158d3124d3ba39a13cf28,194,TRUE,1556,1362,Radiant
5e4eb67e59259e41faf6a4ab4ca7fe67,2303,FALSE,2530,227,Dire
491d4a4195d3b6d885de6803de4fc23a,1413,FALSE,1788,375,
2b1f420cdcb6fa082e9b937838bff053,1819,TRUE,3033,1214,Radiant
df5cb12b16ff6aeeca07d17425b81731,421,TRUE,1669,1248,Dire
e60372f3a73289bc8885bc83958a1c05,1310,TRUE,1499,189,
fcdfb698b106093202c47e856cfa42ac,2828,FALSE,3064,236,
3fb2bb7c9ee8f9d883e93ffb617f1d97,385,TRUE,1324,939,
1cbfbf448a2db627d558b9df2540e62f,2129,FALSE,3493,1364,Dire
bfbd1719c0ce20681c715662bdc974c3,672,FALSE,1544,872,Dire
ecd5a67beb4d56cdb3f93f99f21c1ae0,218,FALSE,1394,1176,
cd5d844a75becbba3ed8b42600c312c9,1861,TRUE,2779,918,Radiant
ea77bf844d34ccc98cebdff7aed302a1,256,FALSE,1366,1110,Dire
2f0ef555793464930ef5c8b6f23124bf,337,FALSE,2653,2316,Radiant
b4c74e5d8d94898111079dd56bf6f5ed,1007,FALSE,1430,423,
fb230a6cd3957e213d699c3e426eb90a,1870,TRUE,3201,1331,Dire
b0caf46c7936e3dbac3716cb052ce09c,2503,FALSE,3087,584,Dire
6b12645c2ce345e94d2dc4a00ddc5688,1993,TRUE,2684,691,Radiant
28dabac949f92bd6b19a431b62f77549,1159,FALSE,2636,1477,Radiant
f8df916c078a479686c605aed31ce86c,375,FALSE,3585,3210,Dire
7989b1313923f485ca7432741a4ea11c,572,FALSE,3132,2560,Radiant
339cf9ddb165af8a84c661842a3c2945,113,TRUE,2750,2637,Dire
e54d63ddaec3d90dcdb05d17f4f4b91c,1885,TRUE,2238,353,
fd471e336aa0d88293105ef4501999da,2505,TRUE,3141,636,Dire
286d644c1633edaa2ff00f86ac27affd,1588,FALSE,3565,1977,Radiant
19a04e1806dfdde4b52ad8fc79ab1bda,3129,TRUE,3249,120,
4425bd96ee0d9a72143350d26f848474,1448,TRUE,2213,765,Radiant
30306f2ac6368a9f41a38f22b5ba997e,58,FALSE,3410,3352,Radiant
d14efb947c52d7a9f894b20e1f0c6eb8,404,TRUE,1714,1310,
2892f8adfac23347a16ff7bdbe6eb6c8,1662,TRUE,1833,171,
c8fe34d9b112b614b633f04ca0a8fba6,368,FALSE,2450,2082,Dire
bf6bcdfe2c8ec5b308b7d406aafb0041,1269,FALSE,3177,1908,Dire
5b2547841a39811770913e8a96b942cb,1226,FALSE,1806,580,
1ae9394b7dc7d20238c2be5c2f8f66e8,1586,FALSE,2449,863,Dire
73904b59ceeff7ae70c127f051a07faf,18,TRUE,2345,2327,Radiant
48b2801775b3ff9e8305f959c0b1e893,585,TRUE,2008,1423,Radiant
1ea6b2c64333e055c8bf209df7500d52,800,FALSE,2172,1372,Dire
21a78f9e16a3db6d32a68de885ef4578,791,TRUE,2855,2064,
04787e36f8adfba21ea2bb8dfad2fd95,2226,TRUE,2264,38,
de94d9baf801ae9e3060a610e0150a2d,1009,TRUE,2429,1420,Dire
872ec3423971a5b4f62ea6484138f255,1309,TRUE,3265,1956,Radiant
97114f982ece53d1c3fc3ea79e446bc1,2098,FALSE,2404,306,
15ecb26bb40307cf942a01d355f82b69,2074,TRUE,3142,1068,Dire
205c201d2ed8ba6dfd939bbda1236d73,883,FALSE,1646,763,
7c2a5c9cd5b43b15dc4761c5d8f0514e,434,TRUE,1826,1392,
6bb756f0bdcb203f0a027010599b44ef,528,FALSE,1685,1157,
504a09decd75cc5e43a3b5f7d0822b8a,1417,FALSE,2521,1104,Dire
44f63944cb8834239f4a7db71668889b,325,FALSE,2239,1914,Dire
6301416ce90bb9c5548538decd2854dd,334,TRUE,2648,2314,Dire
cf26eb4439172d6984e987bd8006280f,945,FALSE,2364,1419,Radiant
c818ddc2c01de5a2898bbbb6bd5452df,650,TRUE,2024,1374,
0c8039832acc3fd98e2f1f5f29f5bc94,289,TRUE,2746,2457,Dire
d0a1f5390cb5fa4ed160153c73cebfc5,2285,TRUE,2779,494,Radiant
4f7d81f1e5fea3a8e63b6b3559213fe4,1254,TRUE,2262,1008,Radiant
ddf08b22582d464c262155a81ff228d5,1581,FALSE,2497,916,Radiant
9897fae571e7cb8b442482317707239f,149,FALSE,3805,3656,Dire
ad673578360aa313cce235a7fca3a5bc,1601,FALSE,2928,1327,Dire
8e7d4f0b11b90c568c98b7ff7d590907,2690,TRUE,3054,364,Radiant
a3b45ffaa7248d662cc731c8f93cb264,10,FALSE,2555,2545,
04b2b9f173c108d55aecb2fecd33efd2,1689,TRUE,2268,579,
9507c9ceb01d3a4949c471f609ce7beb,1807,FALSE,3798,1991,Radiant
26673212b1a8a3605648057c2e5efdbf,1129,TRUE,2750,1621,Radiant
5465496399b8f12b129a9536a7f55a5d,179,FALSE,2475,2296,Dire
eb117b2606d6c83cdc89dc8071ccc259,2273,FALSE,2788,515,Dire
b6a14a0a7841df5583456dd8bdf37247,577,FALSE,1951,1374,Dire
87ea6d4e64d6cbbdae3832f43d3414de,1017,FALSE,2360,1343,
118a41351ba7f923f5db8753eedba77a,587,FALSE,2179,1592,
9a5097b20d0845b5b1287e67785d3147,1443,FALSE,2084,641,
50af084c3c8d961808f11cb08b140862,67,FALSE,1937,1870,Dire
4474fdd289bad427cfc47fbda0b614d1,2170,TRUE,2727,557,Dire
a0449cc69d776f024b102eeff66a550f,933,TRUE,2301,1368,
58e75cf312de926700e05781fed0213e,352,FALSE,1876,1524,Dire
3dbd71127b85a9fb489405b0bf8f5303,2092,FALSE,2216,124,
ae1190c452ee42333a3f5d3ed9d48ead,874,FALSE,2261,1387,
d17b445a4aa6645f13b862cb71a6878e,1453,TRUE,1806,353,
80e8b1359ee89a3dcc008bd4dd02fab1,1461,FALSE,2116,655,Dire
e3ff22212e13f7352ffd725d494930b5,1,TRUE,2655,2654,Radiant
4adc5cab20c14d14652ccd97ebccc504,861,FALSE,2255,1394,Radiant
cdf9fba9a34e07a3f3eb553cf1915317,1279,FALSE,1969,690,Dire
4d9184d906ce6bc0a0996b718d18829b,2598,TRUE,4186,1588,Dire
0db7ad957a4a8500b5ed5a5948ba8e10,2195,FALSE,3200,1005,Dire
014749726b73ff14b5532833ef98e9b3,109,TRUE,2167,2058,
f266ad5a3b3621d44a3673963b62072d,1818,TRUE,1897,79,
02d2bf52d61d7c9ccaf1ec9c9c305716,876,FALSE,1735,859,Dire
223c6b3934164a70f296f21526fb16d4,465,FALSE,2600,2135,Dire
470f6277011ac02ae7a85eb732bc9e3d,84,FALSE,3425,3341,Radiant
b39ef66c5f4db17a4502e44e4bcbf9c4,203,FALSE,4009,3806,Radiant
73b4b480fc4af323db55731dd876fb0c,1904,FALSE,2095,191,
559dd59fe20a7c66dcb3a9be62c19aa4,2069,FALSE,3857,1788,Radiant
6f069b4163eb9909ee0082f2724e48ba,939,FALSE,1845,906,Dire
f9d42d1684d2c4372a835bccf5f5d2cb,911,TRUE,1599,688,
b77d233a511099bbd9ce59964f866b9a,1964,TRUE,2094,130,
fb2fa20ae86dc17302a596ae68dfc017,183,FALSE,1847,1664,Radiant
63dcd473861dbc496ce503f1dd5bdf6a,1023,TRUE,2614,1591,Radiant
0d6a02bb4d4a57f65b02b3c18edd6a2f,555,TRUE,2137,1582,Radiant
a6c2dee53f8f8f72b82706993b0c241e,645,FALSE,1119,474,
f29c8836d799bc14f6c240ad4052732c,2830,TRUE,3005,175,
e89c5fb5f5f597eced04bf8457460d00,3147,FALSE,3984,837,Radiant
3b3e48f5d64af0c3d770f386e9a76cf4,276,FALSE,2628,2352,Dire
d3bcd75519311a136655e1754604ca22,2656,FALSE,3504,848,Dire
3211e9e6437c81a8aba204664a8ca2e7,2100,FALSE,2506,406,
a4082ee811b8ac076ea9361001b42ab3,1467,TRUE,2569,1102,Dire
193b51c630bcaa733fe30a59f3f62227,503,FALSE,1568,1065,Dire
d271146fefaeda73ca58a72f6380646a,1941,TRUE,2765,824,Radiant
0f0dbdd96082bfd872b23f11d9775bf9,1672,FALSE,2643,971,
73d24f994e965cc3b355ff2787c317c6,503,TRUE,1154,651,
457336498aa97a4c360b98a710329a3b,1465,TRUE,2544,1079,Radiant
d801ed6a31efacd23428b709a0477c18,1594,TRUE,1990,396,Radiant
f7182fa5eccb910396ea2c12c9c8dd9e,404,FALSE,2069,1665,
fa506f2c1152ee1acbd2b059077c7513,428,FALSE,2049,1621,Dire
5cbfd593247b1460667220e7e111e493,1588,FALSE,1865,277,
874cc96b8e2242af772e5debf1ff8171,3,TRUE,2805,2802,Radiant
8d0766dff812211cb3944b9bd503bdee,621,TRUE,1348,727,
7ae05c75a824f436a6833692a1ea7636,3883,TRUE,4222,339,
a22a30bd46d7ac849f70528382bc17b9,1011,FALSE,2273,1262,Dire
19e46ceaf9396126417ccbe681764c21,335,TRUE,1936,1601,Radiant
b566015ac4342e6294d4f47c140839e1,281,TRUE,1542,1261,Radiant
2542af2ee2952bb4f55c970340ae777b,934,FALSE,1977,1043,Dire
d4d0c018299713fdeb4c87c75e04597b,466,TRUE,1695,1229,
548855e9e7c85ead05ea9d9ba4ee4cb3,1058,TRUE,1633,575,
c5142ef9e7c32132c2b04c1e5e918f4a,805,FALSE,2567,1762,Radiant
0f6c4374a18d2d50f914b802f0e16eff,1321,TRUE,3065,1744,Radiant
65ad14163da195e64900eef328dbaf4d,490,FALSE,2857,2367,Dire
1382e0e725ebf5a055d347ae0cfe911f,762,TRUE,2015,1253,Radiant
53a56a4f55bc87fb356a7c41ca4671fb,140,FALSE,2820,2680,Dire
972006db6c50ed9440b3c3eb30f0eb14,2207,TRUE,2506,299,
418dd963ee8db2d335fb841447d0ba29,2444,TRUE,2624,180,Radiant
bc99603e5d2316c33dd665c36405cd89,876,TRUE,1425,549,
7d70243f1bd16519e61c8ede78ac14e3,2284,TRUE,2879,595,Radiant
087ed9743ca48d1d282cb929d1122cae,732,TRUE,1332,600,
e800ea21611d3838d6a4f01c39953606,1738,TRUE,2086,348,Radiant
5de67f328add914bdff7a8019fd12f08,365,FALSE,1656,1291,Dire
46fea7b30b8d5238386302817284992f,1609,FALSE,1879,270,Dire
478929fed4928b19bdbaedf12f79610f,1284,TRUE,1582,298,
2d922968bce9d072d478908163f273d2,548,FALSE,1790,1242,
c9c1fcd4c1a020c9e39bf4a6c731d5b8,2724,TRUE,2953,229,
257558a35392b7e5f75123f9cc3ea51e,836,FALSE,2098,1262,Dire
2b84be87f217a2e2a48a9f0de2dd5689,547,TRUE,3666,3119,Dire
7515d9648df1227ca4b6bf4a64837284,1561,FALSE,2243,682,Radiant
192b5b1efa2f9ae54683b96c5961fbb9,1683,FALSE,2500,817,Dire
1d055c93300d84ca8bfc2a48fb1a638a,1995,TRUE,3306,1311,Radiant
2c9b688ca3a4c564fe418dc8b9b51453,1535,FALSE,2528,993,Dire
a79471bd3b09b9a2d36bb1b85772ec8e,1102,FALSE,1575,473,
568866cceb39c33be44d858fb547f7ea,2695,FALSE,3175,480,Dire
98bd36856facacd0759377bc8f1fa2af,343,FALSE,977,634,
e31a0308f416da312b499ea1211ce77d,1485,FALSE,1899,414,
7ed355e7cd7f7dea67d13f6e49d8c82f,1098,TRUE,1550,452,Radiant
5c659aeedb3565dea687949e09b982a7,445,FALSE,3378,2933,Dire
caffb0a9f1ab493740b04c088b47e244,1197,FALSE,2106,909,Dire
7e36eeff3b875b4a9d8120a9acfc1008,1043,FALSE,2239,1196,
b255d83f1f409e89d9162acfed3d1b09,2018,FALSE,2128,110,
9f345205b3efc990d0828598d46db8c3,966,FALSE,2360,1394,Dire
cba854161b9394bd090977f47ab70220,1607,TRUE,3701,2094,Dire
577a6a301f3ddca54d810305b2a97cb5,426,TRUE,1270,844,Radiant
faabedbb7f6755dfbf111ed101ba9fc7,363,TRUE,2679,2316,Radiant
73e017ddcfc70f451307a95acc7c0f98,935,TRUE,1828,893,
7cc785110e65cf23fbb709fff628b0a7,61,FALSE,1920,1859,
ca0b6e706dab4daf95c8937574c16540,852,TRUE,2013,1161,Radiant
04da08eb622573e71687653a81c3a8f8,1442,FALSE,3569,2127,Radiant
f377c842e018e0c76cb0f8dc22a35f91,1277,TRUE,3667,2390,Dire
145e2f35a2eada95c2d8610e2fd594da,315,TRUE,2350,2035,Radiant
4fe20a62c3ef9efba9804003954704aa,459,TRUE,2924,2465,Radiant
31a3ed4665ea313312bb69712972b9bf,1147,TRUE,3346,2199,Radiant
f39c7bb0a269456af572433571f4bc40,814,FALSE,1555,741,
abb2797db5eff012446492bb78b7e815,2783,TRUE,3110,327,Radiant
9e5da8cd6ea3328d51fbd96e00dfa43e,1785,TRUE,2765,980,Dire
55e0a998ed0c806613884b088c94feb8,516,TRUE,1280,764,
8ae083451c6addc2a604112f369efd90,590,FALSE,3329,2739,Radiant
cb6ce1b43b77b198c7765aaf5f6e3b1c,415,FALSE,2218,1803,Dire
c8c4d6118f2807b871770bd1604b7a22,99,FALSE,1551,1452,
3d948f870618b0854ab0c07f478e0704,1095,FALSE,1745,650,
af1bd41c5c9cbb9083891feb71068bc6,1159,FALSE,1836,677,
aeaa3a3aa9dd32c91cb3ea0815aa6244,2065,FALSE,3541,1476,Dire
9b7e9cfc50a8c339a251fc7dba433ac6,842,TRUE,1351,509,
26e9d8f5e5787f47d0803b989c882da7,3704,FALSE,4105,401,
e4d2d528a78998e9b9c01a148eab11b0,717,FALSE,1184,467,Dire
382f49b48f4dcf5cca81ccdec6cd2ca8,1994,TRUE,2891,897,Radiant
63cf98fcca09c07bfa260457bf7ba68b,1092,FALSE,1820,728,Dire
66b610280de896bc37d48b46fba50185,1064,TRUE,2922,1858,
ad8ac2b6ca4e032124e07186481e1dd0,1866,TRUE,2293,427,
437a4d8b80c1a78ea345852fbc134da7,830,TRUE,2499,1669,Radiant
667793fba45f5d9b9a2f6e732c4e675e,575,TRUE,2161,1586,Radiant
7faa25ca2ce51ff1bbd3a30b41d06fbf,1896,FALSE,2094,198,
5221f7d20ca7d2c96d7917c935cc4855,1306,TRUE,3122,1816,Radiant
93422c74a337099b650dd5690dfb5bc4,2346,TRUE,2963,617,Dire
5b6cff8ebdad093b518d131e3d0404c5,2217,FALSE,3103,886,Radiant
8ddedac12b0e3b3277a625acd82fc5f9,962,FALSE,2568,1606,Radiant
7993c2cb3aba7b659a794a76a35fffdf,373,FALSE,1382,1009,Dire
9ec2439965efac73ae84ab3fdce2ab6f,1688,FALSE,1812,124,
30fd8ea5f4c2aafa194c34b73e654390,245,TRUE,1068,823,Radiant
32e86a26dafee089085214134682b62d,464,FALSE,2468,2004,
684129edb72d122095e10042cd348908,588,TRUE,1661,1073,Radiant
b2e3d55210d82880c622fa6b7bb5237f,98,TRUE,1620,1522,
07f69e90c1b4c8682e426d23333a2daa,605,TRUE,2790,2185,Radiant
2e41f2c3e7ad80aa8c57ef503d10b945,1498,TRUE,3041,1543,Dire
3295c490e39658145c1b25230275c454,1524,TRUE,2797,1273,Radiant
94152523210a1ad2674949cccffeeb61,975,TRUE,2147,1172,Radiant
a6db8c8b7d81dab0fbc206ef4aa256a9,1167,FALSE,2298,1131,
f1d1d09467eeb7da136aaff83aae90d8,2126,FALSE,3706,1580,Radiant
a9477d8038a4ca0325cb378f99ce02d7,2740,TRUE,4154,1414,Radiant
f466c8770ce86f0336263d67694c4eb6,2002,FALSE,2168,166,
dc1a7546613b7d760379d3e9f17d9257,2069,TRUE,2424,355,
e8135d9e40ee4f8853ea8b49bd1af691,1526,TRUE,1723,197,
3fbc9475551f992072590218264a84e1,1222,FALSE,2331,1109,Dire
d57c0843ad46ba7dc00599aceccbf232,585,FALSE,2522,1937,Dire
cfb17491fca593f62bd21aa8d576a4f1,19,FALSE,3219,3200,Dire
d86fe567389c5f9fcf2e86c5176a7e8d,3212,TRUE,3897,685,Dire
f62cb5a31a6001b3bbd33ed50b682cff,1481,TRUE,2120,639,Dire
5e3001363149e4cd70bcdc6717eb5e7c,2698,FALSE,3195,497,Dire
5273b8eb7a0fa0d2b6f7e1724f306ad3,1695,FALSE,2197,502,Dire
a72bc3d777a8eb0cbf7a77ce6c8b3484,2328,FALSE,3955,1627,Dire
5b5156bea4163d1a39a7a8bcafbd5941,1751,FALSE,2862,1111,Dire
b03a4832b2acf97fba64e5376cbf7485,2665,FALSE,2732,67,
abb26e94425ddd5c3a5cba6e555f6c32,2955,TRUE,3102,147,
c7b59f890011ce7b9b12dbba708b991f,545,FALSE,2237,1692,Radiant
5c22dc828659f9635079c2333456f794,992,TRUE,2566,1574,Dire
bc6bf5356a55727da36e47963f2f4a51,1228,FALSE,1660,432,
cee6df06607e1fd8f5cea58d8bf1c7b0,492,TRUE,3811,3319,Radiant
e8fbcf66ad4d0d8b0aa1d3f63f11581f,2293,TRUE,2575,282,
46e2e77cc691cf3bdd0a4622a0592fd1,477,TRUE,2386,1909,Radiant
e4c98846ab4612f530f667013acd187d,324,TRUE,1715,1391,Dire
7a398a0283eb9018c84103ce1f480809,1780,TRUE,1929,149,
2d12134c34f181ac13f51f79218ca7e3,1239,FALSE,2177,938,
86ef762a4dd63de298f10c3d16a0743f,1933,TRUE,2100,167,
31d74b02ef6fd9d66c91624577a0180d,574,TRUE,3113,2539,Dire
e904b1e2b3f72a3daa497d3ff41cdf2b,1829,TRUE,4129,2300,Radiant
68f14d5857117f4fabdfeac01dcd042f,422,FALSE,1645,1223,
b1831b2b6db34830b8560bc3879b9ead,1402,FALSE,2294,892,Dire
8593c6cae53438d91d2dc3ad5e539ccf,2010,TRUE,2309,299,
44962ece73b6f4667842d702f1ce8975,436,TRUE,1473,1037,
a5f6050aee29d84934b5480b1aee0fe4,1383,TRUE,2643,1260,Radiant
db1f5c8a1243c140a5359738c21af870,993,TRUE,3320,2327,Dire
58321752ac2af463268f1ecf30d23148,206,FALSE,3296,3090,Dire
41e05d578bffd991ae85a5283d2bf265,2559,TRUE,2879,320,
c3b8917123ea0ae54198223794b5e5b1,728,TRUE,4045,3317,Dire
d1f4cd35423ff5d4fe3840a34b4ef225,1205,TRUE,1958,753,
05e63faea82701bd79dfcf149e0c68a5,166,FALSE,1885,1719,Dire
9c1f594f5df9babf0c5e15542a10fbfc,2584,FALSE,2891,307,
7a47dee84fd89b8ce29cdec50bebc1d1,1021,FALSE,1083,62,
c0352fb46f5854246eb952d63eb0a013,3451,FALSE,3767,316,
95f357aeb1dc54f30360e0475fb0c963,319,TRUE,2774,2455,Radiant
05f51ef2120f3ffb02d2d8936fffc087,1413,FALSE,3254,1841,Dire
4cc7114c5f911f2cfae85dcfc4eb0021,1633,TRUE,2013,380,
70e9733119f5c183e792e6c517035782,842,TRUE,1887,1045,
0ca3d87438690ab9c9c5d02ae9e7b76b,1716,TRUE,2983,1267,Dire
219c9074a09c03eb1d0bf2b200764376,1079,FALSE,1767,688,
df8ef5af6d5d2546170c07bc41d40840,1102,TRUE,3862,2760,Radiant
caf991b25970a365ef2a68a935dcc12c,2110,FALSE,3212,1102,Radiant
c10b45e9af9ec90590a95c05838637cf,2754,FALSE,3203,449,
0af683ccd33870cae5f170da5a93f84d,2006,FALSE,2652,646,
82df82a3cc142895bfc8c47d4cacb4e5,843,FALSE,2098,1255,Dire
5f97d90e98f571043df589f770b085dc,163,TRUE,2197,2034,
473307a38cacdb5b9b759134367dd761,1415,FALSE,1451,36,
fde7979388f636783254c396629e11e5,1079,FALSE,3351,2272,Dire
03bfc3895b7f58f921102001c539feb3,861,FALSE,1524,663,
943c51f4c066bd133d9385fbe0ab925a,283,FALSE,2471,2188,Radiant
d2baf2c57a23ee2f34b75a78ef4e37c0,773,FALSE,1563,790,Dire
f5ac861dc59eedb3c9a2d8cfeda7fba3,699,FALSE,2823,2124,Radiant
0287aeb377e206198515457045996dd5,1430,FALSE,2481,1051,Dire
1ecde214d317906025337ea147ba902b,583,FALSE,2779,2196,Dire
5ecefc5011ec2f159ff9b773f9a28af8,1705,TRUE,2003,298,
a8c3664060530304f98f1313f4c191e9,1623,FALSE,3606,1983,Dire
b51a6c2b91e2062d153980908948fc44,1204,TRUE,2295,1091,
dc761b52811e815e0b9ffdf7f2b4c1bd,961,TRUE,2038,1077,Radiant
fe994d07f35e7d72de7208d2b444d53f,1466,FALSE,2164,698,Radiant
daeba0e7af074d714ac587b388298658,2378,TRUE,2850,472,Radiant
3371b27bbc0febd218bcbbda43c1b15e,123,TRUE,1931,1808,Radiant
8040fe2430f52215ada516f156abd1d9,1901,TRUE,2293,392,Radiant
b288b45b7aff875237a258bce74cfa3f,3108,FALSE,4190,1082,Dire
ceec514a8526b8c4123dc45f6343c5d0,1522,FALSE,1658,136,
fe8f3cce532dc9ddbd7b819fd95ae584,253,TRUE,2971,2718,Radiant
29be093edd25d48414a4fde86dc26572,22,TRUE,2107,2085,Radiant
448bae7eb191026549ffffaa86f88f58,205,TRUE,1897,1692,
68e3608521bb9a7a746e0a570687669f,2185,FALSE,2599,414,
2ebd448323b1b19e34ed5fcf83e53e3e,1018,FALSE,2672,1654,Dire
996bf95d3d08593ded6cd9508799397a,1353,TRUE,2295,942,
62c25335b38a76988ccd0db24d03063a,200,TRUE,2709,2509,Radiant
e512aa754b7d741dc60599c65ee6395a,1772,FALSE,2514,742,
b3db3baae918a46cee6a1052bb40356c,1537,TRUE,2786,1249,Radiant
0a3a0b26efcc5869098e8498a983c17c,1952,TRUE,2492,540,Radiant
7381f61a06fa0338af33564b71e10864,1030,FALSE,4033,3003,Radiant
12b5f27ef38ad9cc7a95049ac2c78613,1388,TRUE,3521,2133,Radiant
5f84238a75c81b6d27cc0aae89a6cf53,1802,TRUE,3697,1895,Radiant
51fe562165f6457c2b34a904835ded1e,2815,FALSE,2949,134,
11ebf347f91fc5a9f5c5424137f884e3,849,TRUE,1726,877,
de7f0300d075628974f48287e841bb5e,2963,FALSE,3055,92,
e21dd5d232c69aacdeb7551b6f7dffa1,1364,FALSE,2572,1208,Dire
de5408f5fa7578c09765e1c485551203,1494,FALSE,1765,271,Dire
413bd96d2b57de2a704ea46fbfe27779,2957,FALSE,4307,1350,Dire
407888db3735b3362c4653302384254b,13,FALSE,2664,2651,
16bbccd13eb4a741291a4b94348940c7,1340,TRUE,1549,209,
689b7f071cea687f7217f8f3292a25b6,259,TRUE,1569,1310,
f61b8d75c9c3487a191e1b512dd30ddc,489,TRUE,1966,1477,Radiant
f1793bf890baf54720080c13eff6508f,778,FALSE,1680,902,
da54e1b362e31eef184561506a15fef5,480,TRUE,1081,601,Radiant
b1c302b7e09f05adba7f605332f20d2d,1742,TRUE,2924,1182,Dire
83f5100711da5e09cd5a390d7b168cf5,2297,FALSE,2363,66,
b7953372228ed6713c37e8fd4c9e1e04,1249,FALSE,2651,1402,Radiant
46c43592cc926d9e20069ea865b15d84,1808,FALSE,1852,44,
39cc7e6e5579c9c7f5dac0485bfb786e,3301,FALSE,3631,330,
f94a12d7362d2c42d96fd1be2e522f53,2641,FALSE,3119,478,Dire
92077c30549c5b5047653d83dee20030,1899,FALSE,3529,1630,Radiant
7e9de418d26259d0b7d57ba47b99d947,2051,TRUE,2666,615,Radiant
1bc2e86fa3029b10d267cc94f5d25c03,2935,TRUE,2970,35,
0a5e808d714b03bfaada2f0d3aaaa335,93,FALSE,2196,2103,Dire
de43c694fd909303b08e9a77ca6c45b7,2094,FALSE,2962,868,Dire
c4c6eda1d63c905e30d608cad3e2492a,1794,TRUE,2936,1142,Radiant
3179e700fa17949183354d6dfe3084fe,577,FALSE,2219,1642,Dire
d915845c17fcbce1313d31678a3e6079,615,TRUE,1870,1255,Radiant
3c4ca2bb3d5048c6d085fc8668a0cc23,96,FALSE,2099,2003,Dire
2b07d5bcd938e82a9b2932c98afea5fa,715,FALSE,2808,2093,Radiant
6d5ed8e9679572bcd8e51c779da4c181,2483,FALSE,3110,627,Radiant
4bddd8870bd21d0ca1d423eef914096b,310,FALSE,2883,2573,Radiant
95b1e9e9b2026b1d60f972bd292e9574,1888,FALSE,1942,54,
8bb679b0691cc8a307d77ab00c456451,1416,TRUE,1509,93,Radiant
dd045a82ddf25d6b37c996ff6a7e4e8a,407,FALSE,2991,2584,Dire
898c51053e819f735646394650bde71b,623,FALSE,2050,1427,Dire
be325cb1ae57603c7a979a7fefad8959,495,TRUE,1474,979,
aeca28bfd6625f5dd7582869919f7ece,352,TRUE,2618,2266,Dire
de2a4d6d55df2692aac3e498ab471ade,2051,FALSE,2933,882,Radiant
f079fbad973e3ec6fd507f6d77a0291b,1166,TRUE,2192,1026,Radiant
a39b311a0897e38a8be95a8b85c7282b,1371,FALSE,2306,935,
82731d5b7a64e9b24e668364908d3a0b,876,TRUE,2544,1668,Radiant
d01ecebac8be0102e66c3815a8820a5e,663,FALSE,1571,908,Dire
72eee36738becc68ba41426bb8cd0721,2267,TRUE,2326,59,
3ba660edd6fa8f234961715d7f2604db,2132,FALSE,2188,56,
ed43797c7dea3f3c04d5ef7c42a42f0c,2049,TRUE,2737,688,Radiant
6c0f91b6c333820c6fa0541f4bebe5d9,255,TRUE,1387,1132,Radiant
b7af3236bbcd32975fda35b2ccad18ac,520,TRUE,2032,1512,
2da04c25e22e85c03c409bd0bdaff601,432,TRUE,2193,1761,Radiant
2811f26681aa61b9b0c1b9a84c101aa8,1318,TRUE,1516,198,
3e8acfccf58a4b893eab2b9aa7f6aeaa,1846,FALSE,2059,213,
57fa414967e267704e67b372f17c0130,830,FALSE,2310,1480,Dire
6a7f3c801a7b460291d6232cec836a20,970,TRUE,1728,758,Radiant
7d9d96ebd19bb79030a1148d1c174db3,680,FALSE,1071,391,Dire
4aa38804805a2c90cea2115dd4966573,1031,FALSE,2011,980,Dire
f1c3575266029bf82fd11ee878a2df8b,397,FALSE,3617,3220,Radiant
883d4f5b031a5485a4da97947ed5095f,1304,FALSE,2975,1671,Dire
ceed4521c0d07eada8ff788638e7fac7,370,TRUE,1679,1309,
4e0b2d8a095c16af25a9b58fce007e02,908,TRUE,1747,839,
ee0f09c5a7e54af632c841ebdb563722,698,TRUE,2419,1721,Dire
5ae92c85f7869987eeb8f82329aa8387,1526,TRUE,1983,457,Dire
120cc73cae9d051b688afaaf73cc1885,780,FALSE,2441,1661,Dire
fd6ff841aa9679ec84019e71f2926867,1006,FALSE,2744,1738,Dire
1a8ea48945e2b7130614fdb8578976c5,889,FALSE,2331,1442,Dire
bfeba0e29464bd3922b07557f706270a,1846,FALSE,2192,346,
0def225e64de08990371620b710111fc,315,FALSE,1524,1209,Dire
49218282adefb1419e0e685f55c2c481,1685,TRUE,2778,1093,Dire
157faaee3ae16ed0fbef6796c8f18264,1287,FALSE,2291,1004,Radiant
00612295d26660f91bb9565467c080b3,1360,TRUE,1831,471,
18f5b4e53166a044a82ec01bd97a8d3f,475,FALSE,1905,1430,Dire
d4084e6a3e7b8e95472ade97933dc54b,328,TRUE,2407,2079,Dire
c7f83785fc0a4c6441a203e337929be0,620,TRUE,1741,1121,Radiant
83a2d9035094260aada14ad3173e980d,615,TRUE,1576,961,
96da102536e836d07d13c0d2bcd0bea6,337,FALSE,1804,1467,
1249768312a9cc9267041b8ea451f87c,730,FALSE,1698,968,Radiant
3ffaf0801532ff408da7ccca0a86d7bd,19,FALSE,3140,3121,Dire
282dc2d7a2fb8ae7a37bf9cae4c071e1,192,FALSE,1780,1588,
da1a981ede6b75f8318ec5bf9ae88d4d,2556,TRUE,3090,534,Radiant
84ee70003fc06dc55610202bbd1f7c15,528,TRUE,2106,1578,Radiant
6d0171bffac5ffa0b9f19b4469da29ba,2223,FALSE,2394,171,
8e37a04315dd715acbda2651b85267c1,448,TRUE,1353,905,
2a478f98a0a9c55995b593feafc9d3c1,1336,TRUE,2464,1128,Radiant
558ccb7b36ebcd2676a21d94c98c03ed,523,FALSE,2893,2370,Dire
8048c08f249ca62ac3c576da9a3071d4,2643,TRUE,3439,796,Radiant
3c96d20024c6a5a795da260e15c92274,1351,FALSE,1569,218,Dire
bb9c93db72627d7bd3167c143627c4b5,1036,FALSE,2199,1163,Dire
561d5a14cf74a10fc8dd61e2b9952973,2684,TRUE,2842,158,
d74f1a1361ca87b79fe5600d63076677,892,FALSE,1815,923,Dire
e843d0acc542a3793d524cb1537749c1,975,TRUE,2607,1632,Dire
e968e7af6aec2ce0f0a95e17586ec593,905,FALSE,2053,1148,Radiant
ba409670acf34dd0f1bfd9a03fe67cc7,1120,FALSE,2419,1299,Dire
81ce063d3f0618125becff0e8e459ec9,67,FALSE,2478,2411,
40bde44f3a1ae322dbe0679befec46d5,2289,FALSE,2323,34,
16da1a45bd1ab7776fa2aafbbae3eac0,150,FALSE,1709,1559,Dire
1d2067ad42f0b862a8e8deb66f304423,453,FALSE,2605,2152,Dire
4ec3c4d304531afa48f21f35e908a874,2024,FALSE,2338,314,Dire
6619f63d1d70bf12b18d900cd69d1c4e,1494,FALSE,2517,1023,Dire
31e8232401fbd13bf0992e9bdd27335d,1047,TRUE,2974,1927,Radiant
1ba1aa14299a511fe7392ed7cb902404,1105,FALSE,2898,1793,Dire
def1bc70d2e72777a7613c20ced75b71,670,TRUE,1986,1316,Radiant
15aa18ed1b855e86c0fd959207aa9e19,752,TRUE,964,212,Radiant
8f93ed810a6863833b77f50e78528033,1082,FALSE,2853,1771,Dire
f0a4c0ee09588b69eaea47d73c8c0733,1019,TRUE,3814,2795,Dire
2c3f49c9f9040c6459c2403b09c5a174,2010,TRUE,2766,756,Radiant
12d18c7f4e1ca7f96790ca96809ea772,1320,TRUE,2613,1293,Radiant
d4b48686796cae0d60d53b8c9afab44a,2354,TRUE,2435,81,
d64509d463a011f5c12d946ddcb42f19,2458,TRUE,3557,1099,Dire
0760e4ca82ccd36772ea281278ea6a6d,1312,FALSE,2407,1095,Radiant
8573bfee212c02523b2da3a6340847df,999,TRUE,1408,409,
db6e806775c203f2c8b8d5db9d75b608,1124,FALSE,1604,480,Dire
04f5b93ee1be907aee53a495448dd1b4,4538,TRUE,4592,54,
28798886359e78850a58b241fa3735e6,336,FALSE,2573,2237,Dire
0dd9326e4021141d65ec2817588308c8,228,FALSE,2405,2177,
3ba0cf78616397a8e7bc5a4fe718da40,404,TRUE,1276,872,
6b673a342a6dd787fdee909fa0e400c4,1117,FALSE,2227,1110,Dire
7ea9773592013072ad989d7e0056f6a8,263,FALSE,2427,2164,Dire
6bc2eafd7cddb18c2542ac8a9d6a9301,1587,FALSE,2211,624,Dire
b9869849693296c6e1b3394c1044a2cc,1092,FALSE,2072,980,Dire
6b30d67909c60c25771460dc2aa9f4c8,1072,FALSE,2179,1107,Dire
050df0e5e3d99bf70328484e08519c59,128,FALSE,2220,2092,Radiant
26fb747fc10f19943ef944bc092c6af6,1231,TRUE,2775,1544,Radiant
eb46d1fb9da20d014950c0988a407646,1338,TRUE,1701,363,
b31d3d425f267524e780005988273305,1603,FALSE,1965,362,
3fde3eb9285537d49b4deeb8dfe265c4,1714,TRUE,2236,522,Radiant
0c50c8925c4e331bee31788a8936874d,955,FALSE,2669,1714,Dire
9ac7b9dd6fea1c63c3e3973cdefad390,1863,TRUE,2006,143,
02b3ffc39859cd33a4d1e40668bcbba1,1724,TRUE,2586,862,
a43ff462e92dbf6bfe8cdd2fdb5c2335,1450,TRUE,3389,1939,Dire
716676607bc1171a2306c03a5417130b,1423,FALSE,2272,849,Dire
08f38aca9cb238f7697d172547672004,661,FALSE,2744,2083,Radiant
8079e2cd444280e44202f3263d2697b7,669,FALSE,1704,1035,
ae26aa90f3cf7e6d5e1ad81c70d8ac1f,76,TRUE,2571,2495,Radiant
bc4ce843a381ea145cfcb8c7135a84f6,347,FALSE,1529,1182,Dire
dff6c0454113fc45a054f4cd92c458f1,1346,TRUE,2788,1442,Dire
818ab1038c1d6d35d21e80eabe6dbfba,1528,TRUE,2046,518,Radiant
3c5e8ab6a3bfb6b7ac4e8341633485bb,866,TRUE,3453,2587,Dire
7e3f8abb8828a0950483ea3ea5eda001,2487,TRUE,2732,245,Radiant
905db6ebd05487682d28badac6d23bdf,40,FALSE,2337,2297,Dire
969c8c1e66ba91bc3956cfeb2b3db8b8,339,FALSE,1057,718,
abf205b26b91372fe72ef40288571bf0,193,TRUE,2641,2448,Radiant
9ad78490374e272fccaaf296fee23677,831,TRUE,1332,501,Dire
960d77ad9fb0439bad85e1b270c52427,2875,TRUE,3382,507,
25ddd7ba8b459e907f8ebb89c21b47ad,880,FALSE,3304,2424,Dire
499ea4809b5e64a9098b9611bb030b7e,2012,FALSE,2778,766,Dire
b6c51024df36d33e01ff12ecc03cfadb,988,FALSE,1427,439,Dire
55e8c14ba0c5d38ce6a74c7d74044ac9,1818,TRUE,3922,2104,Dire
bf447b63d20f9579f7df183ddef27914,115,TRUE,1540,1425,Radiant
d55bd30d98dcd81bf8d7e2243cf0bc47,1488,TRUE,1877,389,Radiant
e99b103f4fadd82353aa35574a211a82,331,FALSE,1565,1234,
69ffb4ed337960190a44ffc5214613f3,1826,FALSE,2540,714,Dire
739fc9fb685275de1626283839d02f12,2529,TRUE,2570,41,
c6bb22794f13ae30b6a9dac5c913f9e8,325,FALSE,2839,2514,Dire
2a61f9c520827c2a007dd5fb69ec3a9e,70,FALSE,2338,2268,Dire
869d41e75b6f0e1a95b89f6027484c6d,1456,FALSE,1805,349,
842975a9bb1ddd2e103c02a1baa2ac75,833,TRUE,2135,1302,Radiant
34a0976bf85aa6d2a215529ac7a4e41d,1295,TRUE,3017,1722,Radiant
4d76328262250c7dc0dc4d5373fde440,2735,FALSE,2865,130,Dire
8d85c51fffbce965203ccdbc3df8d3bb,38,FALSE,3307,3269,Radiant
fc7ec5b1cb7958ba865cdb7541620651,872,TRUE,1930,1058,Radiant
737204cf793b72a2036b5eeb39c00d7a,2490,FALSE,3421,931,Radiant
b86a4219507a31f0543d2e95e1aa59c0,511,TRUE,1949,1438,
1a9fdce135b284e5d0f3dc662b2bf261,686,FALSE,2723,2037,
c98e48fb0f549eff701a186887aa64e5,1523,TRUE,2327,804,Radiant
c64680b01ee04f9f55374a856bb042f8,524,TRUE,1075,551,
77a718e1cd8bcba2c1896df7fa674062,523,FALSE,1935,1412,
18846c3bb8a7023e55d40fda70456a4e,250,TRUE,1911,1661,Radiant
4b536a58b3df713fa2ea7361055930cf,488,FALSE,2677,2189,Dire
f2711f3a8a0e48f904c4362295b8a88e,1512,FALSE,1693,181,
2d47b05fafde25085726d998347ede45,2076,TRUE,2168,92,
62d11406ee634308e6d64e0d9d19a968,264,TRUE,2972,2708,Radiant
c94891d182d5b017eed545e073b9df46,1258,TRUE,2887,1629,Radiant
e5e900b927734f0f4ba0070c13351bc3,860,FALSE,3663,2803,Dire
b24ed86ee142dfeee85f1530937ef37b,1598,TRUE,1941,343,
9817109afc20541e102f0643cd834e54,747,FALSE,3171,2424,Dire
db8ded3530dc7501e70134dec22fc8f6,413,FALSE,1953,1540,
e440f59bf9f2caa8cb82ef81ff303ad5,314,TRUE,1256,942,
d2e65f63cfbfa966f819f0cb98ed2453,1504,FALSE,1912,408,
56e3e53dd93bf41adec9b6d13fd9cbbb,116,TRUE,2209,2093,Radiant
8c20114220f133c435a385dee923b620,2932,FALSE,3150,218,
033481e12571fca6112779a71af2d5ba,482,TRUE,1571,1089,Dire
506fd451647cd1972b7067b60f9003bd,1609,FALSE,1967,358,
55770f07a084bc2cfc8a521e1ee4bae5,1734,FALSE,2225,491,Dire
5da8938198812861a984d08911b03f90,1666,FALSE,1878,212,
4ac3023b6bccce10f793dfe6c8ee1a39,1912,TRUE,2898,986,Radiant
48c06e3ed9fffbbf0f300341512240e4,1529,FALSE,1576,47,
d0adbf3b76bdea552407e64c37dd1814,1130,TRUE,1539,409,
f2df7d9910f73cdcaad36ffcab706887,1735,FALSE,3025,1290,Radiant
46c9e076b8ed85783c285c4246f2a8e2,90,TRUE,2562,2472,Radiant
b413226bce62b446b924edabf3f9186c,1349,TRUE,1675,326,Radiant
215563c04f41511585fd198d2d7561ca,1543,FALSE,1851,308,Dire
bfbfe5543277b3a7f22db062e6187bea,2809,FALSE,2914,105,
9598a6c433180991b12bcab796ff0dbd,1170,TRUE,1696,526,Radiant
ee4bd98cb4bbd48a061181c82623af02,855,TRUE,1926,1071,
6e3f0173c1c82d3172cb0b734630f1d9,1162,FALSE,2334,1172,
0916fa8673cf2cc9dbaba26a32330916,3071,FALSE,3147,76,
8731f6833be190f2dc3ee7d273b93150,2505,FALSE,2950,445,
c32ff4a8adc1b37311b75ab426436338,341,TRUE,2032,1691,Radiant
516cb6cd25b6b78f4b5fbcbfe27bce3b,1834,FALSE,2863,1029,Dire
65423dc3299e1ef394adc1df4e1bca77,1767,TRUE,1831,64,
2a06a67754f5d4cf60a6e765670ccbe4,1028,TRUE,1566,538,Radiant
7f81f970e87fc9c322fcf09fc7e6dd14,399,FALSE,3200,2801,Dire
8f2d11065b8e98b97a01217f97880ca7,1205,TRUE,2935,1730,Dire
1e5a6aa39b99c97d537adcb93e9d97d1,2855,FALSE,3619,764,Radiant
2ee1c9cff980467fad5786c083a4a1ac,535,TRUE,3321,2786,Radiant
48db6cc7ba80b5c76c5f5f1a8a1fcb41,1243,FALSE,2171,928,Radiant
0cdc8be68a541d6ed6e5f5f84d6f357a,1487,TRUE,1987,500,Radiant
2447453c02a3df619cb9c39e344bdf58,175,FALSE,1597,1422,Dire
422dd35273edf9332c21af6ccfdb1c4c,3387,TRUE,3887,500,
61fd4cef01c40e2275b63be645a26d1e,696,TRUE,2064,1368,Radiant
2c7da63bbd2b95ea70f26d049441808a,180,TRUE,2725,2545,
05dd60aac70d52bf7cc1ec24703b925a,2574,FALSE,2974,400,
10a09afcc4c0be2ac8840307a278203f,1697,FALSE,2060,363,Radiant
a423cd54a1e7d9c8de1dd85c46debf13,273,FALSE,2131,1858,Dire
98fe1a61c2c241312aabce5dd470913d,742,TRUE,1415,673,Radiant
c3da09166c569e22f30a931b5f92755f,293,FALSE,2942,2649,Radiant
2e4b2460050250f527ada0dd388f3d9c,1367,TRUE,2068,701,Radiant
ed3bbd2f0f38dfe67b3714d19103eac4,2829,TRUE,3349,520,Radiant
19999fa320a48efc8b80569d3bb3a988,139,TRUE,2230,2091,Radiant
32dcc817362cc74a5ee63c47f61f2b36,1121,FALSE,2501,1380,Radiant
a6e2aaf781e1097fdc7e19be59026c87,1222,FALSE,2516,1294,Radiant
1289b7eb46149eeafe01738230951705,115,FALSE,3429,3314,Dire
869cdf191bd40415aa79b45ec2918480,694,FALSE,2691,1997,Dire
e28bb03bf53e353ca9a97c0d2f4677bf,638,FALSE,2324,1686,Dire
832c12fa6685e7b4f72518535b9067b3,782,FALSE,2570,1788,Radiant
1b27458c145b78cd9744d55d9fa5cc22,968,FALSE,2286,1318,Dire
704ad0805fc32849e4865c5217ee8c52,654,TRUE,1742,1088,
046f452fed55d0f25af9a62ee85ce906,3345,FALSE,4166,821,Radiant
dedaec362eb1d13d3c776870189e8b66,1652,FALSE,2681,1029,Dire
916a4dee911be85b8ab05880c35afb5f,709,TRUE,2296,1587,Radiant
6e99ad5647132871dc711c1ff8a9cdb7,3100,FALSE,3377,277,Dire
96301e2f7725f2dd0ae9fbc3a612fd24,588,FALSE,2302,1714,
17a3d3900c34746a44a7e8ad0b823620,2118,FALSE,2657,539,Dire
c840f72bd6db6ef15d539759870d7023,2688,TRUE,2912,224,
8166eab9d2ae427f06f53d144a7acb4a,616,TRUE,2231,1615,
621fec2076ddbce055ece668bbca2ee8,1381,TRUE,2603,1222,Radiant
951fe428d3c17ac14f8bbe7e10e9eed9,1593,FALSE,3532,1939,Dire
d214140d5d06aa1281263c87528e3039,98,FALSE,1593,1495,Dire
faa83a3508ccdd98e905cf4a564f7ce2,2852,FALSE,2921,69,
4b6b87d0ba09bbbd3d183363ef7efc89,1372,FALSE,2184,812,Radiant
a7840994fcde167465d08f512abb40db,1512,TRUE,2064,552,
2df1f63ca96a023a9506e8e860cb2730,130,FALSE,2136,2006,Dire
e4956cd94568f25f66927c1813283ccb,1571,FALSE,1760,189,
a6c21da2781870bb01adf219899c7136,1775,FALSE,3972,2197,Dire
ca42b8beaff70101cb79c7e1d960d40d,1760,FALSE,2855,1095,Dire
1f874260cfd342a1596b1c971971d715,92,TRUE,1703,1611,
3324702e1b445ae3eac3a5c2bcd4510d,1524,TRUE,2305,781,
23720b5dc2e4e505f164cc39bc0d12a2,1441,TRUE,3342,1901,Radiant
f0421d0c945f6e39c413a5b6754d49a9,2119,TRUE,3195,1076,Radiant
3eb1b80348dec85754c63ce6d2047ea5,618,TRUE,1815,1197,
4a1d580d029ba8113112c9242761dda6,1503,FALSE,2147,644,Dire
24dd97a0c5e20e1b5c232a9fa551d6d6,396,TRUE,1874,1478,Radiant
86f2f705a718af979f59153fb7ab453d,1529,TRUE,1911,382,
226dd9e2630d5273959906e4d039daf4,2696,TRUE,3155,459,
d449185387941de4cf830844cb594f46,274,TRUE,2163,1889,
f3e74c3e320dbea253be6c70fe696c25,1565,TRUE,3261,1696,Radiant
dbc5c2372ac9df75d9b34e2a05e2fc18,2811,FALSE,3384,573,
6a21def9e6d9366ffeb0c1217c2e48e2,662,TRUE,2093,1431,Radiant
9274c5531ec41adc9ff20597873ba565,1433,TRUE,2121,688,Radiant
65ed9675b56773649e6e79566245ccf2,1110,FALSE,1863,753,
4540666c61cde6fc0e45f84ab65e0d6d,808,TRUE,1884,1076,Radiant
37bbd352514784d7b10e4c973eb717b0,1115,TRUE,1711,596,Radiant
67c36b65e07513be72af45270c4214e7,316,TRUE,1545,1229,
642eaabb4902974772c765db69ee1865,248,FALSE,3996,3748,Radiant
0ac23a960a79e568bbc64568b147eed2,1444,FALSE,2248,804,Dire
9533b6e9251e16f1a19b11ab90af6a35,1006,TRUE,2672,1666,Radiant
b407ee3b064a7853ebfddea9d9ee93a6,1668,TRUE,2836,1168,Dire
0bde9db3bf1e6f8508b7404a4f004daa,1194,TRUE,2226,1032,Radiant
e0395c3d619ef9c736d778833c4100b9,261,TRUE,3283,3022,Radiant
04612b903deedc3785943aeb88e926f7,2766,FALSE,2855,89,
629986ef93bc178cc33a11aac34a7142,1755,FALSE,3109,1354,Dire
0d75adc84cc3f9d9f1c574e43920abd1,841,FALSE,1241,400,
7f1a6328b309d3c02f6f459e9df0be02,1097,TRUE,1737,640,Radiant
e8b40b2f7fdb24f94b632c0a1141dc23,410,TRUE,2008,1598,Dire
fe494ff5ccaf03fbbbe0c2ce6695ca87,1786,FALSE,3846,2060,Dire
4fe86559ce40b4c7815eb4acf8e9a294,658,FALSE,1953,1295,Dire
96133491b85e8fb916871b09524cbd68,901,TRUE,1736,835,Dire
2d3898d87322d12f89327a87961faaa7,209,FALSE,2117,1908,Dire
fb206357a30ba0ae45ff9ae6adce5edf,215,FALSE,1958,1743,
370e7b5dc798046aeeccfad7da236dfa,1909,TRUE,1941,32,
122d40fa65056bef06ad1e8a1b2a6b7d,1037,FALSE,2495,1458,Dire
82de8d47815c75d228aa213a9cdcf12a,1192,FALSE,1552,360,
12978d7c3a965ae112911912dd343354,239,TRUE,1871,1632,Radiant
9219787c2b385ee29d01b3a163253639,847,FALSE,3501,2654,Radiant
711dec32479707a0320ed819e9180d30,723,TRUE,1521,798,
80c154dc47a58cf65bab37c08c21b9f0,787,FALSE,1709,922,Dire
b3c30b48b3838c6b04619fad36fa4a21,18,FALSE,1536,1518,
eeed3b998ed3ab391e2e7463fb4138e8,95,TRUE,2554,2459,Dire
93d03385ae26ac40ef5756a6570591fe,844,FALSE,1573,729,
fe9ddef2ec1780a9d419dcdcf5ac1ae4,501,TRUE,2642,2141,Radiant
f0f4558b0969ad54b9b6acc9749db8a1,1909,TRUE,2499,590,
6a30ec9126c3104cdb22a4be6492a941,1062,TRUE,2222,1160,Radiant
fd3f21f7c6555c37dd0853bf88924087,947,FALSE,2564,1617,Dire
ff213d49414a5bf9a9d0959f24a8407d,325,FALSE,2801,2476,Dire
9e6efe013c5f927dedc03d89e548d04b,551,FALSE,1970,1419,Dire
a347b86e00ca4a8708f037512366830b,517,FALSE,2832,2315,Dire
bc7e8065126a3bf44d12c09b978ebe92,2976,TRUE,3536,560,
190fa278395cbdc6e00f3e207224cabc,300,FALSE,2224,1924,Dire
576b7c863647f71d4e202e39cce980f8,948,FALSE,1916,968,Dire
9593a3f11248f479a2db40176e47ce72,334,TRUE,2714,2380,Dire
c9ed8212200488d39354d6044d39b08b,501,FALSE,2602,2101,Radiant
c4b18aec9182274102a23e6db472e6f0,434,FALSE,1771,1337,Dire
9dc6f0c1471fcd8516bd57c56f1f19be,325,FALSE,2674,2349,Dire
2272d0cd890e90e08a3cda6791181bef,2259,FALSE,3325,1066,Dire
754a150d436b7baa691f9b5aa25d71b5,1186,FALSE,2202,1016,
a8dcb7a0730ab027fe1da292d63c8524,2024,FALSE,3197,1173,Dire
41552c7aa5d337a338e2e3053769bc16,2203,TRUE,2473,270,
1234c5c5d9d1ad2321534447dee4a842,321,TRUE,3059,2738,Dire
2201116d6965215951b5665ef1c7e56d,1317,FALSE,2139,822,
511244ac5533a959b531537e6da5651e,1660,TRUE,2781,1121,Radiant
00d4cee5c371ada231364dcf08bc6b79,2157,TRUE,2497,340,
cd23d8a412d2dd79092a8d788096f1ce,1035,TRUE,3107,2072,Dire
b56ea18db1408fc68263757232c1facb,958,FALSE,2033,1075,Radiant
77d2b4857033c53e3ad241f67aa619da,367,FALSE,1942,1575,Dire
b741ea0afccc04c3f068f4cd72ffe10e,3305,FALSE,3394,89,
607987430f3b77c0ae42ceb0526328d6,433,TRUE,3453,3020,Radiant
9f526bbb18679fbe3a7099fb3d2fc0a4,890,FALSE,2533,1643,Dire
19424f57e8c948cbb59c949ee700bd80,1219,TRUE,2882,1663,Radiant
4945649be973b40ba6b5f95269e1a7a5,817,TRUE,2486,1669,Dire
dd71dbe568d412ab5aa5e50e71d7df92,1598,FALSE,1828,230,Dire
5ca236b9b890a0e1596bd03d7b566ff5,515,TRUE,1297,782,Radiant
f83096327430e2eec104b933abfc7fad,668,TRUE,2071,1403,Radiant
14ff9e74a038cad2c41393ee8a55df40,850,TRUE,1354,504,
51b930d4c6f065392b227ce96df538c2,2329,TRUE,3096,767,Dire
e93d0a2330bf157545f1e992f6282b78,1351,FALSE,3138,1787,Dire
6457b15a82f9592bc779cc14c0c96885,520,TRUE,1099,579,
8daa0c5756547e0a4f7c877ad4ea8d2b,1507,FALSE,2136,629,Dire
9acfb9ac92fb53e63ae6a651123743a8,205,TRUE,994,789,
f74a02f4002ca03bc22d8104bf39efc6,2361,TRUE,2718,357,
32f2d3495c36bb1476faed1dc56d1625,1332,FALSE,2779,1447,Radiant
298e300e93832356c5de5f13219840b8,1302,TRUE,3604,2302,Dire
a382bf665debfb590346d4c21fb1bb0c,4,TRUE,2360,2356,Radiant
add2313f5c96c0434fa825c09f0bba62,2100,FALSE,2515,415,Dire
fce24ca089aae7d654f40c16d4c24b29,1103,TRUE,1600,497,
8dbc7d2b3b2533b7f7ac5faa3e934d8d,718,TRUE,2644,1926,Radiant
f40adc10ca1e14a4cfad38c8e41fafb7,1208,FALSE,3363,2155,Radiant
1eccb0e3547ba0dc97ac2e8d73c6c1d1,840,TRUE,2583,1743,
3c0cd4e0163c634fae88cea406ec34b1,1190,FALSE,1837,647,Dire
c4382945c4ba6dc270a24b743393918d,1607,TRUE,2540,933,Radiant
89f161ddbb5ace719fa20052671f86a1,368,FALSE,1680,1312,Dire
8ecf3ce040ef51ac2d7549ca0dbba861,1847,TRUE,2459,612,Radiant
e47e53b627f56d6e827bdfd693b482f3,1127,FALSE,3223,2096,Dire
e82632f8140b88b9e3ecff25b56db241,2338,FALSE,2802,464,
64b692bbb60e9142348f0c5743a941f4,18,TRUE,1942,1924,Dire
13e9bcc406f41da65c4490acde5ebc31,623,TRUE,1544,921,Radiant
9ee3a6f5719738449ae3d0514d8a8d37,1586,TRUE,2335,749,Radiant
106fdcfac0c2ded724eb2d3274bb483e,146,TRUE,2188,2042,
dae79c3b3e490de5e8760955e0104c8c,1435,TRUE,2182,747,Radiant
43f48f14254ca6c46d515c872c0f4c60,482,TRUE,2028,1546,Radiant
fd0f070411e0ef7ea846ce08f3c9fdd9,1697,TRUE,2079,382,Radiant
c4e75c9e1944ab0b55c8e40c76a33d26,1893,TRUE,3512,1619,Dire
4fe850734418e35a3e22f688e766eb0c,198,TRUE,2224,2026,Dire
3864395ce2c44be42746325e57426104,841,FALSE,2529,1688,
610753fd39ee6989d6187985054bb597,26,FALSE,2385,2359,
d2ec38da57da417786b4df940f62e9e1,714,TRUE,1202,488,
d8a11d1efcbd27bec865a8d24542eeea,1247,TRUE,2757,1510,Radiant
af1dee0fa4a7f77aab21744e23a8dd28,1498,TRUE,2448,950,
aa4d7f4c6cbd6dc67792066aba54bd92,1729,TRUE,3142,1413,Radiant
9435433fbaec389d93d84e1f88b3a35e,2736,FALSE,3360,624,Dire
46c416d1682afda990aeb86a11bc8be5,689,TRUE,2235,1546,
c1d8511c58ece0d1309187c53f149f4b,103,FALSE,1607,1504,Dire
3f468c829c1b13323b8d9ef96bf0d014,87,TRUE,2044,1957,
df6274f2025eb81985fded21359d5711,714,TRUE,3319,2605,Dire
ad819bf5a5140f0d7e93fc7c9bc1bb06,1261,FALSE,3577,2316,Dire
9345fe5d653e202a213758647d478927,1693,TRUE,2685,992,Radiant
d3edb565de9292d4b1b38f4373a0e063,475,TRUE,2522,2047,Radiant
f92b354597d5f849756ae87309f1baf7,1597,TRUE,2639,1042,Dire
5d217744a9e9f7738d8d6a58bad7f655,769,FALSE,3088,2319,Dire
f4052bf84de5dc918b2cc3ad0e6410a7,138,TRUE,2659,2521,Radiant
d18ff1fee68b2d63312d090f130c9f5c,2775,FALSE,3019,244,
d464de7959de7b1038bc053a63aa64d7,0,TRUE,1090,1090,Radiant
fb6af18eb19002b0a6868a59a3baa282,1853,FALSE,2212,359,
e20807bc7936a260f7cf21fc32ae3b70,818,FALSE,2147,1329,
2356cec27419f5de07d9396a5e0d0063,1314,TRUE,1658,344,Radiant
dc4e250a2a030be5b9744707e5b3d77f,544,FALSE,3678,3134,Radiant
45b0f7512eb1681fea81a25ce7d67a39,1688,TRUE,3382,1694,Radiant
8f1186ceda4d77b4092d3e2dde21b2ba,1105,FALSE,2902,1797,Dire
35dcc70f4a2f7049cbd63d2029cdb47a,2266,FALSE,2958,692,
527ac40766ad2d51a6718925ce9b1a4d,1514,TRUE,2525,1011,Radiant
37cddab879519695164491a8a179f3eb,847,TRUE,2177,1330,Radiant
087df5988adb1cb2d0b545e1eaede412,1855,FALSE,2791,936,
a9661166bde584261f9079b7c45b2121,703,FALSE,1789,1086,Dire
622ddd4e43019615a95d9fa7ad03d0a5,1966,TRUE,2020,54,
e668b7a65e2475c7a4209ab3651b9e2f,1475,TRUE,1707,232,
ca1178e5bbd3b495d674ef0478b2b8ca,769,FALSE,4282,3513,Radiant
83a134804ed4488b6b336b422532690e,519,FALSE,2928,2409,Dire
7eb8850085ed1d7ad7a04c7c28b48514,931,TRUE,1554,623,Radiant
f09501e0e25eba329017668fed9794d3,623,FALSE,2212,1589,Radiant
200a726b3a91cbb59d36930973bee0b9,771,TRUE,2877,2106,Radiant
e5ead2adc1dc16760ca37577fc62649a,1112,FALSE,2922,1810,Dire
a6d27d1eff5c472ef19716f9b4876e48,557,TRUE,1900,1343,Radiant
d51de2454e95e7d37f3b18280bda0152,426,FALSE,1898,1472,
7caafa033b19e97aaacd4660e4f649d3,239,TRUE,1534,1295,
c52400c06c7e8d0e0fe13ec54e31ece0,1784,FALSE,1854,70,
7301208a60d7fc5345d23c92eefe7e82,830,FALSE,1808,978,
2e273d9154a25949bd3ecf455dfb5515,355,TRUE,2287,1932,Radiant
f13e6b425a7846217aa646dc94b5d286,179,TRUE,1072,893,
640958bed77fa3c591f499c8de4cf52e,850,FALSE,2203,1353,Dire
580948831e8d51f486cf2e6ee9803434,1668,FALSE,2056,388,
86198e676d1c9ccfe3d65011c0d62053,1265,FALSE,2083,818,Radiant
e57b88842858a58f4ad29e831f3028f2,2644,FALSE,2694,50,
ec45bbaf1c4d141cafc41bf8870acd3b,1057,FALSE,2128,1071,
7f810524ba244d97664ecb94c99f0d41,1062,TRUE,1392,330,
4386126db3cfaf1417c444837aa7bd46,835,FALSE,2234,1399,Radiant
0ae0f75bdbe6df52741d2b3bb8516e01,1861,FALSE,2522,661,Dire
2f2f9b1a4d26b1e3e3ba5c6356479861,1216,TRUE,2292,1076,Radiant
fd9aa2d624869cb7bdb363070d7cc99b,1035,FALSE,1767,732,
c74a9c9195e50653be59936be0ba9aed,2042,TRUE,2169,127,
6db2ed0916219a661cedd181a4eb8548,107,FALSE,2106,1999,Dire
2bf6ae6b92c29411980c56550fe6b714,2083,TRUE,2262,179,Radiant
d4e6ee7bc5195e99ac01d53c4823bf75,897,FALSE,2337,1440,Dire
f247fbdeacbd7d1b31cad4a29c82de9d,2001,TRUE,2195,194,
11015644a7aa610a8b5a9848cc2b6995,2618,FALSE,3132,514,Dire
f66cd1a4e7906f8af453dacd0ffa5976,1488,TRUE,2046,558,Radiant
d55717aabd3855bcfad2b32a724a1292,106,FALSE,2049,1943,
2d095ed2585409e4776833b1c4a5ca3f,1342,FALSE,2838,1496,Radiant
49d3cd11cbcb68e1e8e210af16add1f1,1721,TRUE,2593,872,
3e942062b103c027315b926c63c74f3b,447,FALSE,2096,1649,Dire
5a7b3a43116ef508f9a57fe2508e3db4,894,FALSE,2731,1837,Radiant
8c948e76fe4690b1aafb262d6f590cb0,615,FALSE,1995,1380,Dire
abd7524e49633463349922c379f78cf9,1041,FALSE,2152,1111,
8413a6f1f9ec7d8728cfd7db38b47f80,328,FALSE,2317,1989,Dire
8a9be33637321658a9005ee050b5ec5b,822,TRUE,1858,1036,Radiant
e1471ed2afd51fb432bed6edc0100f54,2376,TRUE,2597,221,
cc419db39d140000ab078f7060064916,316,FALSE,2639,2323,Dire
00b85496c3cb99533b9c2340b171655b,1394,TRUE,1708,314,Radiant
cbe301d4af058c2afdd4b6b9a5b18771,1208,TRUE,2273,1065,Radiant
4fa5a9fceebcedee1d424e269ff9019f,308,TRUE,1893,1585,
df508f1b17583a01748275a2370116e4,475,TRUE,3010,2535,Dire
daf2724ecc1652d639a2c5639a598eec,1903,TRUE,2293,390,
f5f9b90bb60768749e3103de7e37bd0a,1732,TRUE,2602,870,Dire
9da8b425d892e8e89f6d2fc735b446c2,1021,TRUE,3009,1988,Dire
7451d509e47936083299b170af704da5,1806,FALSE,2528,722,Radiant
56dc066fe42e134ac72c8753a93e7d4e,148,FALSE,1102,954,Dire
02a3e67eac761ec1dcb7772d2d514a4c,511,TRUE,1578,1067,Radiant
a5a526cb8738add322b01d4f952c0506,350,FALSE,1418,1068,Dire
e71376d706f5ed4cdf7b482f6db99cc1,709,TRUE,2070,1361,Radiant
c694830dfd3f80012dc418db6fb1939d,1931,TRUE,3412,1481,Dire
35123431e5041e802fab4f28a30acf96,645,TRUE,3002,2357,Dire
a77f052db1f282deb3e18be06493ae6f,1082,TRUE,2248,1166,Radiant
11a544fbb8b9c1b3a959b3c7d73b49d4,1518,TRUE,1615,97,Radiant
85bb841ac09e9942f598c69612345e32,1812,FALSE,2272,460,
db31698ace44b6c55e21315d50258a0f,2042,TRUE,2184,142,
b554aca7223cf03191d47f5ca67a8f7d,805,FALSE,2419,1614,
f26f1e5da7ff94fcb623d56fd8ffe863,206,TRUE,4106,3900,Dire
40438a257eadbaf4a553ab22bbc6a614,625,FALSE,2556,1931,Dire
c9a02edca93221361d7a4a43db70bd7e,514,TRUE,2866,2352,Radiant
93900a823f4ab6762789370c574c59e6,490,TRUE,2234,1744,Radiant
733b4b55bae7b5af5f90b51c87a07a5c,1588,TRUE,3296,1708,Radiant
1497e0bd519c67f3b1d547027657562a,1477,FALSE,3670,2193,Dire
d34b1ad517609ad6ec0983ae63f2fea7,709,TRUE,2648,1939,Radiant
0ade32565fb81f54857a15d1063b7731,411,FALSE,1547,1136,
872936352530317b4809f8c4c5b7cc24,1310,TRUE,2169,859,
d77355065831f3a6d6f7af8a7faf8724,522,TRUE,2702,2180,Radiant
83f79b0d91595d4c88fb7d24a109d1b9,219,TRUE,3289,3070,Radiant
af552678a13e029deaf85cae288de9cb,710,FALSE,2568,1858,Radiant
1b81ab28699b32021993cea1ce8cc868,256,FALSE,2279,2023,Dire
fdb04a86a5ec45e7d4b2db4e09b6c70e,1151,TRUE,2458,1307,Dire
5cc415b2a1e9b2ab504f3ef7482fbd30,1745,FALSE,2430,685,Dire
24554673cd034b3293aa828d8a55fc15,608,FALSE,1819,1211,Dire
aba797a314357b431c0155dfbdd9e952,910,TRUE,1247,337,
f7fff94290c71dd5297261347c030e8a,439,TRUE,1980,1541,Radiant
b710cbab04353ed353d2ea930336b425,668,TRUE,2547,1879,Dire
2ae0172cd6d053bde325d34f888c904a,691,TRUE,2653,1962,Radiant
16d77415a0ee42bb973792bd0901f1c2,7,TRUE,2851,2844,Dire
f052a5b708a2dfb5579dd364781f05f0,772,TRUE,1001,229,
4bb8cb6e27f788f900e6bf2f226e615d,1479,FALSE,3056,1577,Dire
340e5f50997ba17286b1a22de0a1a1f5,505,FALSE,2234,1729,Dire
d2be5011118b46cc659b0218ac1496e5,760,FALSE,3074,2314,Dire
c464dc393eed3c3be0185ae7b531f550,570,TRUE,3095,2525,Radiant
dfc93dd1a38cb1891d1fa3d28bd87f8b,563,FALSE,3263,2700,Dire
edd24f12f5a6425adcf529a57ddd93a8,973,FALSE,2843,1870,Dire
1891a86c5b2b52123520ed838ca143c4,1635,FALSE,2692,1057,Radiant
2f5b3348fdaa0c33c711b6d73f740601,1353,TRUE,2340,987,Radiant
d61649728ad59c9c80f44b484e4da611,415,TRUE,2623,2208,Radiant
3620195c50e6f1f1a7b1ceb297f65782,214,TRUE,2147,1933,Radiant
79eb614831d512dfac95b70579e2f341,2272,FALSE,2358,86,
cd057b46b6e34658b531f94330861a91,1038,FALSE,2021,983,
8089288ed2f87d7b50f3b9b14ef6e27d,162,TRUE,1727,1565,
70cdcb690fc6678520ed2b9e725631c1,1347,FALSE,2412,1065,Dire
cab6cd1327637df4741ac54776a171b5,2031,TRUE,2262,231,
f9f32b01899bbcef045aeca1f25a1baa,28,TRUE,2312,2284,Radiant
b742a392e0729ec832dd2c96cf38a2ef,1578,FALSE,1700,122,
658613cedff7f72b421e02b121b54965,493,TRUE,2321,1828,Radiant
f8a5b172260132d62756a65f068ef6b3,1714,TRUE,3540,1826,Radiant
88c217d919950eb522f5aa95ffcfeaef,172,FALSE,2573,2401,
d707681fcabdef33fce87440a9166d92,1085,TRUE,1732,647,
f2df0b77955e734033c6ab2e06006616,1453,TRUE,2246,793,
0341abe85bff033284cbc05f0a7db81c,600,FALSE,2561,1961,Radiant
a260d96cb7142b70d423c3838b9656ee,1540,TRUE,2814,1274,Radiant
228d858658e0073ea5e6818b3f0fee0b,336,TRUE,1958,1622,
7de4dfc1e13b0b4d850702158eac74e5,390,FALSE,2838,2448,Dire
60872a3e1fe77059a618d506a2cc79c1,987,FALSE,2410,1423,Dire
36ace6ad906714d09015109568134db8,1958,TRUE,2089,131,
7a6867b46fff722e59c19fa29ad262e0,1280,TRUE,3948,2668,Dire
25b6f8cac2830509c4b8b34ae3503b6f,818,TRUE,1662,844,
ef6643559bc0e7b86b60a29b564c00f1,2169,FALSE,2266,97,
2c736a6432bb54d59e2b595a242af54d,1506,TRUE,2732,1226,
6af4de0a62f2eafb4d4cc8ca0a4c2a25,293,FALSE,1737,1444,Dire
060f1ea8c2716f22a7bb1f0574d395e0,1084,TRUE,1929,845,Radiant
f3065109a4440b23f71aa94008dc64b4,1114,FALSE,2903,1789,Radiant
9758b35f9acc89ef950992840ac0439a,1481,FALSE,2670,1189,Dire
3543629d01893050017d64bc7c62c387,669,FALSE,2081,1412,
d099949675615a226d07fb99a54f5071,848,TRUE,1592,744,Radiant
926992158eb874e81f6d7bb74652e825,1790,FALSE,2619,829,Radiant
90018bbd5a909ea44515d5da55d6c87c,1233,TRUE,4092,2859,Radiant
8c07a09457b34f5649936a516ff26838,561,FALSE,3117,2556,Dire
94164606f6bf4eb59965ad1b153f7e2d,1874,TRUE,2220,346,
8d57f055806feb0aab1430c56ae08ff8,72,FALSE,1972,1900,
a8bc9768a987878debe82fb4588acc08,291,TRUE,1466,1175,
ee3b605a8fbb32ce471202181595d4ec,1144,FALSE,2336,1192,Dire
e2b48e58a8e939efcd8bf9f44e6bb01d,1407,FALSE,2510,1103,Radiant
054822a4bfb4a185a5abe2d2c9740ef8,94,TRUE,1343,1249,Radiant
aa9085cd55492560d4a6c349c337e75c,227,FALSE,2211,1984,
49b190bbb5ae8f77458c6378055f108e,1872,FALSE,2965,1093,Radiant
68040810de5aa50573b93fddf6b8aa28,1973,TRUE,2604,631,Radiant
acae9311f31a4a57ac2d7164c6afb52b,2981,FALSE,3015,34,
f97ae9211b891b75e302f221b22013e6,578,FALSE,2605,2027,Dire
d81055eff2b8dfdf8859fdd3743126df,923,TRUE,1495,572,
c53f4283aa77aa9a5506e396e777968d,545,FALSE,1348,803,Dire
fdfd27284f06f1d7fbed2a8ec10ce896,1043,FALSE,2180,1137,Dire
2341bcc578ec1c41c217e0f4d9f34a2f,1390,FALSE,2435,1045,Dire
d6aaa932757e6bc9d8111d93611c4f88,2188,TRUE,2764,576,Dire
eca034fb0e154a5ef84a92edaf6f5867,1349,TRUE,1506,157,
2989f746b782f9cc6cbf4b8ade762862,766,TRUE,2959,2193,Dire
467e50a20e6374642684c1e72dd4d3fa,980,TRUE,1728,748,Radiant
b93b86f9b09c55371c0e900c5b6ecb47,1926,FALSE,3316,1390,Dire
3d922e5b5e9e9f5d91dfe0aba246e517,1780,TRUE,1873,93,
578184d5c6cda1051d3588487ebaeb8d,1195,FALSE,2157,962,Dire
5bb8a7dafbf318b6eb0ee3847721d6cf,455,TRUE,3774,3319,Dire
c04e5b04fdcf9ff29b14487a30e00929,1564,FALSE,2154,590,Dire
7541cadfc6c619ef1370c8fe1dc08ae5,1709,TRUE,2116,407,Radiant
ba5822e8a8a625ec83626be53ad7bcfe,410,FALSE,1221,811,
d41e4972dfe3cbab56a6480d2e072b64,893,TRUE,1899,1006,Radiant
48f42bbd0f936843ef0f19c5b2fac6c6,1499,TRUE,2399,900,Radiant
8eb300378ea2f297622dfc8eea083c79,1465,TRUE,2613,1148,Dire
ab64cfac0ecb281f5770560dc81bc92e,3386,TRUE,3452,66,
16cfdc6f26cd7c5b172189fe97891e80,238,FALSE,2429,2191,
93724e8722c08d3dd74e10f895e44469,345,FALSE,3284,2939,Dire
1a05668f169145d76ada0aed947ca3c7,1812,FALSE,2988,1176,Dire
219947e63e085420e0ccf7bbc287ce4c,786,FALSE,2597,1811,Radiant
95000746a2ca3c080a9fe2c1943da7d1,16,FALSE,1220,1204,
32b0efd6ef5b61e84662088d1e59245d,849,TRUE,2484,1635,Radiant
34554509854a616d67a1810f000f2fb3,778,TRUE,1273,495,
f8ef7ceb86128f7b63cd676c36caf5b0,488,FALSE,1918,1430,Radiant
5481b411067e499adda786bfaa3bc55c,1070,FALSE,1434,364,
258d886d487834e96b10595878b06106,176,FALSE,2361,2185,
b094f15dbecf48a1a0047ad248a0e6bc,1482,TRUE,1705,223,
3e42a3499c739152eaedebbe3abbf3fd,1791,TRUE,3408,1617,Dire
7f42a0d274b0839ebbc7a22c39127f83,647,TRUE,2195,1548,
50005828979f8ac67e8aa20ebdda69e0,1062,TRUE,1781,719,Radiant
c6b339b1089ed64f655b369e068f60d0,985,FALSE,1616,631,Dire
70956363b8575602888851bcaf10725b,2809,TRUE,2977,168,
843181bad36cbb4e85e4a40d3b6e65fe,2708,FALSE,3437,729,Dire
fd91d128fcf0c6346e1a73a4595c1071,1529,FALSE,1684,155,
486c662532a26bfa8a53752f63f22631,2457,TRUE,2550,93,
8778bb97ac4415d857e586a6ca681adb,2400,TRUE,2634,234,
37b534900f46508c9eee041e1f8f7248,2306,TRUE,2739,433,Radiant
d6becc86064033acfd307a68e49d53aa,650,TRUE,2610,1960,Dire
21145b3399791fc38f7c57380a4aa1e5,1232,FALSE,2727,1495,Dire
5351b39504bd35ec16c16f1288798ab9,1947,TRUE,2373,426,Radiant
f1d40f6834e3ac2c46aff92a3cc8f4d0,1774,FALSE,2803,1029,Radiant
257d263bd1d0168de55df2055b4c361e,1441,FALSE,1997,556,Dire
797bfaf1a3ff926aed9bcc6ff8068e8d,197,TRUE,2443,2246,Radiant
711cd912cfc6fa87d0408795fa10ceec,1095,TRUE,2604,1509,Radiant
c825b60844a07e56bf3ffa2c0c5e8384,727,FALSE,3414,2687,Radiant
0df741baaa985c48a337d7ebcd50245e,425,TRUE,1833,1408,Radiant
466c0a02708bfc9e584d085c0a3bb505,1998,FALSE,3045,1047,Dire
d1d3c78bca0c6eefa883cbd8ef9ab1b7,1051,TRUE,1160,109,
a7fcd4c52b401dadf8a67b80a6686aa1,2039,FALSE,2283,244,Dire
5005f4139b225d957bc3ffaee3306ca2,1662,TRUE,1891,229,
102616aa62c01aabb4a906038d4e524a,1176,TRUE,1602,426,
9d991261199dc0a6bc3e8e0d8e5aebc7,46,TRUE,1517,1471,Dire
d1b6dd18ff55039f987a823b1f87382a,586,FALSE,2859,2273,Radiant
2542fe2bad8605ba21638ed2d90c6a51,1105,TRUE,1877,772,Radiant
72fb9774eca72a1e0cb8800a48494b3f,1857,FALSE,2026,169,
cd5e5f95e9132ffabbf717bad9f0bbed,2354,TRUE,3604,1250,Radiant
b43acc20d17a0ac239ece1a63f2371fc,214,TRUE,2180,1966,Radiant
79090dfbf829e74eda323b10b85b943a,1456,FALSE,3083,1627,Dire
d39687beeb6f6ac46d4eea715b8c749f,971,FALSE,3066,2095,
c2b0e21afcd03fd935aa660806c08f33,609,TRUE,2275,1666,Radiant
70b29fc0db71bd49adf3cad794deed61,426,FALSE,1907,1481,
8d154c608012be92ea56ce5d5a2b0157,552,FALSE,4490,3938,Radiant
c355a67fe2a408a43f9a38c27d7c19a7,3658,TRUE,3922,264,Dire
1c3d84c673f8b4ec53c7ccb2077243d7,2115,TRUE,2632,517,Radiant
4464642d8bc9efdc6be4640f39e3a0fc,838,FALSE,2182,1344,Dire
9536262c48f8bb7af0fa379e07a31253,3289,FALSE,3623,334,Dire
dcad0d62f4c5ce015d1babefc8f62609,1728,TRUE,2788,1060,Radiant
b92be3b841204095c9ceaa1723ecad4d,1374,FALSE,2518,1144,Dire
1fffebc6c1e0ba59ff9c2661d4603c4d,369,TRUE,2711,2342,Radiant
99316b77221a4fb0168f024ba4a67d03,2430,FALSE,2719,289,
8467c17a87d82a2954d1f4dad0b27b60,827,TRUE,1929,1102,
2cb5e2a0600b01e9cc69da76a6cbdc74,967,FALSE,2401,1434,Dire
7dc37db837c134b3355d9128cdecfb23,1071,FALSE,1955,884,Dire
41c243f2842f96b504533bda43b2f6be,91,TRUE,2353,2262,Radiant
a6bf79084614566781b8169d005a32c4,1037,TRUE,1943,906,
97c804597924110a52767eed1cf1b88f,840,TRUE,1591,751,Radiant
ae5fe5562b4f0a45bd11c68f11330b2b,296,FALSE,2383,2087,Dire
45d1b7dc9a53514d27c2fdf030335572,2245,TRUE,2782,537,Radiant
ccd6584be2cc8828186b2d2f77494692,53,FALSE,3598,3545,Radiant
cc039d6a57757e0e25c092aa626c13b2,1753,FALSE,2280,527,Radiant
b791e4155fe7bfcdcbe2f05378de6d5b,729,TRUE,2568,1839,Radiant
86e3044222473baaf4c87a91bc8271d5,1686,FALSE,2764,1078,Dire
13963fee4fa71870a9fba41430301fbb,835,TRUE,2170,1335,Radiant
23c3fd6acde1b266872873dc4377c13a,783,FALSE,1453,670,
b971c0b366d503b642c7828e7e586849,1976,TRUE,2027,51,
c17e41093d8d2d2aeb019bc240d520c8,1727,TRUE,2801,1074,Radiant
2ad3cc568c9fb5941d050850c00e18a6,1980,FALSE,2085,105,
baea1105efe53894bcce83ad7669e672,2121,TRUE,2557,436,
605e1cf3ac2f401f9c3c2733b6c672e3,941,FALSE,3399,2458,Dire
e3d9d5ac78ea394d768723c7d272125f,334,TRUE,1962,1628,Dire
a112b58bcc7d75fcfc8c9db5a61d5cc5,996,FALSE,3090,2094,Dire
c10d2d918e9cae448849d57cce40b47e,1178,FALSE,1893,715,
d439f972ec7a658de11f14906de244aa,862,TRUE,2116,1254,Dire
2b50ec09ea08a282f5f2592a7ccbbdf2,1060,TRUE,1661,601,Radiant
9d5b05c6aa12c371cacd50dcea060c13,2055,FALSE,2733,678,Radiant
2dd6c4f16236462e8aaeb591a8a80ee6,172,TRUE,1707,1535,
c4d201d67715a96b469909ce45658e95,1963,TRUE,3717,1754,Radiant
1b94d66eb5a2be19afda9690f78d0b96,839,TRUE,2771,1932,Radiant
dc19f722d1e2d3c4a947fc1a440a114a,2547,FALSE,4914,2367,Dire
72081784d3547d303324dfee6fa61a42,752,TRUE,2223,1471,Radiant
0620380f1b7b3bc90488bab664cd1527,1136,TRUE,2746,1610,Radiant
0218af45c10734696c20052881f33c4d,32,TRUE,967,935,
b9513ff8a9630d86b852b43f401d8da7,1122,TRUE,1619,497,
6b690b0802a0a5021f99b0b23dad5837,1163,TRUE,1881,718,
640d709095e55f80906443923bd84f4f,437,FALSE,2456,2019,Dire
7f5df31d118a45b40a47a8ea37adf143,785,TRUE,1188,403,
4d94fab055d26c50b27ab5da8121e126,598,TRUE,1791,1193,
13fb0449f8505721e4dbbb00de92c6dc,1834,FALSE,1937,103,
65e09d7f7e60261f10222e2b6b835cfd,60,FALSE,3533,3473,Dire
71b86e636d1cf82bf372f2988d543006,3011,TRUE,3045,34,
f838e6ab1aff0ac02dc69f58b09e617c,41,TRUE,3891,3850,Radiant
462fba89916cee6d95fca9604330fec8,840,TRUE,1663,823,Radiant
cc2a0de53117751a230f956b580555a1,1085,FALSE,2527,1442,Dire
e96abdb0459048a22cd6029739b19ab1,1356,FALSE,2380,1024,Dire
32d192030dfadb526a2f08ed092726c6,468,FALSE,1321,853,
a3053c51cc7277f1a82eaefdfae080ee,1397,TRUE,2080,683,Radiant
f273c355ff6975baf5a18a84ad22402a,1142,FALSE,1878,736,
8888e105548d2dce0e8d63ff8262fc61,2063,TRUE,2684,621,
3ed11a7f9e6d78b58899febc64a8b2f1,386,TRUE,1945,1559,
2c13dc4a4ef18dfb53da5151fce64b50,1879,FALSE,1918,39,
546629cd1b2428ab2c314a09ac53cb2a,1198,TRUE,2048,850,Radiant
f84315e0a821ac8ee27c185eb64d61c5,955,TRUE,1470,515,Radiant
bacab526f7db77a5b29db96acc18654f,742,TRUE,2440,1698,Radiant
6a609c776a2bb70aa542db6a92f8c4db,1940,TRUE,3134,1194,Dire
ce09923a39f5f5c424bd7064927edf16,890,TRUE,2035,1145,
d55d6d88094411a6f77e65750fe55302,1573,TRUE,2938,1365,
3775521ab49975aaf7e19877ea79438e,746,TRUE,2641,1895,Dire
7b9f01915ac075804a2caea66926b6c0,2224,TRUE,3281,1057,Dire
166d301039117f3245ae39bb040137f3,1735,TRUE,2006,271,
4396c38493a0b9e93809093dc8165016,2059,TRUE,2835,776,Radiant
7e1eb7c06da477acfc6922772037ce79,1436,FALSE,3115,1679,Radiant
aedae7b8f9e25a0455a1cd6363665964,1823,FALSE,2969,1146,Dire
856c99ede73feaf8f3a655ff5a437bc1,371,TRUE,1790,1419,Radiant
bf8a8c236a73090798dc630f14b2163f,1121,TRUE,2698,1577,Dire
80831f8e8042f353efddef2a0e72ddf6,955,TRUE,2184,1229,
63475259b68659f82a4f442f92595779,16,TRUE,1439,1423,Radiant
86efefb6716ca99c51190fa13fd1b3e3,891,FALSE,2402,1511,Dire
af24a4a8ce283023343d332a3aafc0d0,1628,FALSE,1907,279,Dire
1cee1a05a4d498d333385f5708151969,2032,TRUE,3339,1307,Radiant
a5b5c8fb5571916e501b4eff764ddd62,858,TRUE,1452,594,
c188690a498c6128aa5b65e4f277f81e,837,TRUE,2823,1986,Radiant
5d5d9f330cd55cd77b075eea0cfda22a,894,FALSE,1787,893,
3eb75e402db036f58fc5103372c7e7e9,2020,TRUE,2369,349,Radiant
ecf209719f347f8749b4fce825640005,384,FALSE,1072,688,
b0606d708df58e2c183c0298b6fa8a83,1158,TRUE,1365,207,
40a2c45b481bfb91369374ad9e78ec30,522,TRUE,2231,1709,
09719045bc0132851db3dc50f985eae3,2254,FALSE,3218,964,Radiant
6c972b23e80135bcf7594b08e1924bdd,40,FALSE,2056,2016,Dire
0833c5a9d7e573bee25bfc783e403529,1603,TRUE,1892,289,
9c291c309bc217d6a3c34e19e2f1eea4,2433,TRUE,3638,1205,Radiant
31eef8ce2018d578e58de2b4ba569a05,1985,FALSE,3134,1149,Dire
5a991c3f38552b88c595e54268039aae,207,FALSE,1381,1174,
f1be466f7132f6f4cbbeab6911598ad5,1524,TRUE,2723,1199,Dire
45295f30811fb9e9574e12765c9f8626,1301,TRUE,2937,1636,Radiant
e179b03419e1d68dd22239c30f117453,2129,FALSE,3412,1283,Dire
5d8b0f9766cda255d09ac7d14b759e65,1108,FALSE,1979,871,Dire
f3cbf3190eb1786059c130f20e76c660,9,FALSE,1936,1927,
487e8f285960f58398f9b8b7891ea72a,583,FALSE,2686,2103,Radiant
c0de3b149c293d1fba971eeb375de06b,1632,TRUE,2275,643,Radiant
f21a1ccbc74558097f2b3c3a508ffab5,542,TRUE,2450,1908,Radiant
becf86ee3b0d7590afde270288bc6612,1843,TRUE,1898,55,
eb8f471e8496c16a9bcbfdc42b27f150,1185,FALSE,1456,271,Dire
5badd0a9bd3231a069b2424db592462f,2128,FALSE,2516,388,Dire
e129b812a6f07e8365efb79400fcc64c,1166,FALSE,2599,1433,Dire
4678489708192ad3eb0a394c1e831b9b,3100,FALSE,3136,36,
0b7f9cd257d6bb4ba9067a5381c33199,371,TRUE,2622,2251,Radiant
b347389a6787f5ecc8e0f70777d6db0a,1382,FALSE,1957,575,Dire
3514f56630027b99e64927283b18e5a1,134,TRUE,2520,2386,Radiant
b30a1a05129aa0e8dc65bdf5151e61f6,2192,TRUE,2527,335,
c426c605512cefa190a7a05ac83d1478,404,TRUE,2557,2153,Radiant
0064bfd12fd3d2dd8a28088925f3629f,707,TRUE,2200,1493,Radiant
7785dd283559a4f2dc77237c4499ddc8,1135,FALSE,1551,416,Dire
3f9abc2c5c71ea781d9569e007595355,2504,TRUE,2616,112,
b5ad75733939e0105655247f1557cb00,1833,FALSE,3278,1445,Radiant
5d4c708021d405fef703893440af0f49,55,FALSE,2032,1977,
459b00ab681b155878fec76b96253627,1243,TRUE,3675,2432,Radiant
812b3e83d92a772f3e2b667bfe2dfb97,2079,TRUE,3343,1264,Radiant
48b4bafc1b22887bddbd8dd58182c9c8,114,TRUE,2070,1956,Radiant
e36ecf49ed13ce43652b027c08bedfd9,1705,FALSE,2222,517,
43a9057fbe61920c2122be98a169dfd0,236,TRUE,1965,1729,
42d6040688fa3046d0b30be5f494c5e9,2182,TRUE,2223,41,
8fa770846fc6137100e6d2602b1825ad,991,TRUE,2096,1105,Radiant
a0a570efe947fea2e170dbc050596340,1111,FALSE,2108,997,Dire
aafa300f4f64a128bb5038e9f7d9baac,1938,TRUE,2172,234,
735ad82d0a07ab27baa8ec3eff022b4e,324,FALSE,1992,1668,Radiant
ba34fed809f5bec20104739add28da35,620,FALSE,2247,1627,Dire
83d7af1aa4a1da3372ba88e1b44bb307,1672,TRUE,2303,631,
35486a36111c1e873c08c83ca3354f43,408,FALSE,1583,1175,Dire
e9ada37b73a293f56a24567d5335a502,1142,TRUE,2081,939,Radiant
b6b517da362791b24976771c263fd537,3088,FALSE,3454,366,Dire
2f7894100deaed9d22d6c2529c36cdd4,2606,TRUE,3629,1023,Dire
15c1ae97b93b97691c07ce29ac4f7918,1771,TRUE,3310,1539,Dire
b68d75bf8f95699114e9a6fcae9d47e2,3934,FALSE,4225,291,
158ae0eb28a0200a72e1547871542d09,1884,FALSE,2362,478,
085e4f2aa7f80cb23df0d1c52f53123f,633,FALSE,1304,671,
941a902be2dbc7789631ace259612b06,1561,TRUE,1664,103,
ef6ee2f027f2e17e7a5c4859b316b57a,2511,FALSE,3013,502,Dire
669bab9f4e8cf3549abe15afc59cb3a1,340,FALSE,3385,3045,Radiant
5add32f9fb145c64fabb9e9d38fe054f,745,TRUE,2672,1927,Dire
0b01c09e1357488434e786fe1292066f,239,TRUE,2437,2198,Radiant
fb2e66a9a9cd4454002fa35021294a36,676,FALSE,962,286,
a24c71964d9968695f87e54e982d1fa7,653,FALSE,2236,1583,Dire
e35c1f88e6784e65e43de3fa3927d084,1059,TRUE,4497,3438,Dire
57ebfc4ded58dd8b9945b973d6a12252,1416,TRUE,2035,619,Radiant
bae35d3a0aab32558038f9b9e03ed36f,1873,FALSE,2473,600,Dire
7b6ce7946cd68eeb05a8d6760ee3af37,249,FALSE,1558,1309,Dire
1fa653483579497e523d3e98e84cb7f2,1043,FALSE,1279,236,
34cfb3e65ff324663097840808587c8b,675,FALSE,1798,1123,Dire
a4f376df5c1cac65c51d6388cda6f6d5,428,TRUE,1441,1013,
a8147485124089bb12ee8c735a25d32a,3864,FALSE,4097,233,Dire
78799e4ea7c37f690da2d9c82577c9aa,389,TRUE,1861,1472,Radiant
87c20a888d2a531de2ea8abb7e0c7a6b,1010,TRUE,3688,2678,Dire
7ec6f15a43830ed31af3c804115fe649,848,TRUE,2106,1258,
63fe4580dec8a1e7aa7b6609f3161e52,1868,TRUE,2097,229,Dire
40f8379ade7a5d5a210f246080988d05,2146,FALSE,3286,1140,Radiant
53365780f3871b1ddbcba88e3cd5e29e,3092,TRUE,3330,238,
66c086254f38df8e0e62b8b4a1345924,1079,TRUE,1229,150,
e0df4648de33dd3d6d7be5b1470d3d2e,1611,FALSE,2371,760,Dire
62319fc668a2ac0dd04cdc5def17f0af,2151,TRUE,3296,1145,Radiant
e59aec35bc3076a839f95bd77cf04d64,381,FALSE,1941,1560,
794b6184abacda673db067b52e56831c,1068,TRUE,1686,618,Radiant
9c13498ad142ce289b97c693f36ef3f2,647,TRUE,1680,1033,Radiant
f058d610fa5c8a2ed2d74d6281392c85,431,TRUE,1422,991,Radiant
a7d44f37215a04c2b7fff2ac77e8f4aa,1574,TRUE,2579,1005,Dire
45ace3f768c7bfaf0db532b52b95365f,862,TRUE,2600,1738,Radiant
463c24752c44ec9e9f861d3e63137ab6,1346,FALSE,1910,564,Radiant
e7a47a3ebb6aea0ce0d2571e541bce44,404,TRUE,1529,1125,Radiant
f320a690b5efa787ef7a4df546a73526,2647,FALSE,2998,351,
2849387546710efc90b520c9839ef32f,1684,TRUE,3335,1651,Radiant
150b8c720b9141c23880d6e09fd588df,996,FALSE,1483,487,Radiant
d969a610a43d54a35b7656205b64824f,1072,TRUE,1519,447,
037d58a5353c9b0a0f5856ffd54243b9,1981,TRUE,3488,1507,Dire
09e96452f9da823c688d5faf159b1c3b,2152,FALSE,3123,971,Radiant
f19d151c69481699a04190fc938fd20a,711,TRUE,2712,2001,Radiant
5864d5b7243aaef8a7e2b33e91d5d036,996,TRUE,2183,1187,
60dcbeb6241d973a9b6b4714df556ea5,5,FALSE,2476,2471,
e23c739908e3b5b8c8eadb286e344a5f,1293,FALSE,1504,211,Dire
98db43590eb7662175c6cdeba4c4be72,484,FALSE,2542,2058,Dire
ef9c4df32ba8677a5615026daf18ed81,1853,FALSE,2596,743,Dire
3c732e933b4ae0c5d0e3e76b9aa1104e,1827,FALSE,3758,1931,Radiant
c75d42db95a484b96029bfe8f838ce28,641,FALSE,2216,1575,
8af2d14c323f12e05b263c5287d5d5f1,1539,FALSE,2005,466,Dire
69a706350c49acf1faab2eeecab21e05,661,TRUE,1742,1081,Radiant
e3c95790ce9127048055f55c73a453d7,516,TRUE,4141,3625,Radiant
8a0b8f3f76f5d20c3af4346c0ed1fd0b,2560,TRUE,3050,490,Radiant
a0ebc54bd89a0ca39a36bf6e9c38a83e,988,TRUE,2513,1525,
6913cdef658202ab4b78ec691954930f,907,FALSE,1169,262,
b83e83a122bfae5f5b17586fd062e2fb,379,TRUE,3672,3293,Dire
b25ac016ff77e61812ae361ee8a05912,1520,FALSE,3049,1529,Radiant
d6f9742e96fa5889f57bb4e2a41a1677,200,FALSE,1005,805,
03e626cf84962d8f2f1c07b6635cc975,1228,FALSE,1925,697,Dire
193890a0d23312ba6492527e8a1b594e,784,TRUE,1481,697,
3736705f39cd5152e04e03caf1f53255,69,TRUE,2163,2094,Radiant
f1420d6e157ba6df7c81fcd72e7d7fde,2126,FALSE,2561,435,
8cc64cfc972c5b937daf1d8a9aeb0dba,486,FALSE,1659,1173,
ffa2310f6ed7361cd38ee8d9ae2932cf,1710,FALSE,3146,1436,Radiant
a40d972408454870be597cc60c1bed30,314,TRUE,2510,2196,Radiant
35502dbc734125aa9a7070b453b271ed,1118,FALSE,1958,840,
859e938ac0d175c9862a995a776b6e71,841,TRUE,1722,881,
4c38cec4d4791b03461115d462450155,118,FALSE,2444,2326,Dire
14d0884f95f82f36c39e0cb21b346b6f,1724,FALSE,2640,916,Dire
cb5f0ce7890ab52046fd4a20a9fc01e6,1807,FALSE,2103,296,Dire
75d3ac41ff2d87c9497f55e6562ad7fa,706,TRUE,1796,1090,Radiant
ea049d36053082dca8c4dbaa304bf6a5,581,FALSE,1907,1326,Dire
81bf9275ca543970540a2967c9b5d17e,602,TRUE,3001,2399,Radiant
d0c6c9e48d532d159d3444c276ffdc77,1397,FALSE,2422,1025,Dire
f14f4972325388adf01297daed9be5c1,956,FALSE,1196,240,
a1c85c741468d70d0853c37b702b13b6,374,FALSE,1882,1508,
8c7835e99772756e76333211e48e7753,65,TRUE,2812,2747,Dire
6da06316a66d1a38a70183ad6e9fde11,998,TRUE,3542,2544,Radiant
c0a9a2de26bdb92453970c36a94ef935,179,TRUE,2209,2030,
25e773bf9bf1f094ddbf263f04dbda80,1552,FALSE,2198,646,
df0f495121b709c4f36cc0fd62978092,1604,FALSE,2379,775,Dire
93537f04284b404f659e642b1ad4d4f4,1451,FALSE,2236,785,Dire
b4687d7f9a2b849b17d66dbec909629c,1831,FALSE,2261,430,
d7d63c4cc12cd1734beef4c31bb5ab3e,2090,FALSE,2225,135,
f6a6e99e1ee60307c9bf9112c4be0f71,1125,FALSE,1645,520,Dire
3258d966d629ee2fabdea1c51faa3c69,1158,TRUE,1978,820,Radiant
d030c08e9b45b27b9e89dade4a72ec0a,980,FALSE,1425,445,
7d162eee7c41f4c263464b6061804664,1056,TRUE,2190,1134,
35c5a234e1a7858ca70e57b12eed520f,2175,FALSE,2371,196,Dire
bf219547c3d98a3e3c6e3da34acfcfa0,2350,TRUE,2590,240,
8d2cab726a1f64b4843d73c7a98da5a8,202,FALSE,1456,1254,
13ad66bc1420f9198ef7ff41925a842a,1174,TRUE,2503,1329,
171c55dd3d85afbc03d41cc716760849,1381,FALSE,2420,1039,Dire
661f1cab1ff650cb53df5f2304289a15,368,FALSE,2458,2090,Dire
b2cd661dbc5a871bf738971559efa72d,1696,FALSE,2348,652,Dire
df55e8f8527ee33dfddf4e56def6a7c0,1932,TRUE,2384,452,Dire
ade8151b682351ed461bb5b0a7fb236e,1502,TRUE,1721,219,
f24da582cdc91b1c6324dee35b377eb6,1714,TRUE,3063,1349,Radiant
5daddab46ef26c8b19625c30c52e19d4,810,FALSE,2192,1382,Dire
7e632c7e3b30763cf08fe990eb77b175,2079,TRUE,2928,849,Radiant
0c358c436f9c5d4b52bf9e66187500af,733,FALSE,2220,1487,Dire
a4d5caba7b69484a8719b36e7c2c656b,2509,FALSE,2926,417,Dire
013e3deca14168958386050d70366af8,144,TRUE,2897,2753,Radiant
dd19fb25002be9b220d85c294523e227,603,FALSE,2683,2080,
8cb8de9bec063a827a976bfba0247a11,2113,TRUE,2315,202,
307039ba7eb4eaaa373b6447dabf368b,941,TRUE,1438,497,
12430caf533fac8e191d4487393afd81,1790,TRUE,1855,65,
a969a3130c1009cfe86cf4c6df14dfa2,980,FALSE,1366,386,Radiant
883a4006b79bb0afb7cb6cb4ead2e3f6,1114,FALSE,3106,1992,Radiant
9ff9f2711780721e2deb1669c4b84330,2011,FALSE,2319,308,Dire
8d83a639588d0048cec24624402735ac,438,TRUE,1381,943,
69ec67648bb0ec1cad357a005e02f951,2011,TRUE,3580,1569,Dire
b70ba608df6766f42f35f0b4c973e57c,213,TRUE,3421,3208,Radiant
cefa36ad3a90efce237a03c47e8abb0f,1129,TRUE,2343,1214,Radiant
176188eb468d5ec4573c007f67fd5946,1721,TRUE,1864,143,
04ffe116bfd4d3baa664baa96beb8ee1,746,FALSE,2037,1291,Dire
c135cb84bc2e60bd0a8d1f53bda10f6e,1806,FALSE,2040,234,
540a098ded268d7e7ddeb84b8c6cc255,603,TRUE,3064,2461,Radiant
0658efd6e2bda8fcc8d51d39a2f453a2,1419,FALSE,2464,1045,Dire
9d6213030792616c3ad2a3cdc6976aea,864,FALSE,2582,1718,Radiant
7a5dd84438988c4760b2f7213af874aa,3097,FALSE,3336,239,Dire
2e4832c409969dc57c8b32f072b3e8ae,2462,TRUE,2512,50,
cd9db61857ddedde4a8bef3a7d5d92ad,2631,FALSE,3147,516,Dire
c26253f0d60d9d2b85e4b1d7e320bf2b,1798,TRUE,2211,413,
808a9bcad91856aa773f43ec723482c7,868,TRUE,1711,843,Radiant
e07d2c3e0f18770e24598e1b8b4e7a10,17,TRUE,2172,2155,
ed97f5336dacb90352693a08bde415b1,1878,FALSE,4435,2557,Radiant
8adc8ec43d310e8134aa869156d72574,2422,FALSE,2658,236,
32a09824cead8e80eddb6fbcca51488d,1563,TRUE,2159,596,Radiant
01545a547da55c0114f183b87b771172,2658,FALSE,3167,509,
dab16b96e51289eac49034652d4988ee,51,FALSE,2784,2733,Dire
6b5087143eb7fc876ee2ef699b068ade,624,FALSE,3335,2711,Radiant
46b0dcf0b5d47cc57459ab6e08a22688,1642,TRUE,3017,1375,Radiant
488c763bf13168fcffed7348731c177e,109,TRUE,2327,2218,Radiant
e7291a651febfe06f47ac8dbbf36614d,480,FALSE,1602,1122,Dire
fd4e7489115111a375a9e33a61be51c4,1873,FALSE,2594,721,Dire
5da88d2bdd9c672e5f37c3ebe43d3103,1839,TRUE,2434,595,Dire
0cdea3663b5107b3f3b7d46b7ebd531a,1524,FALSE,2605,1081,Dire
151f8a948487fbd5c37551440c714b6d,1127,TRUE,1756,629,
ca5dc942fbc1549f2cb3954f3149dcbc,909,TRUE,3274,2365,Radiant
80dc0f46a37bb2ab4ece351fe8336a14,889,TRUE,1924,1035,
867867db869eb42c327ae58e1f94d92c,1185,TRUE,1760,575,
730223a139257dbd147c27c2e5f80364,1483,TRUE,4924,3441,Dire
448a6d68b9c4b094bdd43bff88d006b3,3952,TRUE,3986,34,
ad49ea87b13a70b07bb59db912d4b016,656,FALSE,2580,1924,Dire
946cebc736b2b9358232d06835fcd4ad,843,TRUE,2576,1733,Dire
1cb9fe57f19fe605c7e6e712e77f53e4,970,TRUE,1599,629,Radiant
09dc86078d461eb33f3d3d7ff980ba9a,2276,TRUE,2342,66,
eaa58c70b51f664698056bdb710d3928,581,FALSE,2439,1858,Dire
db0f7df35b4ca1d43f5d0658def411e2,93,FALSE,1395,1302,
e01775d061c21aa10e9453a561f6fcf4,850,FALSE,1092,242,
2ae2f87d27d537f8d27348bedd8c94fd,882,TRUE,1301,419,
d7ce3ced8a43b6e2e9762b488cb4e7fe,2177,FALSE,2831,654,Dire
ba615d9c2b26c0ea12699725ad49db17,1726,TRUE,3427,1701,Dire
c7d71e74af56cb9fe165c26bc5352029,2148,FALSE,3238,1090,Dire
2d971ea795cec1b49266e93d5fc60cde,2074,TRUE,2326,252,Radiant
26edf49aef5b4d14c0726efc1456e152,1688,TRUE,1978,290,
2b0a56e3faef7f9f17c4a6a3d3cd189e,652,FALSE,1337,685,Dire
5e4ba8e5d741e36afffa44a53609c8fc,62,TRUE,2764,2702,Dire
2ce65b6b4a692a5360e6289798affc4a,1274,FALSE,1782,508,
5963109a1e9bf01a4ab180dfc9fdda96,514,TRUE,1409,895,
d024c8c8c4ef27f2df622785e34f8c0b,2537,FALSE,2657,120,
d1861174c48ce9c0b5c3d60190bf5a7a,331,FALSE,2502,2171,Dire
38f47fb3ff6819ff4c402cb637780d27,1631,FALSE,2026,395,Dire
a1b45b63896058253e9841693d57948d,637,FALSE,1905,1268,Dire
283ced99b316f3d1d8b4b803187796af,450,FALSE,2250,1800,Dire
3f0a82b9e95672837d6c94013a0b8bd7,565,TRUE,2281,1716,
fc3eb03a4c6dc5e6d94fde72641e5c2a,173,TRUE,2487,2314,Dire
1573f402884a5475b9fc8b2a23fba6e7,1526,TRUE,2070,544,Radiant
c83af3d30070efcfcd4d36fa4bbff942,1362,TRUE,1740,378,
6479cad501c73adfbe6b199a4590a8d5,1131,FALSE,2670,1539,Dire
594ce3c1021072a1d91bafb2cb5f2cf9,67,FALSE,2354,2287,
c7ae385b70a871af7568f3b9b712cc77,576,FALSE,2117,1541,Dire
5011c6220807a771e2fac9812d5958a7,2275,FALSE,3098,823,Radiant
a2aa9a1d830f7c1994ed5422e17e799e,1501,TRUE,2464,963,Radiant
9731440a1b0acc4ec15c56905e187bf0,3163,TRUE,3201,38,
d8302be173fa6ba6fc73917f05acd5c4,2216,FALSE,2399,183,
440fd9e0cc6fb73ca18fafbcdc201048,622,TRUE,1820,1198,
48ab89c7d5d1f9f8e73887b73f34012b,355,TRUE,1647,1292,
c915a2e1ec1be6e2e9b340bb6dd55901,2333,TRUE,2506,173,Radiant
1eed98cfc3ac3ba853504f363cf31a0e,2797,FALSE,2896,99,
accdf5fd3926b5f8ccae128615a58d80,83,FALSE,1258,1175,Dire
ff364ab79818dd89574c22e46b24cfad,1091,FALSE,2320,1229,Dire
c17dd675f24eccab61dac644b6d43718,528,FALSE,1740,1212,Dire
2b77de170f16f418cab362c72e253fda,1103,TRUE,2110,1007,
8b78e4e8a30ff7e46ec5288ae1113a8d,172,FALSE,1921,1749,Dire
088f8e660ed8530797b57433bf9504e9,2190,FALSE,2440,250,Dire
e10091c5b7e7b7136eeb6b6e481ba04d,1879,TRUE,2233,354,Radiant
b3e9d30946139d9084d424c59f34054d,1277,TRUE,2538,1261,Radiant
afe8902d66dfeea52c9878c8286b8372,597,TRUE,1585,988,Radiant
b104dbf8acdec508fbf13f93a2a24208,1389,TRUE,1853,464,
299a47e5c0230d4300a9b63d47436c9c,2263,TRUE,2372,109,
134cba1c55e019e2346ccfb723da6697,1645,TRUE,2031,386,
7c9b3921aad8106dc501d55d33aae9a4,1895,TRUE,3777,1882,Dire
70a5398ec2b639402ba273508ece2e92,368,TRUE,2479,2111,Dire
a3aa66b9e1768c690739eb56d94114f8,423,TRUE,2483,2060,Dire
676eeb6d2c179114d3f132c1d4f8f5a2,1290,TRUE,2419,1129,Radiant
db3f311804f3bdc6d9af3ed8811b19dc,471,TRUE,3099,2628,Dire
86c1cad7434b248efb4465765d879792,1766,TRUE,1871,105,
335d30b3a29b18aa91d47880688d1b2f,1121,FALSE,2025,904,Dire
9a2b77490dacc2d6312eba2c1936588c,1605,FALSE,1972,367,Dire
15d78302bdd56e3d72c290cc08e7eacb,1609,FALSE,2248,639,
976db05ffd4da7bc6973649093efd723,1166,FALSE,1646,480,Dire
cd901ecfac74a04545394cca45c01426,366,TRUE,1279,913,Radiant
070f94864aabcb74fd21c547c144828d,1634,TRUE,1666,32,
6a346973a2b4524aac0b00bfcf7d25d8,342,FALSE,2480,2138,Dire
a660a4ac8ddee53d4385fe6fc1c7bfbc,307,FALSE,1490,1183,Dire
1b94f98c44bdb05d0e1250cb07408a7c,928,FALSE,3227,2299,Dire
7a56cfa72872aed618037a481af9d418,1088,TRUE,1978,890,
7a73dbeba3e93df9c8b7f773d5ddd347,487,FALSE,2146,1659,
00a4a3df3c8a56b5d6cb888360e77bf7,840,TRUE,3682,2842,Radiant
13fb04fb21a40cc5ac50d1d19f07e147,1171,TRUE,1810,639,
d86f8099d7c95306d5213dd568739b4a,967,TRUE,1871,904,Radiant
c3a7077a2b0083b8cb5948e086298bef,38,FALSE,1913,1875,Dire
75c8df12d17911f868c1cb3bae503b11,1688,TRUE,1809,121,
68ff1a050fce47d5507cb42be3e6706c,1919,TRUE,1956,37,
f7d920acb551fba615add893c46f9964,26,TRUE,2569,2543,Radiant
02a43c6ee56d2fd89d0255133452690a,1727,TRUE,2359,632,Radiant
966128a64074b1d306e9062a42e0da96,393,FALSE,3077,2684,Radiant
6f88eed286c1508172f2781a0e7f2119,2499,TRUE,2903,404,
21baad3c2c3be94cee369e1634cb0eda,1076,TRUE,1996,920,Radiant
efbbacfcf4950f39aceb8a492fb89244,245,TRUE,2375,2130,Radiant
e498fff98ed3ccb364a884611a90fc18,632,TRUE,2516,1884,Dire
b4080f9712e7b0c050df8ff2a6d34eb3,1112,TRUE,1904,792,Radiant
a9b5c1e2fd08319d794bdb46dff56f85,1830,FALSE,2506,676,Dire
f6f7b9e0cbe23d675e7e4ecdc05610d3,816,FALSE,2569,1753,
b2a650bcb17976c4b8900d004fb70f08,2088,TRUE,2426,338,
b5b7db400dc294ac7a3bcfaafc6e3fe1,964,FALSE,1144,180,
ebd053704fe6ccf05af20f3136d8f1dd,284,FALSE,1654,1370,Dire
50e1d546a99bfe773124a1d8637ba2dc,659,FALSE,2601,1942,Dire
b959662aaba68419f3a6294519e1ee01,1449,TRUE,2865,1416,Radiant
3ffd709cc5fa4dd26d96fc7ea0c63c09,2032,FALSE,2249,217,
817b7b886b484186b1e2d8c649b7942b,2055,FALSE,2348,293,Dire
90e1fe30d67a392bf65d5bd3dc9064c4,1319,TRUE,2097,778,Radiant
0c84cf2fee9cb2102a069c0565b85df2,880,TRUE,1546,666,Radiant
b759acf0945c66e94caee6f1eb3e9ebc,1568,TRUE,2296,728,Radiant
539c45f94234710f7e62567b16c3615c,1432,FALSE,3147,1715,Dire
ce5f629352cb05baaa0e8320e64d8bc1,1332,TRUE,2476,1144,
f78d5766a3d3faac7c2a8756c0e0f21f,1837,TRUE,1879,42,
e5a16318acd1537adc7b4f3479b16679,710,TRUE,901,191,
be19888dfe9b6b3bcfa5838cb024a492,1686,FALSE,2802,1116,Dire
3d02853ab34c53ee97b87908dff56cd0,2082,FALSE,3490,1408,Dire
14e30fc6683743f5c00d37fd37906e10,1765,FALSE,2074,309,
8c5726d5619f2dbf5725f7c6e9005f65,127,TRUE,2389,2262,Radiant
4d82551ff2b8f1f2e5c48e4315d7df47,141,TRUE,2122,1981,
70787af6943b35f0b61bbba611e6ba31,421,FALSE,1613,1192,Dire
678a3317cba87c61f39bb00d7a479287,671,FALSE,1544,873,Dire
8775a6eacd5541da57a093807f4eaecb,238,TRUE,2487,2249,Radiant
ad1232d6214cf2c6c03c2d8863a1af4a,728,TRUE,1685,957,Radiant
4f48204a4d02955fd8677c9a7ebfa642,1673,FALSE,2071,398,Dire
a4fd218db0d8311a1d5e19f98317b0d8,2561,TRUE,3120,559,Dire
ab6fad527c4bfb8566e424bffbf3db40,1712,TRUE,2273,561,
4cdfc440dae1f6803b6826f59113dac1,1381,TRUE,1587,206,Radiant
dd687ee90ba465fbe45af9ec1e857fae,779,FALSE,1740,961,Dire
0222fc771ae30078af593c1356e3c422,797,FALSE,1588,791,Dire
93f079ea0854e823b710171f0b75069f,998,FALSE,3036,2038,Dire
d5c489d187296340cfa256dbddbaae93,764,FALSE,2989,2225,Radiant
e22af9f8a68867bae5fd93a078c0cd41,801,FALSE,1584,783,Dire
028cf32bf42b7df51db8415410372ed9,829,FALSE,2236,1407,Dire
efa975a2af16c19ee6c4370fab903ef6,2145,TRUE,2323,178,
606ee7eec0c4537468bd6534d183078b,389,TRUE,1798,1409,
5cb13d69eae109d06e041638d5906317,465,FALSE,2539,2074,Dire
f938da4925890d6e3ce6a61a77f6cb42,166,TRUE,1907,1741,
054974aa90fc6afe64c66c720b512968,1285,TRUE,1700,415,
3b1d86591993287c3be32c1f5039fdc9,730,TRUE,1601,871,Radiant
2fa271a1c2b00f69453ece32512b72c2,756,TRUE,2626,1870,Radiant
91dafe682fea45aeb1db65eb6a298ac3,1922,TRUE,2012,90,Radiant
19c2bed86a3e067727792ac1fad36ff6,1077,FALSE,2398,1321,Dire
7471f4b1d5428e37356381f8502731cb,230,FALSE,1889,1659,
1662bc6dc199d69716fa33b48777884d,1076,FALSE,3882,2806,Dire
00c1be45c6a299fbdbfdc273021c5777,1188,TRUE,2839,1651,
ffe2837eb66be6fcf1949adc06c90776,1062,FALSE,2183,1121,Dire
7f875cc7cfdd96a6186fea5eeeff2f8b,1012,FALSE,2649,1637,Dire
520dd8c99f34f9d78847ffe7679375b7,896,TRUE,1978,1082,Radiant
0f551912fff03ccd4b72c16ddca5ddca,1660,FALSE,2983,1323,Dire
8b881cc8905408801e8c8c8fa7dace40,2066,FALSE,2709,643,Dire
aee7fbaaee9f5631049a1c90d51fdc88,1004,FALSE,2421,1417,Dire
62c1b710f8c9a6093eff4a498649611f,1366,FALSE,2945,1579,Dire
4da8b0cec625107326fa70b0be1ebd22,780,FALSE,1795,1015,Dire
58a362ed2a5fc72871df8df6da434fdf,800,TRUE,1649,849,
c8bd9bfcf5f3db77d50ef963f8cde4dc,442,FALSE,2630,2188,Dire
662402ff35de632d145c00eb7ef8df62,1020,FALSE,1626,606,Dire
3bc6fb174b217f8c042970e1457622aa,976,FALSE,1594,618,Dire
1c199eec87b910ce7f4c446e5a51a35f,1688,TRUE,1801,113,
42ea1df13ab4440a19512e85cc522fb5,2671,FALSE,2771,100,
c254bbc6704ef057e3ed88cae0f5bcbf,313,FALSE,1987,1674,
2f016546104f54018255509b587c3dad,747,TRUE,1634,887,Radiant
17eea153f534a09605e8085f96dcea9f,27,FALSE,2796,2769,Dire
589c4528c9aa5c38ab790a2d91ef95a7,234,TRUE,3587,3353,Radiant
611112f1efa18547f8f9c7db2fd78c5f,1375,FALSE,2277,902,Dire
be7bb1bfcac73b97c253bbeb51523008,1345,TRUE,1795,450,Radiant
e9d901043debaebf39f3ac7da5ed5829,1420,TRUE,1556,136,
601f660bf37f4a9987ef7236008abd0d,878,FALSE,2508,1630,Dire
cffede029990dd6a5afaafb9ed41cc65,260,FALSE,2683,2423,Dire
955290b8e655df97a3542b86e3354df9,1418,TRUE,3050,1632,Radiant
4ae84f56b5ff4ac6eeeea45a7a382526,125,FALSE,1847,1722,
8ac6b9980419b6db09bc6d57ff38bc30,509,FALSE,1003,494,
5181cda1680e71602d61a4abaa23b0b4,428,TRUE,2013,1585,
9dd0b23ff5c21972b321206fba59f7ce,452,FALSE,1804,1352,Dire
2ffb2b2fcc401a15a562001d27b54eb1,584,TRUE,1198,614,
d56117d8a1ce84625087818097254f3c,955,TRUE,2640,1685,Radiant
6ae7e76175315c2d06056192543d2694,2401,FALSE,2597,196,
545b76acbd0b4506ad32c6657311d309,912,TRUE,3679,2767,Dire
066112c2e2cf5a4924eda7e3f3f847d9,923,FALSE,1889,966,Dire
045011bada4cef77f6af4eecc4f3b97d,902,TRUE,2494,1592,Radiant
aea1afa1fb6bc97b5c48e10c7d5f61a7,2970,FALSE,3085,115,Dire
e653b6026bf3d0b8c80de31a771ce4da,128,TRUE,1689,1561,Radiant
e2138d588c889cc3daa34a89b56430f1,196,TRUE,2652,2456,Radiant
de13316eafe0e97121af9858e0257d53,442,TRUE,1178,736,Radiant
862f22259fe77492770263dac4e72fc7,287,FALSE,2478,2191,Dire
9d04469ae5e9530e24a452b37e8e3ae6,981,TRUE,1676,695,
2e790d66c320dcae293b44016e136cb4,384,TRUE,2550,2166,Dire
f7bbeec4408040942df5b7827bead278,827,FALSE,3482,2655,Dire
4623577bd952fcfd6481cb702fd128f0,2105,FALSE,2739,634,Dire
83caa4009fdd6aa88fae241155714c03,1693,FALSE,2696,1003,Dire
11ff334f3fdaa65fd7435d4660d68384,524,FALSE,2398,1874,Dire
6c3b26b5c0993a6f090ebd7f49dae343,1427,FALSE,1694,267,Dire
e3ad8fc4f31aad7dfe5d7a626a44f1d5,276,TRUE,2129,1853,Radiant
59b4f3bdc5e3735a5daa28533f9508c6,2441,FALSE,2782,341,
14591090792b48c617a27bac08268c23,373,FALSE,1750,1377,Dire
a7f9898816920c099130a4ef9951a691,1320,TRUE,3700,2380,Dire
884894250c50f622c5165fb48e33699b,1469,TRUE,2352,883,Radiant
641cc73f9289688d7b5cdcccbb58566c,1947,FALSE,4526,2579,Dire
6615cf36cfefcafc96f83fe52678a32b,443,TRUE,3220,2777,Radiant
d1a644de8fdea04a2e0d11079a26a116,854,FALSE,2071,1217,Radiant
c2dac6d66c5cb146d6c3c96c9e842428,634,TRUE,1585,951,
716668041f63debade071effa82fef94,1867,TRUE,2870,1003,Dire
f2ad255e85e920845bcc0ba4282d91dc,1258,TRUE,4030,2772,Radiant
dcf8f45ac549f08f55af33704d0fc1e6,582,FALSE,2496,1914,Radiant
728da1b22b81cb2d68b72042efc9d517,1788,FALSE,2182,394,Dire
e76ded2c83d1c52ce98cc229785e2fbf,161,FALSE,2131,1970,Dire
b7507c1e384ca57b1b9390a1b1686fa0,264,TRUE,2135,1871,Radiant
e46f7788e37d54ad0efa2987e95c1bbb,749,TRUE,1280,531,Radiant
bf30fc6cc7c015e88d2b8fa63a8f95a4,793,TRUE,1863,1070,Radiant
0cb145bbd323aec3251b65a336fdbd91,421,TRUE,1733,1312,
9a66073e667e707326ac1f6869508ce8,396,FALSE,2622,2226,Dire
22ca396ca3d296ac8bf86230bf48f8b1,741,FALSE,2618,1877,Radiant
2190f2ba50ab55b27972a9c529a5adfa,15,TRUE,2251,2236,Radiant
f3ddcaa2260fe65231e314ad5858599b,1737,TRUE,1924,187,
136d459608ecf0fe3b71c2a3967281c5,2056,FALSE,3660,1604,Dire
bf6e87308ba1ad39230dee6de0c1b576,1754,FALSE,3645,1891,Radiant
d95ece96c5acf62f8a7ea5c7c5cc42c6,2262,TRUE,2632,370,
a972a4224ddff340d37e7f3aeb46ed57,392,FALSE,2890,2498,Dire
76f42daeeb8e31b3a11ced684d3a98ef,1113,FALSE,2049,936,
0bb27a9f9544d9a57cc9e5d97d973bd7,1464,FALSE,2550,1086,Radiant
b5999811e96c8056434d0c040bc3e2dd,1474,TRUE,2040,566,
fcf6e48511ffc7db965a71ba9906f71d,591,TRUE,1595,1004,
d41fe5bba194e402c72b148bbe62ca61,1521,TRUE,2443,922,Radiant
c46313d109b03e2b7909e498b6d0da79,717,FALSE,1842,1125,Dire
5575f563eae9ecc0692c2e8104402628,88,TRUE,2096,2008,Radiant
f7074572e62fdc46068aa6bbbfc54186,983,FALSE,1542,559,
92a54d39b97fbd6a2cb5aa0fa0d31140,586,TRUE,1800,1214,
fe2eecc192a8c96123ebe0b59ee679a2,287,FALSE,2863,2576,Radiant
4f623b528a29a14201e61f28e861a48b,1059,FALSE,1295,236,
0d1f2e8eab23562fb68579540abaa231,1565,TRUE,1644,79,
da1da677ab358798d9c60e438d3ebcaa,1580,TRUE,1968,388,
47d9d930ea9dfd29583d1d87071ef416,95,TRUE,2368,2273,Radiant
bd7825ad68c36a97a21995fe06ca5523,1791,FALSE,2011,220,
24fbe881df7e2ddd41b1a51af029b60d,2012,TRUE,2669,657,Radiant
94195aba85305b042aec68ced5feda68,560,FALSE,2761,2201,Radiant
7879a664c37e2768a5f0802ef357851e,1130,FALSE,2690,1560,Dire
61123f987f42d6335d329a53c609d113,778,FALSE,3568,2790,Dire
2c86e0820750c9f7213ad583e55400db,2293,TRUE,3837,1544,Radiant
e4ca6413be432796b3044e101ef9a05f,656,TRUE,2298,1642,Radiant
015072490fa1a04e4825d5e2b723b7cd,841,FALSE,2674,1833,Radiant
b86d2b13579e97d3b69727e222190b88,1482,FALSE,2935,1453,Dire
807714c7243d2310a35e6ca7194e7061,2654,FALSE,2818,164,
2b90c260afbed3f9e88553263f639762,1387,TRUE,3029,1642,Dire
d3d6d31d4c150868520d64fed1dda24c,93,FALSE,2213,2120,
7a7ad471144c673a875089209b6507a2,698,TRUE,1725,1027,
423143979175537528dd0174a429458c,79,TRUE,2499,2420,Radiant
443d84162611d5d15c4a003fad6fa4ef,1587,FALSE,1867,280,
a1ed2d8bc81cf649e2dcddd3378d07f9,878,FALSE,2294,1416,Dire
8b4195e789cf1572db0f348805223e4a,642,TRUE,1496,854,
9375757864ce0371986fe72ef82d5e90,1737,FALSE,2520,783,Dire
18266d3c6a4b42c31574e2891791edf4,3681,FALSE,3904,223,
147131b91e86786885c898b9b4031a6d,1609,FALSE,2478,869,
fd90328efed454149d2e80eda17d5c6f,1498,TRUE,1874,376,
c6cac769629a87ade6028d86a10a78eb,1443,TRUE,2849,1406,Radiant
1efdbdf00c31781ff8ae6b1f427e7bbc,1124,FALSE,2333,1209,Radiant
60b3846ed1104ec07814cabc1c546faa,2325,TRUE,3094,769,Dire
b8045d8201576bd187fa080690d359f6,1289,FALSE,2188,899,
199dae862064ceac3b8de91e3cb64c25,384,TRUE,2508,2124,Radiant
9a271da30f20cff6ddc18b9d358b7d7e,769,TRUE,2950,2181,Radiant
cb5ae11211ba4c5b8129ab3de028532b,133,FALSE,2861,2728,Dire
33b4d4e4ed44d66ae836680b97194702,137,TRUE,1641,1504,Dire
1da6cbdefd18c53bd2cd4127d06d5b79,241,TRUE,1469,1228,
a1d4b51586875a12ae19f22e935de4be,2460,FALSE,3013,553,
0b04014d1402ffaabd206ae6dffcc4a5,660,TRUE,1031,371,
82f64e8d8931aabd595d95737674cdc8,1632,TRUE,3345,1713,Radiant
204c7d279b4ae40504e12a267e18e604,472,FALSE,2573,2101,
eb6ba3f3e1c5248884a026790f0925c6,3076,TRUE,3763,687,Radiant
fc72d87318267d2982f5ceb1e9ab95ee,1589,TRUE,2931,1342,Radiant
26e9e427b5ddaf3cb2b9620e128da14a,607,FALSE,1218,611,
a2ae17860fc7fdd8a68252f91da4bf0e,1548,TRUE,2431,883,Radiant
3789708fe9e34476710773c1d5745fc3,197,TRUE,1778,1581,
fd89913e47bbecd797d2c5c3a6aa707e,1464,TRUE,1892,428,
2e15b2504a402b717162f8761121985c,278,FALSE,3124,2846,Radiant
465fc0ea58eafd3c9b24f53cfe237452,829,TRUE,3546,2717,Dire
77b165c494a7bbf3c22f5b8c2af933f5,1893,TRUE,2072,179,
1031d3ab31ffb3ada55ee65c2c454f39,14,TRUE,2620,2606,Radiant
ecf882fe5a243707b1882e8b5f0255bb,1057,FALSE,2157,1100,Dire
5d5c8e8f3cc778bc1e3aad17287798ac,834,FALSE,2380,1546,Dire
4a9f41d0f0af69ca5fc70d2d74f81f61,2290,FALSE,3039,749,Dire
c104dcac93cbc41c57392c40c784345f,1084,TRUE,2281,1197,Radiant
1f9801d2d8a15be4667b9f2dc4163442,451,FALSE,1547,1096,
adc7758d320b0d4f522399c2fa1c769f,905,FALSE,1630,725,
e8936d45df14843e005ca10ae7ffe380,2257,FALSE,3049,792,Dire
28bde5f44cb4d9ad96215ecb902f4e74,242,TRUE,1550,1308,
ee1975f50acfb0efb3a3316f7cb61929,989,TRUE,2230,1241,Radiant
6fe9d46b8f252d23cd308b5c2e92c23e,149,FALSE,2330,2181,Dire
c3ebe7aebd8ebe7278fc9224c9c44b45,498,FALSE,2923,2425,Dire
88db96d3e375266b932a1e248a71ed3c,802,TRUE,2477,1675,Dire
5e39f33e84eed7c646fa3ca6060aed7e,1641,TRUE,2098,457,
a315781835722bf0db80fc701b33e147,884,FALSE,1918,1034,Dire
f7c1822ac3d7e125515f59f6754cbf73,1525,FALSE,2771,1246,
11876e1d926184bd975e206592fc98ca,1383,FALSE,3409,2026,Radiant
cd86d803fcde55d062a74d82cac879b8,1285,TRUE,1395,110,
6ed793681fcc0a0d8298cf7489e1e78b,1316,TRUE,1925,609,Radiant
f3d901ef853fbff870310ec2038b24dd,876,FALSE,2384,1508,Radiant
cc8d1e3ac68134825f1c5434504b071e,705,TRUE,2315,1610,Dire
94efa0c1a5cfe013c540d886764f330b,1481,TRUE,4194,2713,Dire
07423dad67300bf8553ff20b26513263,986,FALSE,1740,754,
d715eabfdcf165e4ba8b2e444976d076,1676,FALSE,2882,1206,Dire
c91533154d2483a2bcdf1b5c50e91e8c,858,FALSE,3567,2709,Dire
983001e2373756d3d085ae861ded5249,1442,TRUE,1605,163,
eacd4ff8d80661dd7e29c237a45103b6,727,TRUE,1298,571,
2c47c5b7a0985a4891b273a405c52e98,373,TRUE,1972,1599,Radiant
d60c82350b800aba2e73a0b5e7b590da,329,FALSE,1732,1403,
13f178d19175d274c1771636e57c92e1,2091,TRUE,3801,1710,Dire
253871397b1df82f30a79a3e48f9e46d,803,TRUE,1976,1173,Radiant
bf532d3ac6dd7ca896401c986a86d8f2,831,FALSE,1308,477,Dire
6ee3eb42f07f23f06c5b7adf0c2e2bc6,1728,TRUE,4691,2963,Radiant
a00a7a4d8152ca141753d948d27ec64b,1788,TRUE,2254,466,
ea518dbdf512ac2d5914378c15ff5145,1488,FALSE,2357,869,Dire
1b254783069f70b47cdca098cddba01a,1353,TRUE,1791,438,
4c7d3859e590df04dce8ad8361d69a2e,152,FALSE,1822,1670,Dire
514f36bdb6d69bca8b6d5674ff566319,90,TRUE,1408,1318,
4147cc05e8bb5de28cbd8b91db8cf2ca,180,FALSE,2446,2266,Dire
94a8557dbc227eef14422d25f55b6970,1213,TRUE,2509,1296,Radiant
608342f0e7fddacf7a554d9d2d8df2bb,500,TRUE,2924,2424,Radiant
3d91f6d2e7479bdd3eb23c61f66c057f,30,TRUE,1467,1437,
d4682603a1eb3435a6df7858473fb18d,1071,FALSE,1497,426,Dire
558c77687ed19e3b1263f3c4714ee7a5,2106,FALSE,3191,1085,Dire
70a6a8990f40774458f13c037e4b1a4d,1816,TRUE,3341,1525,Radiant
1b73425349f0a846e37fc6e160998ed8,84,TRUE,1887,1803,Radiant
42dbcef7a48409ad016f743c289ea34c,2399,TRUE,2743,344,
69eaa9027fa41f87feef6660e4e42f50,1453,FALSE,1656,203,
f66e057605cd83b3f477c536ef937f85,350,TRUE,1944,1594,Dire
57e2c063fffee7eb89a9129f57392463,601,FALSE,3216,2615,Radiant
60ad6f5c9e06638319919b4ecd20853c,811,TRUE,1840,1029,Radiant
cd9b8255ead24cbc05286c6b92359234,1644,FALSE,1753,109,
8d8069653cee8020693c744c9e40522e,465,FALSE,2735,2270,Dire
0cdc61954a1027c08f0a06bc95906e90,1409,FALSE,2927,1518,Dire
6310700b51386e8ef7e931e5850da367,2893,TRUE,2945,52,
1d54af9af3ebe8c016d27126c586d6f1,1542,TRUE,2012,470,
751d6071bb6ddc0b0768664f597ded7a,557,TRUE,1658,1101,Radiant
a840b775c6753e7fe80dbf91fbb2f164,1670,FALSE,1875,205,
e55c9fd62768c4f97cf8ed411d17f25f,2120,FALSE,3055,935,Dire
ac2a038e2d4f1350c0c31658c0d28967,2120,TRUE,3491,1371,Dire
f38ebc0a85729081eb5c038fe0e3103e,2044,FALSE,2407,363,
219be999cc26b0f415672337a446d5b8,1954,FALSE,3513,1559,Radiant
598a928f54abbcbedf0a084ba3ee2862,626,TRUE,2418,1792,Dire
1b45c217c8391263b67336f4f4e432be,160,FALSE,3480,3320,Dire
abefe4acca3276c9f91fdaf98d076463,2062,TRUE,2439,377,
09671f0cfb9ee0a12bdd9c00e5efa09f,136,TRUE,2266,2130,Radiant
69956bd7018a17e0f1c641e263d52e4e,3664,FALSE,3779,115,
e96626cb44f55f024a27ee934b548da2,2499,TRUE,3417,918,Dire
3d0681626d93f07909bb4f8f9e964271,294,TRUE,2171,1877,Radiant
e36041c6f536ed0af8b3f9396a960f91,282,FALSE,2482,2200,Dire
a63e2671e17f210cab5c35e2106dca63,772,TRUE,1446,674,
3b07dfb988ce54bc28bcdd542e908829,1875,FALSE,1992,117,
a23d9e53235a25f617fa6429b8756083,1165,TRUE,1377,212,
ce7737321493e5ff75e4245ca2922a56,3202,FALSE,3409,207,
5ff42ce9797656f7c7516190da52ae7d,1188,TRUE,1882,694,Radiant
5d1480eed3dd0716ff06691a7852c9f9,919,FALSE,2028,1109,
3dfed8dcaa2f55d61ce4ce5b980121be,447,TRUE,1008,561,
8174be483a20c39c88e45f4c67732f0d,2808,TRUE,3982,1174,Radiant
ebb578d1df03138ed4971c1610af9371,1168,TRUE,1859,691,
1939b75ab4995e23f8d7f47e438a6763,1886,TRUE,2028,142,
f2f78b2dce8a87cfe9d623650d38415b,842,FALSE,1530,688,Dire
4ee201b3d1035e1cc61073a5661933be,356,FALSE,2063,1707,Dire
35a382dd9350c86401f142915ec6a94a,891,FALSE,2008,1117,Dire
1dddd145a7fb106ed1d2a278bea25937,2834,TRUE,3463,629,
549ea89125814cb00fe1c2794d4fc0ff,2352,FALSE,4242,1890,Dire
6fef695d83f2723de3c47119a92a65c3,1047,FALSE,1717,670,Dire
97132aa069f91776a973346ac4330595,1191,TRUE,2210,1019,Radiant
98834aa11002e9a9a694d9b0c3f2fb0e,1128,FALSE,1753,625,Dire
e709158d542d5bbe9cae8b0761ab3cc3,787,FALSE,1118,331,
de65b2c35265dfba9ffc883e012d9e47,285,FALSE,1882,1597,Dire
71fbfe6c575248fb88c9cb4ec8ed0d62,1194,TRUE,2331,1137,Dire
77d47a3d3afa25b1e5a2c9c206b75578,1373,FALSE,2787,1414,Dire
5ab9206c12866003b50e8b522b77a903,1708,TRUE,2642,934,Radiant
ac2d5c13b841d2707d0dc88960f8d9f9,374,FALSE,3133,2759,Dire
30a86920309b1c4bb7855483568972ff,12,TRUE,3296,3284,Dire
5d29534246a25961ee843af2988ecda1,161,FALSE,1905,1744,
51e2162d45190922db812a8351a5dba8,1323,FALSE,2027,704,
d557d4a9e95605968a196a86bc6edfab,1307,TRUE,2061,754,Radiant
eab2a98194b1066abc68aa09b4432514,1332,FALSE,1921,589,
83bb9454c37b4a5fb84eda0fed550e86,1368,TRUE,1974,606,
da43e75dc79fc5ff3668f36497ef9792,1211,TRUE,2157,946,
ef0219d39a583d19b26eb93cdc2ead0b,468,TRUE,2947,2479,Dire
46447d9c90acbdae8b6401f34415ac6e,353,TRUE,2912,2559,Radiant
e5244554e8a3182a5eefa987d0693844,927,TRUE,1472,545,
40b88fd327a80b082a25231ef822796e,907,TRUE,1954,1047,Radiant
c17043aa2d392aeb63496f1dcc2704cf,1195,TRUE,2463,1268,Dire
e5212bb36a76ffbe9791dbfad4e0bd5e,979,TRUE,1503,524,Radiant
6126337220ab7665767959359a99e157,3037,FALSE,4858,1821,Radiant
8f47ad51d1526e08693b4619f731e521,880,FALSE,2327,1447,Dire
e36f2db5568adeecce96608fc1fec47e,1675,FALSE,2103,428,
c25cd3b929fc78090ab97d4022393a1d,1437,FALSE,3830,2393,Dire
f70a2c4413b3ab5e625db41202de40b4,814,TRUE,2637,1823,Radiant
2154c68da2c1ed8e4dbdcaefb622ad39,607,FALSE,3156,2549,Dire
85a0191663a7e034e4dddc313a91b99f,1127,FALSE,2634,1507,Dire
3035c1d2befdc9b917db798ab0c3ec53,1995,TRUE,2588,593,Radiant
38975238dd958f0ae59f0d7ecd9e3d17,408,FALSE,1251,843,
887927d907f8e06606601199f7469bce,1547,TRUE,3144,1597,Dire
5e9fb151722592ac8a05aee7f0ae9871,2672,FALSE,2779,107,
443d98487718661f9628cc4cbd6e6888,1221,FALSE,2617,1396,Radiant
92d12dbc05b8c0d1733e6f90525cdf83,589,TRUE,4021,3432,Radiant
97c159c6fa4b14b50ffa6f4a9821f3d3,3,TRUE,1993,1990,Radiant
747244821b5aeee9e92ca859312f7c98,786,TRUE,2023,1237,Radiant
2441902a5d8730430e17c1e2a36f92cc,2799,FALSE,3304,505,
2b545aad2588c2b7aa0698d828a8c75c,618,TRUE,1471,853,Radiant
a349a975b4ea3f49797e83ee79175d20,2809,TRUE,3402,593,Radiant
dbafec0e76b836ea01cfed8832558397,1974,FALSE,3016,1042,Dire
c8108f6251c4e66d6e21a3372703849e,838,TRUE,1962,1124,
7840c9427607671b916ee489cced853b,171,TRUE,1797,1626,Radiant
70a49bf5326ab7c1a060d4d6bd1feca9,547,FALSE,2994,2447,Dire
f9fdd5e1391e853fec78256f7492514c,661,TRUE,1222,561,
ab7a9df341dac0e517e7cc4c580d6289,2296,TRUE,2506,210,
1d5c97f095ff5a2cc8f900e47d4ff75c,133,TRUE,2571,2438,Radiant
f9157b755d8b60975c28aaa154ffc775,843,TRUE,1612,769,
d2439e0c887b99b2891aaf38e06cf58d,1107,TRUE,1292,185,
09efcd0c0644229e2264fee77db8be18,444,TRUE,1351,907,
2a1cea95330a250a8ecb7131173ac999,21,TRUE,1704,1683,Radiant
2d10973c60dda709ac65970d03bf69b2,1904,TRUE,2210,306,
67a1f68ec203f5a65dc92f4f0acb1f49,1562,TRUE,2985,1423,Dire
5e70dbf0c3c0b2a33653fdd4736c58a0,1935,TRUE,2606,671,Dire
34feca3803881d3a11b86d40a9d611ac,764,TRUE,3108,2344,Radiant
4d79f88458de4aa3298514df340ba38b,814,TRUE,2910,2096,Radiant
33a450f6c112a964aa8d488462cea308,2450,TRUE,3272,822,Radiant
4618ebd691c57802ed00e7e2f051af04,999,TRUE,2000,1001,Radiant
a57359912bfa7864ba15f3756e5f6ad2,399,FALSE,1791,1392,
e75288eff8e8d0261253c3f65473c57b,461,FALSE,3148,2687,Radiant
4c2acc0d7ac87952101b4859e3fea8b3,3035,TRUE,3968,933,Radiant
703744b5b9a1e7bec0a5d5ebfc4025f3,1221,TRUE,2601,1380,Radiant
fb05d5a23b4e2f730210152c8dde03fa,291,TRUE,2901,2610,Radiant
6176de9b29ae9d8ef221f6f59858f5fa,2071,FALSE,2291,220,Dire
cdf335630733c3573371ad559f83d293,759,FALSE,2350,1591,Dire
d16511bd45c2cac76e929e1169d21faa,689,TRUE,3383,2694,Radiant
867286b021b0d7a138fc7d441805a894,2070,FALSE,2662,592,Dire
1446b85e6bfae42037831a991c4912fc,1834,TRUE,1908,74,
5c401a2f026be9f2d9974f67847cdf15,1887,TRUE,2152,265,
519845883dc08313b0d05a18699f941b,339,TRUE,1850,1511,Radiant
3272e64793a17842ea36b54c12fccc33,1888,TRUE,2544,656,Radiant
4aedf0bd99bf1197998e1621573d0b8b,2165,FALSE,2274,109,
930c489465760708c8801e48b8768f0c,945,TRUE,1887,942,
0b396c421bfbc65e30b49b4cfb3363cb,2936,TRUE,3060,124,
8f038677388c81deccab093e64d5a159,1966,TRUE,2400,434,Radiant
aa3df0cf414eb81c52cd5aae90c295bc,388,TRUE,1896,1508,Radiant
21bf3f172f41f717f54934e1645a01a3,319,TRUE,3062,2743,Radiant
92995df30c5cce2f9955b392938533bf,3529,FALSE,4127,598,Radiant
ee5a6fa37b4e4d7b36ada0b1b428e5fe,2515,TRUE,2696,181,
e0943081f9251fc187680c80cdaf51c8,2687,FALSE,3226,539,
18959f9c3e1bd7dc56a10e848ecde0c2,1085,FALSE,2775,1690,Dire
5bb0c1390182a474d240e0f33989940b,2531,FALSE,3678,1147,
c261570a1f5b25413fc105ee8ad22b76,400,FALSE,1687,1287,Dire
619edd9b7d07f8e5a4cb608771112c5f,1272,TRUE,3413,2141,Radiant
ebc29f57fff4a1c55cf002b246e13ee8,309,FALSE,1652,1343,
11cd5b4c3944eb65f377901e3774935e,186,FALSE,2410,2224,Dire
ff05b098f394969fa9b4d4d46290e98a,1257,FALSE,1673,416,
90be4a7fb686ed444518169e15e36498,76,TRUE,2471,2395,Radiant
93048eb0683f9b0cd9dd91033e642410,441,TRUE,1955,1514,Radiant
40fba6a748a2e8ea95053819422f45bf,1605,FALSE,2240,635,
2349dc4bd7c2fd70b5c4290a9c97c848,212,TRUE,3088,2876,Radiant
648fe4558c9983846781b080813a9615,1236,TRUE,2574,1338,Dire
8c0b8231070c258bd5d24dd5dc81bc54,1592,TRUE,2504,912,Radiant
8c795ed855b18e16f2e5ea439d861143,108,TRUE,2689,2581,Radiant
19244a9b103c1d12605c61287c82ba74,352,TRUE,2679,2327,Radiant
c1fbc2dc43a4d8f5cc76782799917c0c,1125,TRUE,2454,1329,
fa64002bbcc6ce6d111d4546fadd1f39,1339,FALSE,2785,1446,Dire
ff75256e39493cc1305bc3201a581e45,1850,FALSE,2336,486,
a4ba313faee8a9cb81e03867580634e4,1821,TRUE,2527,706,
116b13e0506fa578f01767857dad9f48,1702,FALSE,1956,254,
d6c3612f28d2f8e750407eb0dd589858,3645,FALSE,4131,486,Dire
95ac3af22764bd3e44baa625f592bd4b,1208,TRUE,2460,1252,Radiant
27740d8914cd847342cb5a948579d363,2984,FALSE,3151,167,
6b69c27138258f7c24da1e4efc933180,1812,TRUE,1857,45,
d75b9e5b4864a4d14e69debb1cfcdc8b,1489,FALSE,2654,1165,Radiant
255022fe16f84f028e68757178c27d13,651,FALSE,1689,1038,Dire
95e9f5a5923e6a9421dafa09fa74a952,1832,TRUE,2336,504,
5f25f98cc187b10f015df78f0bbef8d0,2033,FALSE,2540,507,
d702e755566b7a80d3566365ff7999e7,1890,TRUE,3607,1717,Dire
478e959ab9f96e8d5615924bbf375fc1,576,FALSE,1760,1184,Dire
af0fc7bbbd9cf647b7595b41694c5589,1426,TRUE,1701,275,
09297eeb42709ea521c2e85c29cd1970,785,TRUE,2476,1691,Radiant
5e2420f531df05fd0a90d6923ce6987e,1250,TRUE,1525,275,Radiant
7844f2bec523d83dc27907605a15e9ed,1852,FALSE,2569,717,Dire
48aff23cc94fb5e349400f94d4caad35,598,FALSE,1432,834,
597269e82cdcbb918d4dd1871e4e674c,1545,TRUE,1931,386,
37c287140c0c65ea285c6d3f9eac1e74,210,TRUE,2639,2429,
1b461afc05f55205f36abd855b0a5f69,1616,TRUE,2169,553,
8dc5e1ebc144cdb414c26f64370f17b1,2143,TRUE,3239,1096,Dire
7813461148c04582cd651758e7a3575c,795,TRUE,2680,1885,Dire
1761bef005169e57d948ed43afda7561,1390,FALSE,3017,1627,Dire
84cb5d70702802a4d40e8f4c74977988,1408,TRUE,2648,1240,Dire
582142c94e4c442c6449faca1e978f2e,1175,FALSE,1766,591,
9d4a4a364d71ad58b5256efafe078977,10,TRUE,1858,1848,Radiant
bae2456808a8d87867a79c29d463849d,2840,TRUE,3209,369,Radiant
3e3c2c35f57453d3745de6336597d4ef,1939,TRUE,2172,233,
ec68a0d2167313da96ca4f11828c4662,2116,TRUE,2777,661,Dire
458d7bc6efeed6fb4251542cdae409df,851,TRUE,2508,1657,Radiant
ce9723c8e1ed6c909f365ae97e052fd8,1074,FALSE,1911,837,Dire
48954a06e8534b7e2b50bc99b4916f37,2391,TRUE,3028,637,Radiant
fae41ec0c1dd17becb3165335d61e9d8,1975,TRUE,3915,1940,Dire
988a53c0f6aedf2cd5455dddbf6a113c,1115,TRUE,2526,1411,Radiant
bcd8ba2668bc6460fc70ffdee2c9a41f,840,TRUE,1352,512,
405ce33dcdfcccd15295720928b45979,232,TRUE,2511,2279,Radiant
97d4b27d4f9abd4b6a7c8dedbdf1d9ff,2006,FALSE,3133,1127,Dire
09e78409f4c9093536b80e8c4706acee,1896,FALSE,2462,566,
f156a83cc4c8d9337290bfdf78d338ee,1053,FALSE,2161,1108,Dire
1461538f6b2dcd6540aa0af147e0ac25,1123,TRUE,1255,132,
7b4c288c06d81cde6d677027f6e382c8,925,TRUE,2772,1847,Radiant
b209c5de5295ac5c485492524fc271a3,1836,TRUE,1960,124,Radiant
4e0b17288449365ab0089acae8caa024,433,TRUE,2122,1689,Radiant
39f864febe373ff27c593310d3929bac,1189,FALSE,2390,1201,
fd863b084efe651554d9ad75c1c35385,148,TRUE,2831,2683,Radiant
929a799ad0b848279c7a7218f9c3a211,1050,FALSE,2511,1461,
dfb7abef1d2f64a535892ecefabefa2b,859,TRUE,1662,803,
9700f65fc19520892c4450961ab306a9,1161,TRUE,3477,2316,Radiant
8195a226cce7204f48e1d1ff73f2380c,637,FALSE,2938,2301,Dire
989337e6e5397cd9bfb6d9883426daf8,87,FALSE,1920,1833,Dire
f51a11de59a69b952217f835ca58a048,1727,TRUE,2002,275,
8bf06cf43dc41a09a8e65a75423fe6aa,255,FALSE,2818,2563,Dire
c25b80b1b87313a12a71528a4f9eb11e,309,FALSE,2977,2668,Radiant
473a95b5314f65d4ccd5eab02fd3cd68,1002,TRUE,2556,1554,
068d1bc3aee5129a598bca706898776f,4059,FALSE,4150,91,
e33b6bfe2bafba7c34583c79b4f968a7,1477,TRUE,1637,160,
2aca399ed25971d02443236df945b7f1,445,FALSE,2329,1884,Radiant
f1bc7c7c030f74645dff59c1d428e3e1,1368,FALSE,2467,1099,Dire
6629c9db4d1e497a86eab64ed4bd4f89,1051,TRUE,1579,528,
87d19426b6d234c2fc96cd834212fd59,1268,TRUE,2068,800,Radiant
13049b4dc5ff4861fb339ac6c9fa7ca7,2153,FALSE,3575,1422,Radiant
47a794d452a86c3c6a33448f9b47e83d,2351,TRUE,2473,122,
3d268cfd642daa25a370e8514037951e,2011,TRUE,2061,50,
63673beedb1dff4e1a0e1c8cdb631405,222,FALSE,1999,1777,
fac70672e5b932499702e6b9fe940925,1875,TRUE,1962,87,
2a58bb8aee12931965cfa53bf42b32c2,256,TRUE,2210,1954,Radiant
0c606d7dcac3f76dc150a14ef9fe1310,1195,FALSE,2787,1592,Dire
9d68b279381b930cc96dcde961af2306,1802,FALSE,1890,88,
1b4901e14aa77a9f8a5bc441cf69c94f,352,FALSE,1103,751,
6eadce6bae28eb13f6f70f554df09720,280,TRUE,2233,1953,
50ff5aea194b83765b045831e0d43e9b,506,TRUE,2748,2242,Dire
824a630a24f9b82e11d78a59152301d3,2045,TRUE,3199,1154,Radiant
3bfdbb3a76bd6084931f93c72602bee8,579,FALSE,2145,1566,Radiant
4d1f8977fde7a867b9c246cf4ac72524,928,TRUE,1136,208,
14b5ed418b457633c5a4644dd5f3c6d3,3420,TRUE,3666,246,
8d7aab649e88dab17f3b54b1bf8ae045,619,TRUE,2585,1966,
c9e019378a9e34035d75d459a135338f,2328,FALSE,3343,1015,Radiant
7684c7923929c5bd221df5f0cef972d1,1460,TRUE,3013,1553,Dire
1d7fbad027bf1b56a83548530fb94698,367,FALSE,2463,2096,Radiant
6aee7f369d31cb15275e2efcc442d2e4,628,TRUE,2061,1433,
e084580ff01982ce167a8a34cecdc191,501,TRUE,1633,1132,
cb87cbb1026a0e16a36190634f625fa4,77,TRUE,1711,1634,Radiant
f76624b585d7eb65ef08c3d5ac2832e5,1762,FALSE,2297,535,Dire
e00edc07548d68675945d64d12c98e51,563,FALSE,2098,1535,Dire
40ffa0ca38902d09b92e99e2f4aa0640,1402,TRUE,1700,298,
fe6194b84772dccf95f0357d273368ef,3017,FALSE,3601,584,Radiant
0b255490fda83e32e7e86ab6125b1f75,1123,TRUE,1479,356,
ef2d13c95c67ca595bc3867c69189dde,1472,FALSE,2815,1343,Radiant
76e3eab131280a37101cf54f28cabb1d,2666,FALSE,3223,557,
3aa1904e536909f4ee850427c0356ba8,97,TRUE,1505,1408,
6849564f94cdf1d3dff1d4f525776e89,282,FALSE,2803,2521,Dire
dd8499c7c86a255f3d520655a23f6301,57,FALSE,2811,2754,Dire
3f00eecfad13120fe480b62147cfb4ac,1181,TRUE,2018,837,Radiant
eab4879fb845038f844dc5472c081d70,2066,FALSE,2606,540,
1c600d36004a2e8a1f0bc91a5acb3f17,130,FALSE,4294,4164,Dire
df06ce99269deb9f550006e74f444941,1990,TRUE,3718,1728,Radiant
7a97495080103a959cab33777126b13e,2273,FALSE,3696,1423,Dire
c26cb9ad629815031a41e032b12a8eeb,154,TRUE,2041,1887,Radiant
4f23c6c610feacb761851734650f872f,354,FALSE,2718,2364,Radiant
cb275ccd7c4ea9ad2b051ce43bda5f29,813,TRUE,2453,1640,Dire
dd5829d227ebca05b5329f835c3fa86e,2071,TRUE,2503,432,Radiant
12851e02a9b96b0d75168e33fe227976,1697,TRUE,2194,497,Radiant
19a814f0da326b4cb61051f8926eb231,1062,TRUE,1492,430,Radiant
c2686306311f2375ee2ad068b8920fbc,551,TRUE,1429,878,
05955342a1aaee579455400140e3d5ae,1634,FALSE,1781,147,
ff950a2d8f532b2ff7cfed24965e1a59,1299,FALSE,3085,1786,Radiant
145a58744f04b7bd8914babeaa11901d,2983,FALSE,3048,65,
df8be0565d6f129a0b641bb685c18eed,2208,TRUE,2654,446,
c7d020c615ef24c04f6102729aea41f1,1781,TRUE,1980,199,
eca4806242b3f2017069cf579bac85f5,2741,TRUE,2881,140,
e5ca80fc2c32d87899016092ddc13848,1897,TRUE,2201,304,
89747f9d0528d8eeb438e88b4382f1dd,1489,FALSE,2933,1444,Radiant
c5c3c34bc6b475d27146c3e159af7f4a,1987,TRUE,2031,44,
29019efb229720e679c9d88c6c5b61a6,1532,FALSE,1639,107,
dbecd2b1ac3df970bdb1034164a2b422,263,FALSE,1902,1639,Dire
6381aa9824077bd92b229fc48c3cb908,724,TRUE,2052,1328,
e6197827bf03f5c32eaa4e74a39f9a94,1500,FALSE,1960,460,
44624579744456a41cedb1963061d336,1180,FALSE,1713,533,
bb3eaea791272ffadb2c9be3536679fb,1795,TRUE,1909,114,
51a58dccaa7d263aa385c8ac3b7148d5,1270,FALSE,3291,2021,Dire
13c497fcf5458e0ddc56fbe36658d0ef,670,TRUE,2673,2003,Radiant
a3ea403ddf81c6cbe34755f23985c7ec,2071,FALSE,2468,397,
1ef16241b60e49c8266e8d6a105cbc6b,2158,TRUE,3122,964,Radiant
bee90aa55a7e8f09ded6a404b593bd02,1708,FALSE,2470,762,
bbfd7e52f35a9109fd778c54241a3505,922,TRUE,2181,1259,Radiant
f4f535247bbc0668f2a9836ce78df3b7,1212,FALSE,1633,421,
0904e8fec6b0fa7e296eb783ac30444f,2203,TRUE,3076,873,Radiant
c3f194e9b61c5824faae535a9165bb14,1037,TRUE,2034,997,Dire
6a07b07e29d32387cd03e39f34c43650,333,TRUE,2326,1993,Dire
252cc248f3e4eb3212768797138d69bc,1205,TRUE,2137,932,Radiant
55a5a0f8a5dbffa9407e845f31418842,1007,FALSE,3486,2479,Dire
8fea604727d56514c164df2437616aef,195,FALSE,2961,2766,Dire
041e68e5f50b9c2930b73e202e8b9b72,238,FALSE,1753,1515,
631b2d5fbb31369d3a799b7199c1f2c1,1131,FALSE,2810,1679,Dire
6da29f2c9730cac062e1bb32a16e147b,638,TRUE,3288,2650,Dire
33b51a8456f293faedb934457733e744,1757,TRUE,1806,49,
d9ecacf48081c57ca0209facbfb947ef,283,FALSE,2991,2708,
7233f4390aa4b078153110b70014221d,386,TRUE,2611,2225,Radiant
a604a1aeb7cff53b7353d7b68ed0a05e,1115,TRUE,2204,1089,
de3a5e7376cc28a127941cd505206aba,2703,FALSE,3454,751,Dire
91690f034e150a479a3f4a3a9c7b8151,1108,FALSE,2459,1351,Dire
da0e5a6cb1645c946b33199aca33ca34,809,FALSE,2130,1321,Dire
8acb049d731d0bb0f3d3a011077982ee,2562,TRUE,3085,523,Radiant
0da445addf987604f72e856e8c01e300,793,FALSE,1495,702,
ffbc710810d4200f25481c78bc964409,955,TRUE,1897,942,
18f8d051ea6594886c40092224be0746,24,TRUE,1526,1502,
2c82587b9ddb970f63caf67c2940686f,386,TRUE,1339,953,
0f856aa53535c6d4e418f44e256bd357,1291,FALSE,2188,897,Dire
88f25a3bc20c4078e56b68ebe64485fc,857,TRUE,2802,1945,Radiant
e7184b8ea810b262e249ad580ee3f018,596,FALSE,2476,1880,Dire
3ca66e9b079f6ecf03bcfdd9a09a32aa,2106,TRUE,2196,90,
8e4847d98aa5cad3cfae6d95579df8a1,349,TRUE,2107,1758,Radiant
d6f0a317d3f89a59e487a70dd3d06c92,1327,TRUE,2962,1635,Dire
5d15afdeeb242b4bae48286f6c512048,149,FALSE,2439,2290,
aaf3e6a3b6be9e36eeca63b4682ad7f6,1030,TRUE,1946,916,Radiant
cefe12c1a6083f20024b0fcae35149a0,1124,FALSE,1174,50,
e11706dabac1807bd30126854f05c22b,2124,TRUE,2331,207,
78cf09434bdb87b847087246453b0843,1654,FALSE,2208,554,Dire
073d4f397f02077a746fabc90a626698,2538,TRUE,2996,458,Radiant
cdfbf720b47675b7c292e81a6d865796,1794,FALSE,3588,1794,Radiant
6e7ca3e516d17c41c95dcef581e88bcb,197,TRUE,1963,1766,
de857f28af20ce3825065032c2b8017f,155,TRUE,2103,1948,Radiant
d4127dfc62d560567e9b1db065f8e3b6,999,TRUE,2998,1999,Radiant
069e3960acc935c979f8c85574dd2172,1862,TRUE,3633,1771,Radiant
30bb6817305a72ce661aae5c5937ef6a,1155,TRUE,1473,318,
ae703706027a9f97858aab8176f78de4,1087,FALSE,1954,867,
cda01665d1fd56cedda49bb7626c6088,1774,TRUE,2874,1100,Radiant
470e6d98d04da95d63c11535023a8594,2417,TRUE,2485,68,
de40d001c815c81d0d43eb242ca5579b,46,TRUE,1398,1352,
22ed15d7fd407819cebf147521d4721a,1695,FALSE,1900,205,
3aeeebbe3713ac6f0b0fd95523084514,2026,FALSE,2808,782,Radiant
feb41940672f2a79b438e29d3d37c2b6,1622,FALSE,2489,867,Dire
af7123d1a1efa0b949413ff2c1a5fe01,1263,FALSE,3108,1845,Dire
80b8cd9156115c4352626e41d0c3aa64,1453,TRUE,2748,1295,Radiant
9cf1d14a88a43b57db94834fc10be3ee,637,FALSE,1360,723,Dire
46f537f0e1479810d83f842542830f20,2855,FALSE,2916,61,
8d1b51c9d11ff9f1a0c5e3cf9e9bf4c2,2244,TRUE,3371,1127,Dire
2b3bdafb181f4bcab439b25e0989f81b,508,TRUE,2149,1641,Radiant
75d1d491b2902ed3727f83584a1d2ca2,1162,TRUE,2958,1796,Dire
6bfbafbccf06740ae17a964edc638931,1933,FALSE,2618,685,Radiant
f076b812a56acebbba52c7afafc54eb7,1197,FALSE,2124,927,
6ad6a6fb94c3bc9ea3f07423853b6245,1292,TRUE,3212,1920,Dire
f9cee711d62d4ebb45c89b34b523d11c,1475,TRUE,3115,1640,Dire
f6af52358c16b3317be798af913158a4,3067,TRUE,3390,323,Radiant
964f0614df3ef090d9aac215a5f1b301,113,FALSE,2585,2472,Dire
f0dd945cec279321e4d9fc4d2661551e,43,FALSE,2247,2204,
c36536fbe07d61d6c83bf14d1c8d2134,194,TRUE,904,710,
5d8cdaa80065e60935523598a5803cf1,319,FALSE,1723,1404,
c09cc6a8c52868c64fb9789d74e8f704,1855,FALSE,2433,578,Dire
a9543ed34d1ff3cb7f7fc94008eb550d,741,FALSE,3053,2312,Radiant
7476e87d688a437a77be3b3733ab521a,2161,TRUE,2383,222,Radiant
68855640902772027eac8490eba0754e,1008,TRUE,1111,103,
9bde20b9e57d700de6fc6b72c6780c5e,1786,FALSE,2152,366,
f4786a97d4cf8f79fab5ac4004e372df,2384,TRUE,2644,260,
4556f5c3a6851df77b27418c0cfd10d1,530,FALSE,3828,3298,Dire
0ed14bb54b041d3c752ec417b4b30770,950,TRUE,1582,632,Radiant
c1029f227e2b15a46d91f1a75e84ccbf,2243,FALSE,3232,989,Dire
8b482b7ab51d8c30aae3f0a2d65fcc64,944,FALSE,1932,988,Dire
cd9984520a1b7710872fcbc6a17a832a,1139,TRUE,1867,728,Radiant
4373a9ac031c9146a1d939fa2689d4ef,42,TRUE,2060,2018,
8f438dbc6148c0fc297cad67e2e640cf,489,TRUE,1873,1384,Radiant
9982fa7941ecbd58c17ab397b27aeff5,1038,FALSE,2526,1488,
741b400aec75034f9ad34c9a969794c4,679,FALSE,1430,751,Dire
b157e002a3fa84f6e3fe487103e3a488,164,TRUE,3256,3092,Radiant
ec697a0f72d06d559cc2f6e94b49b596,113,FALSE,2533,2420,Dire
343d170fe77cf6969e716a5b97b8a59e,315,FALSE,1506,1191,Dire
0752b6554a5d35f5ed9d8b8a2855c895,87,FALSE,2030,1943,Dire
8390b0c6079feaef0f20de98d02f26c7,1796,TRUE,2435,639,Radiant
b2a91229eb63da86ef93e3f8e8a8a2cb,2390,FALSE,2482,92,
0b36b14fd6af1d166e5da35561d0b07a,1253,TRUE,2000,747,
b8173ce48536042043bba3495ffe7fe1,650,TRUE,2654,2004,Radiant
6df71feecbde242ee21dd90c2509a74d,635,TRUE,1885,1250,Radiant
65bdcd1ea8f64a985e133b0b6b3e35f3,455,FALSE,2248,1793,Radiant
91d7f761930cc78be846f399111c759a,13,FALSE,1786,1773,Dire
9e30e8cfcedb1d729bfb12aa6890de32,1803,TRUE,2091,288,
634485703d48478eecd473c26127fbb9,692,FALSE,2298,1606,Dire
d88f4346f1e40b862ea115beb06f7e24,1692,TRUE,1957,265,Radiant
9037f98851dcdf02ede9692721221fff,177,TRUE,2226,2049,Radiant
bb45b47d05c63a59a2c2718d293a6ad8,682,FALSE,1972,1290,Radiant
6154ecaa8a445777f97f7df12ecb6c00,1667,TRUE,2093,426,Radiant
43652c26ff6d5254b853361e0d527da7,1576,FALSE,2643,1067,Dire
5b630375f9dd8596af1fe5ff21437bea,1398,TRUE,2073,675,Radiant
72efe5f6dd684e85dea0bb98c5e6603f,114,TRUE,1935,1821,Radiant
1f5532803189f2fae83049f347157acb,117,FALSE,1975,1858,Radiant
7d801e6699e19612cd526fdbf7b31137,447,FALSE,2021,1574,Dire
a09396ebcf0d8f2556ff0e0edceef1ff,852,TRUE,3160,2308,Dire
5ca58127a4183d5ad76735aaffc67198,1674,FALSE,2985,1311,Dire
df55bc3456aa9ed5b5db7c5d52e7a91e,601,TRUE,1591,990,Dire
2aa191ac02e5f08b8cde5db2dcab71d8,786,TRUE,1401,615,
e4b0c3d109c93854ba1903d7cf28c73a,66,FALSE,2069,2003,Dire
f25a7b36ac2f46f04b75ccd8fffc7348,592,TRUE,1982,1390,
efc29f7532094d74c946d72275afa52b,698,FALSE,1885,1187,
b76d0501f4e44791b8325af116e37b05,3917,TRUE,4360,443,
71887e9a0631eaef37691a5259a17169,1426,TRUE,1483,57,
accae5cc0afadaa97fdde9f2b9537cec,1776,FALSE,2093,317,
74753a0bc910d0558ff72db381ba4d5c,2055,FALSE,2404,349,
50a4559998ce975672a4b9d5cf5f60ae,2328,TRUE,2685,357,Radiant
4778fc20ff030670d112a9bd8a5f06ec,486,TRUE,1287,801,
0588d8790b15789092d8bb8d705c103f,2245,FALSE,2461,216,
44755b0306f45a84073b6a37a2c9ca89,1234,FALSE,3001,1767,Radiant
dcd097cbd3a89719f4d140ec4a4e0da2,331,FALSE,2993,2662,Dire
7d14b9f11819e403a06d3b58b4ca4726,3068,TRUE,3205,137,Radiant
d6681aa1d181028ac9f8cdf63748f0bd,1684,TRUE,2128,444,
509a7ca17adf51e10a164322ffdcdaec,2506,TRUE,3890,1384,Dire
94f0ddae883101b6762ab2ae19ebefee,186,FALSE,3221,3035,Dire
40d75f50dcc6c58298fe7baaba590666,1812,FALSE,2896,1084,Dire
420e7431f1caf949a575c1b91c3dbc0c,199,TRUE,2528,2329,Radiant
0fcdb374d0e04013cde3a06092baadff,907,FALSE,1866,959,
92ab1c520994762619eed42cbb82283f,186,FALSE,2501,2315,Dire
61632c2bbcb952d9054a4c6a56e9f211,1258,TRUE,2783,1525,Radiant
f9b15322dc8b875a29886212ea4260fd,513,TRUE,2753,2240,Radiant
e0b6daca48702c188c137cfb7f548190,316,TRUE,1020,704,
5ad9fad5bd7f6015010a05b6481d22f6,283,TRUE,2290,2007,Radiant
c33f2e756af394f31e8a29c11a4f8c9a,3092,TRUE,3827,735,Dire
529190b1467b36cbaab0c02b8803cb04,61,FALSE,2161,2100,
ab0e56965480e710896c6136efb3044a,1785,TRUE,3834,2049,Dire
109a07b7255820dddaa0311affe96841,1802,TRUE,2368,566,Radiant
eafd33757abc603d5cc9199e21b76c43,2044,TRUE,3531,1487,Radiant
c23938b51f244cddb723c45286195741,249,TRUE,3176,2927,Radiant
05e2da42d7e983d211092a95cbe9d445,171,FALSE,2479,2308,Dire
ae7cd26a815f8022ee439daa7f38be72,1761,TRUE,1882,121,
8fc0bb255d08581ee9ae25ea9587cbca,1649,FALSE,2819,1170,Dire
a0ba4ef0965f56d2eba69c2b9ef33353,2549,TRUE,2671,122,
6ed4de7a8740fabab4d0252ae16c5a8e,1488,TRUE,1963,475,
4fdd03707243bf3fb3759594ed42448e,479,TRUE,2351,1872,Radiant
ac5530ff40b87b448b9e0acd8b367964,1185,FALSE,1701,516,
ec2f9d444f608356bc1e169acf7b2df9,362,FALSE,1339,977,Dire
e7151f60b44a8d71889b537411ea6157,114,FALSE,2417,2303,Dire
7b1f2dba9d3d95f65f2cba3b59dfa564,1226,FALSE,3589,2363,Dire
28ad1e3b7a0ada6c05bec1da50337cbc,1379,FALSE,4740,3361,Dire
2e870f7584ec57d7a6bcc41274e7eca5,537,TRUE,2713,2176,Radiant
25cb14d0bcdb3054b7a8dd8eb19e6a2a,891,FALSE,1725,834,Dire
0248812041678ca3538a4740c0b80779,2412,TRUE,2628,216,Radiant
a85dcf79a0a104f75c717cd6cd10fa09,626,TRUE,1681,1055,Radiant
81591603875aa0305a9c354c9a5abc2c,1688,FALSE,3114,1426,Radiant
cc0546f91bca2b7e6b9c48e27d8e4333,491,FALSE,2840,2349,Radiant
48c153e747143671e89cfe39f8dd3e25,2005,FALSE,2749,744,
2cd85f9e056589b4e4b2afaf9658538b,1788,FALSE,2414,626,Dire
0a4c38dbb3e646d39778f40d8e0cc85b,2034,FALSE,2161,127,
360a5ab6e22b41143906a2564443be51,1491,TRUE,3171,1680,Radiant
51760c7e3f745057e762e6755f813736,1801,TRUE,1857,56,
f26ce43cafa430523bac1f2d24e47691,1972,FALSE,2341,369,
84eaab20b7055843e1326c4d3780b225,2202,TRUE,2564,362,
731246a13d4b796711444e1c772f42fe,509,TRUE,2588,2079,
0a797eda7cbfc5bc8f69eab3c2c2aaac,1795,FALSE,2695,900,Dire
9163eb09d6a3bfe306e94e127d86bb11,771,TRUE,1167,396,
5d244c6b52fed829b4ac6c0f9f96f85f,1193,TRUE,5638,4445,Radiant
8c63176774f1f2e3eba8464d3f276334,780,TRUE,1529,749,
6b11e9988cc7e806d0c49d5d6029749e,1259,FALSE,1757,498,
cfe10acfd6a50bde6c2367bee483bbf7,1955,TRUE,2796,841,Radiant
e2cbe915372f9bbd2a5ed95cd4d324a4,1826,TRUE,2643,817,Dire
5c916d56351d1e17956d060a2972f70f,542,TRUE,2488,1946,Radiant
6f2dfd747c0a21126ec6daaf49caabcc,2029,TRUE,2303,274,
d4871a61581f834766fd5f740cd23263,379,FALSE,2006,1627,Dire
e619b653b16761c581fbe2ac04414d09,1120,FALSE,1791,671,
aadb6f5ada5b2fa5db7291e79420275e,1736,TRUE,2313,577,Radiant
8d31c2a25caea698189723af8bc703c7,1526,TRUE,2504,978,Radiant
f45331059c257f016e3811f6c366b3dd,843,FALSE,1816,973,Dire
f88f6cf2aca1ce931bf07d1610b35497,2373,TRUE,2782,409,
a7b2f71ac1ea937885f59d875b21e7cd,862,FALSE,2777,1915,Dire
044db49cc3fa907cbd888069b49e4c95,3262,TRUE,3384,122,
6bc505fad5c0a05dff7d060f20e57542,1537,FALSE,2729,1192,Dire
4b3d150cec4be259a0a4d9d7a77bec21,1766,FALSE,2601,835,
cdebb2ed6bf42313b24bf38b13968da5,1983,TRUE,2166,183,
4fe23bcecb5ac6dd96fdc56d66521e65,556,TRUE,2164,1608,Radiant
1c8d09219abc68bd14a170078e26623e,904,TRUE,1423,519,
52dc7997745c90e4f78782f4d97e392d,1793,FALSE,2739,946,Dire
71eeeef19edb5b101335755ddc6cea2a,1719,TRUE,2248,529,
3a7b322583ca9e0bb61e8ffa1dbbe26e,987,TRUE,2642,1655,Radiant
a4ca94093e6d7a30ed3ee91288339b8c,511,FALSE,3387,2876,Dire
5070d052a11700627e220f071678e7e1,1798,TRUE,1926,128,
c040446177243707031816231de09c2b,45,TRUE,2026,1981,Radiant
0b5585831ceeafa8f30eed32a2c156b4,1059,TRUE,1576,517,
261ab7a191c23cb1c92680eb61380d5c,1455,FALSE,1872,417,
b7e8a96ad0b94cc474f13ad93c17b329,1044,TRUE,3679,2635,Radiant
182fd05aba25969cebbd343c7070e93b,673,FALSE,2605,1932,Dire
392d3d36f983a07e15a16273f1a6a7b4,212,FALSE,2605,2393,Dire
637bf8aefddf885349d88d5c2ed123b4,1767,FALSE,2309,542,
05e17d2cf65ebe2dd81b026fb8f49575,1934,FALSE,1972,38,
560d349b9ff6a6cdc82825312563adab,1423,TRUE,2227,804,Radiant
1b8a164681b6e51be40219e4a12c826f,2451,FALSE,2887,436,
2323aaf0d25a4c01e6eed2cf903175ce,1701,TRUE,2268,567,
544a2d9752fbe64913578f27110b107d,1546,FALSE,2603,1057,Dire
d8623d33641f8ca6c44d2387164acf31,143,TRUE,2059,1916,Dire
316d5913eb253b28a0ea6f91dc6dd2b6,1738,FALSE,3049,1311,Dire
abff79975df302bf3216e14850963e8f,887,FALSE,1894,1007,Dire
383c5bce377ee1fea298d50c9fe0eb26,1473,FALSE,2010,537,Dire
4752b4fc5c0b9ed7de3a302714a9f4a1,2033,TRUE,2307,274,
0ae2c895c70c4b4d7bcc09f9b4d614a6,1476,TRUE,3297,1821,Radiant
5ff662509c2b67176298e89562caef44,2069,TRUE,2356,287,
f4342d7f853a0e2b10848fef34ac7e35,167,FALSE,1158,991,Dire
d95b95a9e1be838616c4e3985a1b2213,1324,TRUE,1561,237,
048273680c5ae1cce0804d1ba3c7a891,119,TRUE,2290,2171,Dire
14692401c71261c3505f88123f884adf,741,FALSE,2943,2202,Radiant
f0c7e50986859f3ff7dad3569daf9703,1767,FALSE,1994,227,Dire
3d28e227d61506f18030b9e9cf8bbdd4,222,FALSE,1214,992,
54224a468e72d29ad42d5dc16d9c3430,347,TRUE,2824,2477,Radiant
0544638e198a11d9691f97d9bcf9d198,162,TRUE,1110,948,
80180a16824cc97abc61f1c63bd9d52c,1764,FALSE,2305,541,Dire
46af5b63d8b2914be463bb628471c321,1866,FALSE,2418,552,
38f50709af79d4df72685c4df824f005,3972,TRUE,4294,322,
85ef179f255a5d5370295e1c5a33d3e0,823,FALSE,2796,1973,Radiant
796d90e1a4cf7c16fde8bb72a5aaef27,468,FALSE,2004,1536,
784d0367870272c3540c88e960b10a5b,1551,TRUE,1933,382,
21f5f0ffb72ffd650404bcbe431ba1e0,621,TRUE,1711,1090,
9123315864832b74c8372372dae9ca34,878,TRUE,1777,899,Radiant
4d20ded81ee6f5f5d1390cc83af2bc43,764,FALSE,2489,1725,Dire
cee4f61fb907a465e695da37e82e2f62,1387,TRUE,2209,822,Radiant
d3d1dbbd33eb3112b3ebc84d2c8048b0,3417,TRUE,4282,865,Radiant
27cd6abaae2ceaec8016bda8da771850,909,TRUE,1266,357,
034f667df3f477437905d844c7c46b7c,1307,TRUE,1701,394,
46275ae6adb728d5461c1cb62f694150,2117,TRUE,2302,185,Radiant
fe749807ab97237d2a95dbd62e44bd02,903,TRUE,1394,491,
9ab30224e200dfce313230467dacfbe2,1395,FALSE,2532,1137,Radiant
92bbd0442b732d67e2ae721a1c5edbd7,3154,TRUE,3381,227,
2b31d5c6bc47126deff711f546cf4c8b,726,TRUE,2559,1833,Radiant
ec2c04eeedf3734c49169eb253af7bda,930,FALSE,2894,1964,Dire
a69edbac4a6d601ef34fec7a9d0e5ac2,1536,TRUE,2604,1068,Radiant
ae9f807c272273ec876e462ed647afd1,796,TRUE,994,198,
1a472221964a109e2ab2f93c0194492c,72,TRUE,1697,1625,
02ab51c521826f35d14bb66b5db3ee11,1416,FALSE,3312,1896,Dire
b3c702dbc34d99be1e022e4910a46d94,70,FALSE,2386,2316,Dire
24fb4b6ce1941c5bd921a65c23f0d504,636,TRUE,2882,2246,Radiant
1319f4e84d80ddb733c0578a9fa360e8,2189,FALSE,4472,2283,Dire
958433f51703f1d2c90d82f46ed0f567,154,TRUE,1134,980,Radiant
2357d854141261f5c16db1d798715707,2348,TRUE,2694,346,Radiant
9fc36edc69ce0b263b556102b188e72e,1483,FALSE,2468,985,Dire
de3d8d7a7e5af8008a852b692dfb05d0,1194,TRUE,2511,1317,Radiant
db9f716d875100526f5884624e5f9613,3431,TRUE,4782,1351,Dire
91b66df07d68a93d7a57c7e8a2106099,65,FALSE,2202,2137,Dire
41aeca70872782a8300946fce66b3425,822,TRUE,1013,191,
29cc4d70b4d2b45cd7c58ed2771e1f9f,1437,FALSE,3653,2216,Radiant
8b704dd1690646f35a4e12e54b7b5eae,330,FALSE,2340,2010,Dire
4cccf66c7b054d6dc8bff9683b4a4112,657,FALSE,1397,740,
4e82e74a5f1084be3a5d4965c7492632,1077,TRUE,1628,551,Radiant
26e4ffea974b36c02643d117d377f0d0,1360,TRUE,2368,1008,Radiant
d896088c7ee88f36c1db9e20c2adcd7a,1709,FALSE,2551,842,Dire
8eb3ae92c08dc7318c975525e2b8d5b3,2817,FALSE,3295,478,
d38f48672610763b28d3dfa7f839d6cb,675,TRUE,2395,1720,Dire
93e78392aef099ab928e50fafac8cc07,865,TRUE,1913,1048,Radiant
4e1792a33cc0bf8ceaa6799311025da7,1067,FALSE,1973,906,Dire
ecd46cf2e3bdc296b5703e6409d073bb,1019,FALSE,2529,1510,
01092ef9e7f494f59cc2ebd56cffde73,310,FALSE,2570,2260,Dire
30c5d5d903866fbe933dd081f9918178,2571,FALSE,3714,1143,Dire
14b6478dde95b25447c087a76412ea34,255,FALSE,2188,1933,Dire
150feae66144620e9bc330d293cea93a,1140,TRUE,1612,472,
b8cfae6277be6c75c4c4fc254a6ddc3e,2006,TRUE,2197,191,Radiant
44ca37b7f7fdf01a82abef2b52fd562a,586,FALSE,2157,1571,Dire
7244ca9b4a5f6aa00c9bf48a0eeafb7c,1892,TRUE,2191,299,
44b51f27a2dc1f9b2da5159153a0791d,1527,TRUE,2140,613,Radiant
d7329bd0b507424df8b2cce3256cf054,918,TRUE,1484,566,Radiant
b23f9123456c2682e6ba77bedc802850,1074,TRUE,1952,878,
7e0486a4f21ad010925665a40905756f,1991,TRUE,2798,807,
83a2aececb7811279a29122bb27934a1,175,TRUE,976,801,
07b11d0b16c96ffccd8fa217139da7f1,2192,FALSE,2305,113,
86a0f9f71d110596f77e72ed428c10c6,1339,FALSE,2363,1024,Dire
be3aeeed133968e8fb4b99841707dbfa,614,TRUE,1916,1302,Radiant
0361daa307f1759d4d192c66247be50d,2478,TRUE,2822,344,
44e5adcec411cbe0df4989b6148cf12f,37,FALSE,1161,1124,
d32c32f13dc72551a55c0220d19f07a7,587,FALSE,1896,1309,
b39311e5b1054c9343c76f8c3553dcee,166,TRUE,4045,3879,Radiant
c6c0231fa660099d62bb9978bbea1cf6,2152,FALSE,2265,113,
c6a78ab268bbefc9102469a98c853ec4,1214,TRUE,2561,1347,Radiant
d697f50cb62ab84b52a1fff6d9a03286,832,FALSE,2450,1618,Radiant
5acf9ca79c6a2607b7d985fbd70ab738,1475,FALSE,1663,188,
6d98b19a5381aab0c2837118d0c29faa,1062,FALSE,1699,637,
c4d89b577b0a0e101b0d6d3c5a70b723,844,FALSE,1852,1008,Radiant
43d64ac25576ee337df8b3d06d8c9248,851,FALSE,2317,1466,Dire
bd93d4409baf81fe5955a406187f1766,67,FALSE,2193,2126,Dire
4139234eba88bab9d1d7df07877e045b,130,TRUE,2409,2279,
798c748119d27a5e7852cfd44eeb7b96,1638,FALSE,2270,632,Dire
f7bef0e58500f45e5298037885923286,504,FALSE,2490,1986,
09622a332942864b2dbe758d818b5fba,1972,FALSE,2113,141,
4a3f4d297d3457d7b13a93c450bae2cc,1500,TRUE,1803,303,Radiant
d433eebedde783f75f9e550c8086b609,713,TRUE,4524,3811,Dire
fb4a93ecafbaf9bb17e228b41b777992,1347,TRUE,2242,895,Radiant
5f73a690aec5565b95123e5d6305c71e,1640,TRUE,3086,1446,Dire
88fb0f431382d1a1fd517fe2f10c3742,1249,FALSE,2010,761,
65c02ccb49ab7cb6abd46a7f394177bd,736,FALSE,2674,1938,
06a526a3a28a06410ab0adf2117dd465,62,FALSE,2685,2623,Dire
019661a9721e39574b847826f26c5c89,1285,TRUE,1906,621,Radiant
029d8f7ca6c0234e2d448cac076a4ec2,1368,TRUE,1609,241,
b50b8d75c22b0a1bf3b178a9faea5e36,251,FALSE,2137,1886,Dire
533af27cf5649abfabb4595e8fe49a4e,2244,FALSE,3995,1751,Radiant
f1d79e06f5ca09615218d4c088eb1329,1162,FALSE,2363,1201,
3c0d24f76ad8a93dea3ad6c10ba15498,1049,TRUE,2812,1763,Dire
20ed1d9a2a25b080a1180d7453d668f9,1217,TRUE,2635,1418,Radiant
5d35bcedf61af1916c7f85b4295568ab,378,TRUE,2556,2178,Radiant
10db5006abc4795312c240f0b11eaed0,626,FALSE,2307,1681,Dire
7cbb56f9bb382ee29d50dbc180eb0066,1206,FALSE,2040,834,Dire
24ef6f6fb50b78403719042f52d57c60,326,FALSE,2604,2278,Radiant
12361d5abc7e4cc35d8d8395fe9cba7a,240,TRUE,3144,2904,Radiant
0769665d0758be9c8b64ae144108d4b1,1132,TRUE,1778,646,Radiant
770c11bbc3f37e86d99481fb0fb1dba8,2460,TRUE,2681,221,
287eeed7af1a6623665a4a3467af9c25,23,TRUE,1155,1132,
c870f8cd4e5285f07496c7869fe666b9,1469,FALSE,2127,658,
2514394c378edaccb961815fd5000bd9,1221,TRUE,1353,132,
78fe654085296af744fc028fe7ebbacf,1505,TRUE,2583,1078,
08654c9446b3215d60de1953babdb3b4,1196,FALSE,2249,1053,
d99d2236b6425475736fa0b545595370,381,TRUE,3835,3454,Dire
4c69601f47d92206c0a9e21919dcda7d,1531,TRUE,1718,187,
13f507173a643320caf182c73ce59c4d,1430,FALSE,2500,1070,Dire
90b249210f0519e1138c825a2259d167,1124,TRUE,2274,1150,Radiant
8a5ff257ba84f8bc518e8f1e96ac12d4,718,TRUE,3529,2811,Radiant
f082b670984bbf1dbfbdde82e3931b0a,2845,TRUE,3246,401,Radiant
ab1339981b69c40b4d4c845b392092c6,2681,FALSE,3344,663,Dire
ddddd10ece496fb4d95517e4aef79769,556,FALSE,2021,1465,Dire
620b354eb99bad4e3d1f48606145f41f,3282,FALSE,3813,531,
a6eaa56a04f3f069e72f2af0af45b9fd,326,TRUE,2597,2271,Dire
0ba8e8b4c8e8819f120af8b36415c8ba,1159,TRUE,3656,2497,Dire
6444c654633a780fe8f67c3ec6741b94,666,TRUE,2012,1346,
dc42b042aac16c59dd5b2c31b2919315,1565,FALSE,2490,925,
b95d1f9ef2e91be6a36686372fec446c,753,TRUE,2608,1855,Radiant
9e4d74091aa55ce730c3285ac39b366e,2335,FALSE,2423,88,
0ee2d2e19e97d051e9ea5fc2b5f7cf83,2550,FALSE,2599,49,
40094790bf36630577bb750ea38e9e5d,610,TRUE,1969,1359,
e56f2abe29c144228cf3c3f73b0a5b04,2081,TRUE,2429,348,
4ea5b3c6ec0b791805383e2774172615,343,TRUE,1905,1562,
930381235149ba08c677ac50c9e999f0,586,FALSE,3157,2571,Dire
a79b0ba75bbd6b4f309fc0c58fe13a68,1805,TRUE,2016,211,
e9f0e7a01bb788ed296c7dc091d5a229,1307,TRUE,1710,403,
e39dc58e2709edf3c0dc43096eada248,497,TRUE,1645,1148,Radiant
ce81b13a42ba39606ceb60d625da080d,1349,TRUE,2055,706,
a4e94cdfb9a46ff23cb32fa56f0eb282,169,TRUE,1281,1112,
d002b480b7006c3d4ceb64e4bc56c873,1549,FALSE,3033,1484,
1afd54d49202e1a0f51c6452b43b20d8,879,FALSE,1410,531,
03172b823e56a81e944e97c108058c0a,734,FALSE,2789,2055,
56480ca02058c6abe5a5f6f28c71a58e,1059,FALSE,1726,667,
a43ebafb307e5f86b2daff9288bc7c07,1383,TRUE,2357,974,Radiant
3df6385a5ab6434d7d7b92b96a616b16,2386,FALSE,2453,67,
cea5a6cf62e6540623ef2cd13fb05ecd,996,FALSE,1063,67,
270fe02463ab2d6a6d0d89b7c26885b3,18,FALSE,1560,1542,
c641ce3d577ce3f1b7bd190461b64182,170,TRUE,1422,1252,
928cba07cdc2b564705ef75d85b5cee3,1522,TRUE,2153,631,Radiant
4c6a3f6389dbf7b9ea763e2b4cce5f3b,1328,TRUE,2376,1048,Radiant
65532a28e6e6d512467ceb4553ef94e3,2555,FALSE,2970,415,Dire
1fb94bd113a4588b418c1f21f3d6c38a,216,TRUE,2049,1833,Radiant
6291de558d39d3bf35015acea581ce4e,974,TRUE,2510,1536,Dire
c2ee33568e624c3f0d5e7578281e85e9,562,FALSE,3141,2579,Radiant
f8f52dc9c2e693a0fc2125ec249e64c6,2054,TRUE,2514,460,
5febced59cf8db21c06ff530e071c0f6,3038,TRUE,3428,390,Radiant
f1149ae4307a3bcfb529651939dd3bcb,1697,FALSE,1972,275,Dire
0edf999a1554fe446cce386d32006462,1728,FALSE,2539,811,Dire
bea67c0a9ce804979ae40dd3a58ee76a,876,TRUE,2802,1926,
17ecd70420fb03620cde9c3ee6f667d1,1482,TRUE,2678,1196,Radiant
fd97d6fa1ecc90134b7870679481de34,1675,FALSE,3504,1829,Dire
922da2b39fda31017adbd6ba6d51660a,807,TRUE,906,99,
80c688fa973270c88af467fff357789e,1594,TRUE,1915,321,
7521dfa58938b16312b7762303d827ab,1643,FALSE,1687,44,
a6b85c40190b3f1a9c75feb9507c9ef5,1221,FALSE,3098,1877,Dire
925ae4b3302eee4558b5b0819cabb146,84,FALSE,1828,1744,Dire
26f12e6f639ae02651bb2cfff896e67c,1210,FALSE,2378,1168,
2ff92f06902f4bd2c6dd38e5626563db,69,TRUE,1250,1181,
16e5705dc75cd87a2bc882f5f8c67b07,2838,TRUE,3255,417,
1133713ebbd98e4522a5fc6a2a546395,631,TRUE,1623,992,Radiant
c28ff7778309e9920bff296ac36ad3bf,1538,TRUE,2114,576,Radiant
b2e517f06044c1f385023708ca9e9871,352,TRUE,1728,1376,Dire
9ac46789dedaf3f589bcefb975f25069,788,TRUE,4586,3798,Radiant
57c79c4a7e013a573698460a8167cc11,1624,TRUE,2652,1028,Radiant
14247e3b97dec28e7fe6b9c54926318b,1926,FALSE,2426,500,Radiant
dc2c11ce0894a8a5166eda4ba9211c7b,1109,FALSE,1775,666,
d57d2a86aa14f5b70045020a7ec57b42,816,TRUE,1871,1055,Radiant
5ded06bad110491de97e6194b1622c6d,2024,FALSE,3005,981,Dire
41c4dddf4bb0d8077cf5f1da415ec167,2659,FALSE,3150,491,Dire
233cd3410e09b250bf91b5052af3292f,964,TRUE,2264,1300,
7e0225f11774c7272385846d966c5e36,504,FALSE,3365,2861,Dire
be8a506b8074cbc92cacac80f5869a4d,2427,TRUE,2496,69,
fcd489e2ced344944804b93425f2d62f,179,TRUE,3393,3214,Dire
81b7d1d3c3631a533e19687026c8580a,537,FALSE,2128,1591,Dire
536d1ba30b4fd597d6b3378b96853090,217,TRUE,2588,2371,Radiant
cfddfda42ecf134b3507e2fadaaf9ad0,798,TRUE,1433,635,
350046f4953aeeafaf056bba08ed86bc,1080,FALSE,1602,522,Dire
f9d2936db52c2aa2adedf152551ad239,257,TRUE,2181,1924,Radiant
cc7c0e4f2f21e55781d75193a3b4acea,128,FALSE,1907,1779,
1ec1e9dc721775133a36ac4c2999768b,2447,FALSE,2674,227,Dire
c15145de368cf0ae7f2627fef3860469,2493,FALSE,3150,657,Dire
8be65987e9ae3f077b034d113f5cd741,1756,TRUE,3707,1951,Radiant
325002ebf25d1b9a99b370a93ca15ea0,541,FALSE,2402,1861,
0b310abb5e8b4d1b93c98e8a0572fdb7,1562,TRUE,2140,578,
1cdb506dfe3f5955c6c08724cc5c6c62,2431,FALSE,3064,633,Dire
27fd867159fed4fb152a6f03f9be8dfe,2008,TRUE,3054,1046,Dire
eadd53dc2bc02375172765283f35f8d8,510,TRUE,1579,1069,Dire
926db49c198365d7ab3f64fdb7fed4c6,275,TRUE,1748,1473,
b73af52bccc688b9b510511b9d114afb,1947,FALSE,2133,186,
0b8df2f96bb37c31bb88d072367e3818,512,FALSE,1971,1459,Dire
1447d86cf3a671e3dc5cde169282b710,2014,TRUE,2773,759,Radiant
a658022bae97d37eccf210e5e8181805,1239,FALSE,2616,1377,Dire
0bbf7aa7961bffa2fb47384b490fc795,2153,TRUE,2523,370,
89a336926438f5fc7551fde1d21c3e89,333,FALSE,2303,1970,Dire
bb0c12f3388247f3f2f0ed5a44b39024,1025,TRUE,2521,1496,Radiant
a015a3eff5a725e94ea0a9625169d78f,348,FALSE,1343,995,Dire
5d3c62c1799b5c08a9b1525dfbb73f0f,1018,TRUE,1433,415,
6961d42bae76655a21ebe5d5632df11e,1272,TRUE,1595,323,
c6b8a364502c8a9ec5bd932d258993aa,1707,FALSE,2151,444,
d3de0824d29716071c440b3505cbc6ae,82,TRUE,1457,1375,
0afb5d4776e6be46c030eec0411d7fd5,1448,FALSE,2058,610,
d9f94e29b04055e540425a7c1847bf47,88,FALSE,1949,1861,Dire
53dc345fb014660908d0e6a412deffc0,1763,TRUE,2330,567,Radiant
e78ebd786d031d0a5ef3f0b7d2f6bcfd,646,FALSE,2214,1568,Dire
e9d24d796bd0ec51b9b8370192886c62,1980,FALSE,3354,1374,Dire
30028c5c3ff313588566a53e125b89d1,826,TRUE,1635,809,Radiant
ef02e178c7ee03e18b10f7d16382cdfa,721,TRUE,1969,1248,Radiant
80106a58f7dded1de61eb4b45df66cad,292,TRUE,2479,2187,Radiant
c9a11f8c37bf6684ad0e597558b4d591,65,TRUE,1018,953,
0012f5c24c211fb92b7ea4d7ae73d6a5,1292,FALSE,2651,1359,Radiant
114926fa13bf94dbf884428aa55957eb,2833,FALSE,3093,260,
ecbb16fa7f9279e3e1cb0734ea2caf13,459,TRUE,1506,1047,
4f489ccc0d023985106416958c564e11,1992,FALSE,2073,81,
83cd9b5016865940fe8f6bcb68c76cb4,1244,TRUE,1663,419,
515b409f582416a872cfd545f2e3abe6,667,TRUE,2285,1618,
19eb0731679a7fe9a5c349eb70659556,1034,TRUE,1564,530,
6486be8eba8c0d420ce5d91976a41406,1413,FALSE,2007,594,Dire
7c59c63063ac35412cdc13ced2ac65d2,1709,TRUE,3719,2010,Radiant
c3565ef1ea3d78de7f468d0130e27331,1660,TRUE,2182,522,Radiant
571f98ddbd17ec2e102abc1ca35e3aa4,2126,FALSE,2624,498,Dire
525ec9625ec81bf40e76d35f24859b41,1518,FALSE,2525,1007,Dire
34f7429649365a9fcf1cbd659d9a6f64,714,FALSE,1812,1098,
ff73c206c4a7e3271db2f63097576efd,2280,TRUE,2858,578,
b6f16a44933aec8afe640c5a0b94328d,576,FALSE,1101,525,
eb09a2f56c992db7e5f324d03d3c9929,547,FALSE,2108,1561,Dire
a173863032ca2f63e76e5cc4ba1c330b,2102,FALSE,2336,234,
5968546493ee2934702afb15b86f232a,203,TRUE,2225,2022,Radiant
d33e07bef1d4383aab92a6d947f7f9b7,357,TRUE,2603,2246,Radiant
69d59bf6ce118f00f6d50b12f02fc5c5,1142,TRUE,2117,975,Radiant
5e81d72d0d9bc1ea530dd945084c5bf8,902,TRUE,2154,1252,Radiant
48162fba100cabacbba6f4600b7f9be7,1298,FALSE,2207,909,Dire
e82123f8ad4a9591908de9658ac5690f,546,FALSE,2265,1719,Dire
14f862776dfc742e4f92cd5593caf795,2856,FALSE,3124,268,
bb0a3c32c27ef967488234078370d76f,753,FALSE,1253,500,Dire
99144825b0abf5e820c4b3af7b296300,1134,FALSE,3120,1986,Dire
879db6f618fd1b77096feaa7ae447d66,295,TRUE,3671,3376,Radiant
6dbde5bca1a452cc66882d4ddfd14265,2189,TRUE,2665,476,Radiant
02683839510d303185dfd9965be5440f,1005,FALSE,3858,2853,Radiant
a4a0b0e61744c8d64141716af331e4a3,395,TRUE,2282,1887,Radiant
d26968f4e01bd6d63da1a4da3821d20e,1771,FALSE,2228,457,
79c9a457bf092358228648f352283b6b,136,FALSE,925,789,
1eebc7a92976d44937b3c6fef88f0249,1878,TRUE,2472,594,
9a5921e040ad4c6dae7514dd1996a2b8,1147,TRUE,3176,2029,Radiant
d243dbb063a70cb7245d61a86c0835a3,1553,FALSE,2930,1377,Radiant
0981641d76ba1673007d17915bd7cecf,362,TRUE,2145,1783,Dire
97ee8cb0700d39dd8ed18c748d3b6109,178,FALSE,2547,2369,Radiant
0d2f816e161714e581d7d977703a338e,913,TRUE,1740,827,Radiant
43d41cd575ca3e3b3315ba844c262d75,312,FALSE,1423,1111,
649025e7e3bf44de00162d39d8dd1699,1245,FALSE,2200,955,Dire
c6128dd32ced4ba876d1ed84aea894dd,1136,FALSE,2335,1199,Dire
3779e438201ef9be74126554b7f26c33,340,FALSE,2315,1975,Dire
2b77e49ff4599cfd6c84b55f3e287b93,1741,TRUE,2460,719,
ffdd16483c63771799fb5f47e5b72fcd,1258,TRUE,1805,547,
b7e5dc72704eb58ee8a17f157d7a53dd,127,FALSE,2164,2037,Dire
81f67649dd7dfd134d129d75bbbcc755,1438,TRUE,1511,73,
4f90cf0469a1e1a4d83322c4baa58a0d,40,FALSE,1843,1803,
a038e2039e66069691a6e0e11da2c901,1122,FALSE,3709,2587,Dire
0f8893afaa389ede6ac0659eae231808,965,TRUE,1649,684,
37bb9bed4cf0f00230dbc745b7d59d9c,1333,FALSE,2118,785,Radiant
5b1c28f44253d5be1e213fa188f46e44,1635,FALSE,2112,477,Dire
dd804fd460253aa90f78ff84c9e8c2ad,1198,FALSE,2282,1084,
e74d7b5aeaf9ce2d28ebfed046d0abb1,1278,TRUE,3154,1876,
16c51f272c8a74bbcf2959511c5c17ab,84,TRUE,929,845,
5afae28b86d13a55a4fc565a32dc2604,1054,TRUE,1809,755,
5f24655df98961869b5e4945aebf8a37,2015,FALSE,2365,350,
02479fe089de3c8ffc8c6afcf3c2254c,576,FALSE,2092,1516,Dire
e2c17eb9321020a286d4546be6c08615,836,TRUE,1516,680,Radiant
5f6f7f6b7ecbee56f8fe83160acf05ae,198,FALSE,2888,2690,Radiant
dd4286185e7126a371c214433f1e64ff,1098,TRUE,3261,2163,Radiant
bd310dac5733c789450af45a19d9cbbe,1207,TRUE,1610,403,
8afd5ddfcea8eb25b739f45446a946df,662,FALSE,1622,960,Dire
4c69f065071b7a61bf31a8fde959bc49,149,TRUE,1870,1721,Radiant
40f92c1259353b8c42e4126bb887abed,1592,TRUE,2577,985,Radiant
30692f283c46187fad0a51b74f2a9292,86,FALSE,2032,1946,
26029799508bc3f3f06248fe019bb585,1569,FALSE,1984,415,
21930ff32e5dde74494e1ef9ae3e7f17,342,TRUE,1786,1444,Radiant
40b3c127da456d8e6b80afd03a50a4e2,2247,FALSE,3372,1125,Dire
ffaf8dfd34cb68b700c4845a4d32a1d8,1162,TRUE,1696,534,
7e6370368a49dd2b90c59e3bdb20dbae,1460,TRUE,4452,2992,Dire
c099e38a888fbd61a0c921de2d18c99d,885,TRUE,1146,261,
3843667aa10305e05b4b45758701aaa3,2973,FALSE,4343,1370,Dire
3172bdcebc26060d809375a5ed2817eb,12,TRUE,2497,2485,
6bbe8ddf7f19176c4e3f3474511d79ab,123,FALSE,2060,1937,Dire
041b806eb977d12572667ee4df85dc3b,2226,TRUE,2795,569,Radiant
e254a0a3b34b51c47bfab1fdc40ce271,1026,TRUE,2502,1476,Radiant
6e5517a071854c9e71987557101c17b8,829,FALSE,1185,356,
0529478141078109001eaee4a1ca9a55,266,FALSE,1943,1677,
c36fceda96a9ef4975ef29f1c577468c,286,FALSE,1583,1297,
4baf34c5dbf0b0c53f794067d26bf431,741,FALSE,1768,1027,Dire
cce327a95779b75148cdda5178b44647,279,FALSE,3009,2730,
dfe2584e65726d6f1b5793bc2512c085,1071,TRUE,1738,667,Radiant
c13e4e7e32a04c78954f3bd9ff4befe2,1828,TRUE,2908,1080,Radiant
d95d9d76b2ec28130368bfeee0635b35,1577,TRUE,2567,990,Radiant
8de2add9996a157f130696936c4e87ad,226,FALSE,1976,1750,
f42dcf0653e91d878681907dad05e7a8,2443,FALSE,2735,292,
c51cbbda5ae535b9efe7f65075854f94,1125,TRUE,2227,1102,Radiant
0f4414fef3e1de7306ad7db47a90f0f7,286,TRUE,1284,998,
9828a84a41c32bae9d7258a6290185ca,1911,FALSE,2498,587,
d1141c576ebc67efa1e77ed5d61f5273,1108,TRUE,3729,2621,Dire
d17f32b95cf9620d6a66d62f6134e392,838,FALSE,2246,1408,
27b7e29e0b381a4cec1285868de47c76,2441,FALSE,2983,542,Dire
590a15a6d6359a12147f7a82abf317ab,2399,FALSE,4047,1648,Radiant
c2f5a3fcd4e1ba6e79f510a962aeece5,2353,FALSE,3832,1479,Radiant
4dea023df6092de2550a0b495cb935c1,1232,TRUE,3008,1776,Dire
fc60e1b33e78a4629020d57b1abe9f1a,1706,FALSE,2476,770,Dire
60a7ee76a88370a1c1931227076e6e95,1049,FALSE,2164,1115,Radiant
19c012555d867fbe0ce15b549274ba30,1413,FALSE,3787,2374,Radiant
f167a50ab744dd7a0a7d5458f2616768,1314,TRUE,1867,553,Radiant
ab62226f73c57614dd8ec5778ff6e251,1931,FALSE,3448,1517,Radiant
b92eeb3d36271243f8e5b22675a30f98,808,TRUE,2358,1550,Radiant
68d36d5ec40f8ebb61c37e546ec78fbb,515,TRUE,1972,1457,Radiant
e42653894e523ddb43bbeae53e24f926,150,TRUE,2529,2379,Radiant
689a3aa977b72da9f91848fe0f896b08,721,FALSE,2400,1679,Dire
99c7642079c3f9379e4f9ab4f35469eb,1484,TRUE,2995,1511,Radiant
5e76b4f155b72f9933f626c57eaf09bb,576,FALSE,2801,2225,Dire
36ba8f65141e3ca73b5a3290816ed10b,1849,FALSE,1966,117,
8d0e92cb12b52d5dbb7c3faebbbad3d1,145,FALSE,3809,3664,Radiant
0a7defac4f0b32ad0def19e59c8f3a3b,1338,FALSE,3171,1833,Radiant
e7a087eb2ed8b276893fb0d524c0c8ed,521,TRUE,2819,2298,Radiant
ec21abab4fba201ecb2202910ea1851d,1501,TRUE,2786,1285,Dire
4e91933b5b33b5e81facfa66fc2b0299,1310,FALSE,2794,1484,Radiant
75e624912402ea631924b46cfa529eb0,244,FALSE,2505,2261,Radiant
5892b887fa278fb4af93ebe0f3f628ab,685,TRUE,1905,1220,Radiant
aec9246effaffc31562cf391324c4909,605,TRUE,2043,1438,
4622499b1454a993353fd67ec9f8643b,182,TRUE,2460,2278,
da0612437cf9cf70ffda4078c2d59322,1061,TRUE,1148,87,
402c9e51367c5f0a330dc1e6a1034dac,1294,FALSE,1688,394,
83dcac4e39166b8200757af08d4ec8d9,679,TRUE,1063,384,
094c7386e049204b8b8d8dfc757bbd5b,1699,FALSE,1885,186,
e94a074abda269ea610a1d6f411db7a5,1287,TRUE,2394,1107,Radiant
50b4ead125644707318cd00e448330e0,1173,FALSE,1603,430,
75f9945ca4bbfab01c5b5a700096a0e8,1962,TRUE,2371,409,
9c3b235c020a15985e9eeeac6663521b,1188,FALSE,3559,2371,Radiant
73d2807879b569fa8b0d4ffb7cbdf6b0,712,TRUE,1993,1281,Radiant
9a7d44f6c527f22c399d99a74b969d2b,1321,TRUE,2146,825,
0b1e26b8fbe38ad2dcdaff53d9b93ac7,1712,TRUE,2335,623,Radiant
2594a0c4c4268076a03b7acff77cfe5d,1710,FALSE,2295,585,Dire
e4dfc966abc2635260f3522df033c979,1594,FALSE,2340,746,Radiant
f74f9fa870ce851c7954dbf85051777a,1541,FALSE,2723,1182,Radiant
1b3d5997302629cd15b539665a10f1cd,561,FALSE,1888,1327,
632d2c6be9e1a8c723f21a67e1111bc0,521,TRUE,1265,744,Radiant
0547f10f369a489085efbf78f5eb4c42,422,TRUE,2851,2429,Dire
f1946267508418d6005bfb77785bdf9b,1995,FALSE,2808,813,Radiant
92ef6c6b50d14b498eed88995284aee8,27,TRUE,1827,1800,Dire
03c4aff3548166c8f9e17c3f99b88d9a,1308,TRUE,1674,366,
7b6fe2bfad6a2bfbac68c7616491e09c,647,TRUE,1766,1119,Radiant
4ee2d4e551a3e38d6262bd0d1e3354d1,1310,FALSE,1438,128,
153eddca39e85a76e54e79ba20265dca,1851,TRUE,2274,423,Radiant
db38438007a8e3f64456b7d25dbffda9,564,TRUE,2038,1474,
3b86d45e2005b2604d1eeb2475965d25,419,TRUE,2082,1663,
4a7ae18147631bb2f79bddce3840eec0,832,FALSE,1761,929,Dire
f3affa910ae5a35fa2e15a28ad67c1fa,1586,FALSE,2193,607,
9a0669a09c3b1eb4522d7435e2b93a23,928,FALSE,3688,2760,Dire
98ceba1c630263de43979ad9e50c29a1,2628,FALSE,2813,185,
2b28c9a6dacbfd8224d2fcc36f636e6c,1492,TRUE,1983,491,Radiant
357498b8d6043be91fbf05b8cde3d89f,602,FALSE,1993,1391,Radiant
a09c7496a6c35708a1023f41bb235dd2,3665,FALSE,4170,505,Radiant
77451e7ced424611a723f24ff59e0a46,1658,TRUE,4051,2393,Dire
683dc7a11947804690c373ba414c33f0,1073,TRUE,1585,512,Radiant
f61a5010155f52505ad885bd89558f09,383,FALSE,1707,1324,
dfb419f46aa20641e76cea202d2181de,1930,FALSE,3088,1158,Radiant
03621870b175b086b076899631419e15,680,FALSE,2276,1596,Dire
3b31210fc21f731d879476bea9823e08,14,TRUE,2780,2766,Radiant
0c6e15ad7b98724b5c5aeb763f4fc5cf,275,TRUE,3652,3377,Radiant
0e725833bb3865768ed0a8d8d49d6510,1465,TRUE,2646,1181,Dire
125f4e6ccd1599f5114a30fc373c2479,1429,TRUE,1722,293,
eef45e34c6e171df15202982c84eb006,752,TRUE,2964,2212,Radiant
9808801527c88c775c83299f288b096d,1541,FALSE,3238,1697,Dire
ca8f453e5ba08fd779c7211c026b0dc3,699,FALSE,1652,953,
0c50a3521fdf9ff514462b0f255ccbbf,1495,TRUE,1597,102,
de7b747842d2aff1ed81029d0477df54,1487,FALSE,1800,313,
e9390b9fa4cbc3bddf59ec4428956ad0,745,TRUE,2000,1255,Radiant
a31be9086846e60f952b5ac92108d711,588,FALSE,2520,1932,Dire
b3cdf3b71435803e1cf2f350239d584e,2285,FALSE,3422,1137,Dire
ec79590852d7d2a4be0be93708db9495,727,FALSE,1914,1187,
a8a327270fad1e75a485ca0ecd7a360d,468,TRUE,2890,2422,Radiant
00d0c2c4c9fd95034d171628d14ea592,1695,FALSE,2641,946,Dire
1cebdb4a1e40c952fdbcc07225b942b0,131,TRUE,1101,970,Radiant
421e72e39daaa8ba940ab4d42b0a8b83,151,TRUE,1070,919,Radiant
cd2da8c5c7f53456da794934f90497fa,1490,TRUE,2536,1046,Radiant
c0c58f687ae8dfd44bbb12364360a1df,1773,FALSE,1940,167,
4977cfdb15f38c89f206c3d61d5b5385,859,FALSE,2820,1961,Radiant
035a0c1d5567cc9c4c60c5242132c747,2824,TRUE,3048,224,Radiant
9a142643f8873a8db08bb0c270830b00,670,TRUE,3270,2600,Radiant
cf66d79853c9d7bd05916906b9ff9ec2,1270,FALSE,2769,1499,Dire
7d7eab92de4bf784ceaf5e3e09780abc,29,TRUE,1614,1585,Radiant
37f017253d76aeba9e1829dbbd2b935b,1667,TRUE,1935,268,
dd6ce54fee91cbd375be7cf0155f99ac,1254,FALSE,3254,2000,Radiant
514e8bfb631152de1ebdf01eab85e76d,1829,FALSE,2377,548,
501629e630def910507d91402359e3dd,2647,TRUE,2877,230,Dire
cc2559542815580033ad715ff157e9ac,1872,FALSE,2442,570,
15a10efa4661256e0d729c068403e15a,507,TRUE,971,464,
c7dffe7a820f12dd5dde4f71db1b1070,542,FALSE,1106,564,
3a68e2804e96cf51c8ad98f3674a4205,1372,TRUE,2016,644,
41e90fabca92131638c2b81f013c5b8f,1791,FALSE,2034,243,
0f905ceb56992b2f7963b6a206dc03bd,1509,FALSE,2005,496,
76a3687727c4e043167eaf72a1920f53,1973,TRUE,3569,1596,Dire
6891b460e6f63383faf2bdb80d694b79,1089,FALSE,1746,657,Dire
2173a5b7e1e03c22fc33e0fc5e5c2d42,788,FALSE,911,123,
3639c1cd50407f0a35bcb7424ffa953a,955,TRUE,2542,1587,Dire
d5bea6cf11d5b1b760a721ae66a3502c,1189,TRUE,2839,1650,Radiant
4972208fd5dcf9a88af89b77fe9a6bf0,1604,FALSE,2089,485,Radiant
eb1a4a959172912796d881fa6dcbe2a6,2312,TRUE,2346,34,
a8d805457622246cdde2bfcf5d0454bc,1293,TRUE,4412,3119,Radiant
eedc66b04b173d0956ec8321743523fd,360,TRUE,2366,2006,
ba6f0b49f7184a2de7870210ebd5a73c,697,TRUE,2034,1337,Radiant
e39226cd36876b1313750beb2ceca93a,834,FALSE,1881,1047,
eebeb9c9b5f2fb42abb2bf4ee476cd9a,1395,FALSE,1919,524,
298ce82fa65b94b0e25d7ab2f6a293c8,616,TRUE,2155,1539,
0c3c4fdd2ca642823998a2f545c72df0,2208,TRUE,3146,938,Radiant
40d64af25f56a2560217014896a4bba2,247,TRUE,3106,2859,Dire
a4f0cf6251876f55db5ea7c443ed79e6,1278,TRUE,2112,834,Radiant
20533923edd08a8f9090b0ef785edaf8,44,TRUE,2362,2318,Radiant
465d5ab9a44940f6ec4775d9d5bc4bf4,1942,FALSE,2245,303,
565e254d4ef90b23bbddf41cf5786f20,491,TRUE,2361,1870,Dire
d73570f3126546c83ab8ece2536f6d83,2328,TRUE,3267,939,Dire
b485e79a9c032147bbddb6b4707cb70b,248,FALSE,2446,2198,
888e64f692682f1dfacb228e4ff27955,1371,TRUE,3231,1860,Radiant
33af4d976ee89fe39f95ed9e0571b1b4,1790,TRUE,2512,722,Dire
254173b18ca105b3d0e27e1da98eb8c2,1525,FALSE,2235,710,Dire
8596700c8741fb00c5d2d47493285e41,2410,TRUE,3279,869,
7c04554d10c78f4c3b4fa362da87eaa0,364,TRUE,2702,2338,Dire
47b67c78e5c5c8d9773af6ec0040a564,388,TRUE,3369,2981,Dire
4275b1b3e97a9b36a1e26d33f6afa086,900,FALSE,2214,1314,Dire
38d6a9bb7b8d941c2fe5d4ad070f3ecb,928,TRUE,1794,866,Radiant
a55316e4f88cc858a85e270a78ffb092,985,TRUE,1985,1000,Dire
e56beab91c255a12b80ac8be4533d651,957,TRUE,1875,918,Dire
2ea4b663328b1509654eb5ed83c16e60,1452,TRUE,2218,766,Radiant
07a4b63e8e73b58e580f73d3efc563c0,304,TRUE,1291,987,
3262c2741dd4983dc979518e0056ae4a,563,TRUE,2587,2024,Radiant
69190f7c5b02cd317e882d1af6d127df,30,FALSE,1600,1570,Dire
f5366659a31f35d6ebe11f7dcd1c5ced,1206,TRUE,1596,390,
67bf0ceb1d9a6d0db927d7410702a916,1972,TRUE,3299,1327,Radiant
4b6d4201f440470464748aa4af91ba44,2027,TRUE,2930,903,Radiant
f88c12da88ab8f88b57b1b8e459a81aa,909,FALSE,3623,2714,Dire
5f6fb78437c4f0bf40d4a808b8f945ab,513,FALSE,3013,2500,Radiant
4f9823970dc5cfba33f591e05bc7b1fb,1525,TRUE,2492,967,Radiant
e2320462f4eb2d90b9ea0c4bc8d8dd16,1852,TRUE,3076,1224,
b5cc4669c9411d724d1b09bae91b3dca,761,FALSE,3668,2907,Radiant
b795f7aa066fef0f0af8ca5ad2365fd1,1429,FALSE,3201,1772,Dire
b243b85d91a20ec067b970667e1002f4,47,TRUE,2511,2464,Radiant
a6bf159f3b5dd810eb0a5a885af2b5df,1540,FALSE,2318,778,Dire
1eee3982697ecf9c3e1a728d2a671511,2225,TRUE,3085,860,Radiant
7ae04caa8201f0f1a59e3be133cbbb55,1448,FALSE,2195,747,Dire
12752a41e9212746d4b174abbe73244c,1156,TRUE,1948,792,Radiant
01967a10f8c5cff7d493b4e1d634b96b,1431,FALSE,2289,858,Dire
cac6688065a8af148c345bbe166aa355,1289,FALSE,2015,726,Dire
31dadbabb029b6dd6d036e81376e2c46,1380,TRUE,2341,961,Radiant
2a941977f7f0d1c987563c7357563727,244,TRUE,1019,775,Radiant
203f67f421fd731320f2a11352505fd7,548,FALSE,1008,460,
18f8e09361deebc21f6164cc87af0739,194,TRUE,2088,1894,Radiant
fdeec31d8c7c0f944879b47d3da60440,689,TRUE,1655,966,
30e1cc24e1ede61c295f256073575d31,1541,TRUE,2361,820,
5ce4a2b908aea5346ed2b3faf39e2ee4,341,FALSE,2245,1904,Dire
453de23b20c94d4486d7728bea953480,536,TRUE,2055,1519,Radiant
e4f7c0dc8b70ace1997ba2cc30abe7fd,327,TRUE,2154,1827,Radiant
610942fa30ca8ea8f119411d3e66cfde,1442,TRUE,2854,1412,Radiant
cf6229bb228b8591ac210f24c365dcc1,316,TRUE,3122,2806,Radiant
d349a06b35451176102f1900adc4fb4f,618,TRUE,2547,1929,Radiant
17709f671a84e56874324ea3d78c4920,512,TRUE,2980,2468,Dire
242daa9c7ba7f90fc7bb7f469014603e,194,TRUE,3385,3191,Radiant
47fd0268751f8c05c1210ade921a5c3f,1353,FALSE,1999,646,Dire
a20f6cba34a47b8236783ec15a3a0dd9,1512,FALSE,3142,1630,Dire
d97b2dc026075e3ea671c967083db1d9,3021,FALSE,3201,180,
0c03647d0560764bfdd49c0e05655f28,586,TRUE,1982,1396,Radiant
4a6bf15c2b0ae54b84f3b1253562700a,487,TRUE,2478,1991,Radiant
185791223892c4d3faad49da72865742,501,TRUE,2879,2378,Dire
0396d75d72a910456c7eed38ede2bc9a,273,FALSE,2819,2546,Radiant
953a82abdae00d3d8d2703c7d4a332b4,826,FALSE,1940,1114,Dire
b23f02db6c74abfaec287dd0ee4bce08,3311,TRUE,3378,67,
941982952050eb77d47fbd7fbb2775d1,2663,TRUE,2941,278,
32d888094a431547092adf1a62c043c9,473,TRUE,1963,1490,
7f2751997473097ba59feaf11e142fcb,1504,FALSE,2283,779,Dire
667e5961692b87d4d790376570a11d58,439,FALSE,2084,1645,Dire
e54feb9e1f4e64b4c8572110aa4450c6,3397,TRUE,3497,100,
63576e01c506648fff5f9f8e9ddb6e39,1285,TRUE,2172,887,
3c86fb5378aacc3c87aac23c7b56c319,1594,TRUE,2004,410,
fec735cdf5a8270ec02a1d6bb4ff5c23,1604,FALSE,1807,203,
3bc447d02c08fdcdb76d529b9c685a5b,329,TRUE,1619,1290,
8761ef6d0b276e572c8b88351bde722b,2508,FALSE,2547,39,
dfe3449338605106c8f5ccdef6424744,685,FALSE,2805,2120,Dire
f603bf61a2a93f10a19d4ab38f69b5e0,281,TRUE,985,704,Radiant
e07b03c663b10f2288d7bd54174170ce,1840,TRUE,2107,267,
ce4d4dc8ba9370acc96a07b1efadffcf,480,TRUE,2207,1727,Radiant
8eafd2e24a544e41b86493183cbe7379,487,FALSE,2216,1729,Dire
2ef86edc4bd569b03ea570ce99a83ac2,638,TRUE,1954,1316,Dire
41d9780db39718b9b7d237badc7e08a0,1574,TRUE,2344,770,Dire
fdc175e351ec2359c5aa6f0de77c94a4,2588,FALSE,2651,63,
2f4a63fb8764e31c464180ca8d682551,167,TRUE,1902,1735,Radiant
5b1ff888d3b0ee7c20aa6e5385971c5a,2318,TRUE,3127,809,Dire
aa5f51b92dfcb719deb6be21bd3cd59b,713,TRUE,2287,1574,Dire
5029814e96e9bbab985d81fe11e9cd9e,1561,FALSE,1953,392,
2ea44c7568da47476d0e4e3bb4fa1a13,1682,FALSE,1828,146,
cf798ab1de5cf3b5b8beb0cc52b7465e,576,FALSE,3563,2987,Radiant
5d028846514aadf81a7e99ec9b7253be,2088,FALSE,2165,77,
e64a5e796bbdcfd2756154826e4d6a63,1742,TRUE,3863,2121,Radiant
181aab29cce4859640e86ddf7c04cc7b,903,FALSE,2542,1639,
e6eab89d1e2d8b8b8440110d4f985dae,719,TRUE,1748,1029,
5d37abcd80e7ec9cbe1de57ca09550fa,1689,TRUE,2390,701,Radiant
c298c45cafb00a81783a8e24112d5b26,1382,TRUE,2354,972,Radiant
d6a601a179756d7bcb56878aa747e891,985,TRUE,1257,272,
a9b41c6871a8e6adc76389e974a18ec0,1557,TRUE,1958,401,
6116d4b93768ae1ecfe930ae61adb3cc,12,TRUE,1390,1378,
304a0acaa2675b4c0d6f7fa01c69129d,686,TRUE,4124,3438,Radiant
dc1aa4ee80bb2d12079e4398c4d0540b,1041,TRUE,1084,43,
4891a62e826dc0ece403d78f04c0eaa8,71,TRUE,1821,1750,
6a1737aa296b7ec1dd882a9cd1dddd0b,14,TRUE,2255,2241,Radiant
f013524c85717fc72bb671b9587495fa,944,FALSE,1128,184,
e41fa0be19bbf30f78277ecb1e4de93a,611,TRUE,1884,1273,
faf87196e8c2d74f1d751ac3d9ab0ddf,1846,FALSE,2239,393,Dire
43839e354969c959798d7e2a7744be7d,2001,FALSE,2113,112,
add3a1707f15c32ad7c637afbe147e5c,263,TRUE,1890,1627,
a8ef2665ef916c9a358591e936827c90,616,FALSE,2262,1646,Dire
9d5eea6d1d10123f6d5c243f3aab4890,364,FALSE,1319,955,
b8cbbe9c44d8c05d0e99881686641f68,2903,TRUE,3219,316,
43c8e4ad85bf1cfbb7f10fb65f872784,1685,TRUE,2682,997,
288a7a7636c9652804a90d10d15e9308,952,FALSE,2590,1638,
a91f059dce10cfe669a1a118bce064ae,2481,TRUE,3546,1065,Radiant
8880f3c492f3faa5120b7428c61d20c8,1463,FALSE,2245,782,Radiant
9bb658f9c916e6f4b58ff6bf95acc0de,268,TRUE,2872,2604,Dire
8b7d351c4166818f7ef09379a0603e80,8,TRUE,1781,1773,Radiant
5345c5be5fc945b24c3456a1fe5c51d9,1317,FALSE,2281,964,Radiant
035fcd28603dded740ea04802effff2c,105,FALSE,3317,3212,Dire
c181091b5d1196de76875c43cdcf00ca,1546,FALSE,2809,1263,Dire
17e7c15af01ea5ba5d9c26de9abf554a,1528,TRUE,1905,377,Dire
7dc097921b0e609de7016b2218e43f9b,212,FALSE,2835,2623,Radiant
cfa4bff052821aec585182c6976e31ae,123,FALSE,1979,1856,Dire
c603a01f55a928ea76543a85f05adee7,2242,TRUE,3072,830,Radiant
c0500c86d49a0387b7fd3b0d12c865af,1233,TRUE,2825,1592,Dire
ecbaa6d249574a760785f471bb1e7ab2,1237,TRUE,2761,1524,Dire
b9079ade33d1110e8537f38017e342fb,266,TRUE,2379,2113,Radiant
18e3348a8790509fd4eb8e2e566c9d92,476,TRUE,2240,1764,
dfd5a327f1816758d07b8b30761706eb,422,TRUE,2479,2057,Radiant
9367caf7ca04ff37f0013d8c8b42e804,189,FALSE,1822,1633,Dire
6c1e2bbe1508ba5da82aa66edbcf2fe8,925,TRUE,2594,1669,Radiant
d226eea211af00430b93d6679c776067,185,FALSE,2089,1904,Dire
ab82c7f4888c165471ab61c886e2fe13,823,TRUE,1837,1014,Radiant
ff294d00e6f10b8a6934783922e40810,2320,FALSE,2392,72,
ba308d31d14254580ce5fb51d084f0c0,1001,FALSE,3296,2295,Radiant
59be0c13085d1fa6e3cbde94d4fbff5f,792,TRUE,2602,1810,Radiant
b8d832de88ee1b33fd736f13303af9c6,2092,FALSE,2561,469,
4383e8b643425d333345a994f35c80d8,193,FALSE,2357,2164,Dire
674d286e0b70b3dd0dfa425b5d42bbd1,176,TRUE,1203,1027,
29645c21336b96c7a3e3c8ae34fee6f1,768,FALSE,1306,538,
b6dfcec34243d5c0ec796e48d97ec5d1,646,TRUE,1331,685,Dire
89ee7fb320939ac6e72f6100152e3e3e,3013,TRUE,3426,413,Radiant
2041a6d9923dcadfd7eada65a378ce71,2399,FALSE,3074,675,Dire
83a3e12bef06c2286792bc2f8ae83d94,113,FALSE,2152,2039,Dire
8c8ca74c56f45339e9620afaec5afc58,21,TRUE,3364,3343,Dire
d87f4bfbd8a5c8cf6cc1d5415da922a0,2142,TRUE,2764,622,
db99735364f15dde93c098636dbcddaf,697,FALSE,1745,1048,Dire
f121df49c39270587bef0735b0e9d943,2284,FALSE,2436,152,
e18d48fe2bb397b1fa5133f3282c5946,515,TRUE,1862,1347,
16c14a9d23d992e9184d8b6bea521dec,1618,FALSE,2847,1229,Radiant
c9c510697e0189ae2d8e34e20c02b32f,600,FALSE,2662,2062,Dire
5584c0c662214cae4a29703fb09658ad,363,TRUE,1917,1554,Radiant
04d08754d89295e88eef60777b0105d5,1508,TRUE,2496,988,
b34011015568eea2ebd366f65cd1b5a8,829,FALSE,3084,2255,Dire
d8a0359332afd98cedadf7af945697ef,443,FALSE,1888,1445,
c903c83d00d3b6d70ebe689a8b9b59ea,869,FALSE,1523,654,Dire
7fb24ac6da9c76f5a80d4cdd19c123ae,1422,FALSE,2506,1084,Dire
7dcd59cfbee93f99ceccfa56315199f0,1659,FALSE,2264,605,
b7b10d12c14acf79681a3cb8cb0b791b,2335,TRUE,2691,356,
68620b5ba77fdd4742fde831827cc098,1669,FALSE,2428,759,Dire
fdf55354538755b993ffa9154372f059,2155,TRUE,4269,2114,Dire
f25cd3944fe928f504380ab35b94822d,1216,TRUE,2488,1272,Radiant
fa86ba7bb32dad0d4ccd4d87004414fe,571,TRUE,1927,1356,Radiant
73b3183cff29d57261bcbb537c74296f,697,TRUE,2818,2121,
6e34fc792ad162ac60be1de829166dbd,1475,FALSE,1805,330,
69ea1a1155d304fe21c146e6b836ad98,437,FALSE,1577,1140,
cb855162d76562cf080a76527dc4fa05,992,FALSE,2491,1499,Dire
a96a0edec9874b48afda4294e1d7cca2,207,FALSE,1291,1084,
6ee83edab26e0a5e394a061708af0c50,2224,FALSE,2535,311,Dire
e5714a16daae5dd42db994303ec9f0e0,785,FALSE,2390,1605,Dire
20f6a8587c70e6219cb93b41b8fdd018,2836,FALSE,3249,413,
aee889e52e0b286eb2b9c16ed00c2c8f,545,FALSE,1287,742,Dire
6fc30f47e324a357d084e8e937a7a9b6,647,FALSE,2046,1399,Dire
46f936c5e5ee979d6168c8595b8c03de,1187,FALSE,1839,652,Dire
fe6b567489b23b45a3a780f0b24592bd,1777,TRUE,2527,750,
6fdbf5f8b1ca73c12904130d9bd55dc5,482,TRUE,1982,1500,
000f6a90d850a43393649af550572f48,1449,TRUE,1631,182,
6e1f0ad7a7b42af961d13691ba09045c,988,TRUE,2196,1208,
73e977d6ea4813c836b4eb4e97b241d6,519,TRUE,1980,1461,Radiant
3d3ad2f509c82b9c719d081ffded1147,293,FALSE,1835,1542,Dire
e097485242b7be721ec934eed4fe3d65,1,TRUE,2333,2332,
507dcac02fbc41a46232d867eb865abc,2734,FALSE,3263,529,Dire
b1eb2666d4258c4d7a85db57cd4fb122,1823,FALSE,2549,726,Dire
c02a00bf015a5a21fa9fb97e6dc792cd,14,TRUE,1882,1868,Radiant
3732aeeadf4737beaf837b141e0976be,2682,TRUE,3201,519,
4378d8f185a0c6d0f4fedc0a5711cefd,1734,FALSE,3288,1554,Radiant
9507af7fc420cbd77cc24bf1131b5571,108,FALSE,3547,3439,Dire
34afcc3850b5e8b5165f0d7bf41907ce,1489,TRUE,2276,787,Radiant
6575716c90cf44d6899d64b41aa7e846,1862,FALSE,2418,556,Dire
7438a35f2119669b22b0a938e49b747e,753,FALSE,2677,1924,Dire
f68bc0a51ae16b0793dc4f60fee4c9f9,2423,FALSE,2459,36,
ddaa4239d703b74a150b0d4ffe46ccb9,1004,FALSE,2579,1575,Dire
db7034f6472346631a8c355c1546c653,492,TRUE,2089,1597,
7ce4122f2be4168eca97a0710bb18a81,466,FALSE,2164,1698,Dire
0c576550b18ec65c0a8984f591083bab,899,TRUE,2346,1447,Radiant
befe162c7fbc5549e8dfc69776bffb9d,497,TRUE,1723,1226,Radiant
1aba5c1d56d38254fc06a31e3829afd7,1570,FALSE,2477,907,
db7b53c1e865bf4839a2f9304218c60c,1159,FALSE,2431,1272,Dire
461da10cdb1e11ac665fc30cd45726a6,260,TRUE,2379,2119,Dire
b3c5101feec9ea0513950c8cd1a91f6d,1023,FALSE,2232,1209,Dire
f55745a7a6c9975db7586d6276b0721c,849,TRUE,2047,1198,Radiant
e9c1b49e6c64d8cdfbe042f1042ab766,1535,FALSE,2497,962,Radiant
9dce058c6f488766f0b5c37e3b8b0a9f,1561,FALSE,2241,680,
fb2deb09446407c7ae86a5f7571ef723,275,TRUE,3339,3064,Dire
ca5cf34b7fab12a6971599cb414d3126,578,TRUE,1552,974,
d0ddd1ad87219d7532dbf5289c96aa91,96,TRUE,2656,2560,Radiant
349690e8af9da1c8591e4a208ad3bb27,1159,TRUE,2106,947,Radiant
95e08535b8bf81747879a84aedab1750,1801,FALSE,2137,336,
9bf78763dd4531402b91fdfb55354ae5,1064,TRUE,2785,1721,Radiant
39b492856fa03ea468a1cb7b84bf79a1,692,FALSE,2503,1811,Dire
7f4cf995bfeba2d93f1e255293259edd,442,FALSE,1964,1522,
218e6bed3879903e4b18ae726d57a21d,1062,FALSE,1897,835,
384b7c317bf3cc4720b654ad9dc59572,1845,TRUE,3466,1621,Dire
6f4d7d55a8bbd3fcea6eff2589ef35cf,699,FALSE,2712,2013,Dire
1c9586f91feeb319d310fd3af5be3430,293,FALSE,1684,1391,Radiant
7495b33feca0a923afbdf2cc9d3484b4,228,FALSE,2655,2427,Dire
9e4cdc0b0981c5658d7836abf4327643,646,TRUE,2731,2085,Radiant
a4aa94bc52c5b2f971a97dfdee05bb45,2289,TRUE,2340,51,
e15fddf1cf653d15bb28646f5ee8e93a,279,TRUE,2372,2093,Radiant
f8ce4401db1273b7f0389eeb72595f4a,1846,FALSE,2125,279,
a4b6617a05aaa5b7bcf6dc13d195f8c7,517,FALSE,2004,1487,Dire
bb4879ef0814207ac4f4fd562e4185c1,1016,FALSE,1646,630,
f41fa74bb78cf04c8fa2b6f309399a62,1544,TRUE,2939,1395,Dire
a9c32c18eadc0f57cd99501f8184f731,606,FALSE,2533,1927,
b469fc3f90df8844ab56a1ec503bc3d5,1167,TRUE,2384,1217,Radiant
29620f33ff4dc2cd4423359da445303f,405,FALSE,2482,2077,Dire
32e0ab249d009c298810ff57eb098b3b,361,TRUE,1547,1186,Radiant
7aabe6e5677df51eab45bf961c5d9a53,985,TRUE,2107,1122,Radiant
172175eb86af3865a48d1f3b03fd9854,920,TRUE,2336,1416,Radiant
fd3dab92af8f26b6a392e8fdb866566b,991,TRUE,1912,921,
c99a09061adec271b99fafd8380ff70b,1357,TRUE,3074,1717,Radiant
21f8c44923d47bd254e3b828eb109215,1915,FALSE,2082,167,
e881acf222dd6fda1b2258a21146a0eb,1063,TRUE,1182,119,
13f2ea84de49a5549f050dbcfbacc686,518,FALSE,1477,959,
b31a2a6e359b88fbf0b6f608a77926ec,1799,TRUE,2655,856,Radiant
a97bb32ed534aa54289d8cbd8f99a786,617,TRUE,2871,2254,Radiant
e5cc763c2b06179e68e3502e1c0ed323,2565,TRUE,2690,125,Radiant
264654d693f4074c2ba889e365076b3a,147,FALSE,2443,2296,Dire
e4bc0f0a866256891ddaccd6594e8e85,2679,TRUE,2819,140,
05140a615f7cc41d4fed3814d40d7996,1873,TRUE,2063,190,
b373e50bae936eac54ab23c19445afb2,2072,TRUE,2790,718,Radiant
d7ed045a357b5ab0250a528e5905ff87,1619,TRUE,2875,1256,Radiant
67ffb3791c2fe58f641b39ee8efaa5cc,1592,FALSE,1949,357,Dire
0603cfc089b9a768ba338ba048cd1c25,115,FALSE,2702,2587,Dire
be736cc2a963839da27c8dc00af096e8,615,FALSE,1741,1126,Dire
858ed0e1b4f063b3adcf2f91d58a0c66,1611,FALSE,3195,1584,Radiant
3d7493aa5ba6395555255b0db76b9fbf,106,TRUE,4084,3978,Radiant
8f93efd90d61e5931f072e4cded98af7,2015,TRUE,2823,808,Dire
00fcdb096fb3e9f287ad4fbd33f023cf,928,FALSE,2299,1371,Dire
cfdf1b1964c901cbbfc852ff83bbc818,241,FALSE,1398,1157,Dire
38ea4d39080fe3a3a62ffecbcd765942,1220,FALSE,2189,969,Dire
be6d2c0b2693ea38237ec1ee2deee6b5,1959,TRUE,2919,960,Radiant
123ad421858526f72470911c44f37ad8,499,TRUE,1982,1483,Radiant
965787658543fd530fcd22ad51412f55,1820,FALSE,1887,67,
ea5bf290fba6f33aad3e01c68b76a5a9,193,FALSE,1915,1722,Dire
336805e3520403db8ea63e95fa714dee,2425,FALSE,2831,406,Dire
a4f2792b6dc717f7a74b33f5f2c39123,43,FALSE,1212,1169,Dire
6eb0592192072822f5c2c6b335874256,1048,FALSE,2667,1619,Dire
4def7c302819149dee34cb07f3f9d4f5,893,FALSE,3132,2239,Dire
8c6ad841a69ca65afe4517f0ea0fec4a,416,TRUE,1554,1138,
2215c94088b949b6f5fd3f36d480b0f1,1988,FALSE,3439,1451,Dire
e39cdff651144e12259a3b6e14643ba4,1232,FALSE,1969,737,
40c3af79da77d6ed4422c25d274cc0a8,750,FALSE,2333,1583,Radiant
c3ae92951d8c6cfbf2823c2ed205a6c1,1945,TRUE,3125,1180,Dire
d7fa5f691999ef09c9c9c77a4b930a59,271,FALSE,2907,2636,Dire
b78d323d24c545cd8af3299fc1420805,931,FALSE,4262,3331,Dire
c8f4b2b986d54fccd59bbc8a93d755c5,1607,FALSE,2187,580,Dire
82284f2fd786b4aa16b72dbde302e8e4,1482,TRUE,1691,209,
a3c53dff1afb73f21e0854bd0768192d,850,FALSE,2444,1594,
bddd5227772e71f41ec091e70a8692dd,1863,FALSE,2150,287,Dire
a177f24ae946ee470ebe988aacba103d,1278,TRUE,1933,655,Radiant
2a4e6e17cdc5409277053d845160020b,1581,FALSE,2256,675,
b25ff9a68fc8df8087db63a485e2c0af,442,TRUE,1158,716,
2b57970a5906993bd18fa50515695a40,223,FALSE,2489,2266,Dire
1d1c75783ce01f72dac61fc292f5d998,1974,FALSE,3154,1180,Dire
90ad8dab90820d2a9a845743ab452a26,56,FALSE,2838,2782,Dire
c28f28646ac233130b71f66ae9a27154,1069,FALSE,3213,2144,Dire
66747d916280d54be4c1f31d41cd272a,424,FALSE,2025,1601,
a2d5dee45e63b976469aae161c92a8f8,39,FALSE,1498,1459,
bc99df20f7954ab84de14470c148d9f2,1911,FALSE,1982,71,
1ab2b442f80eddda89cac56e64959d96,1740,TRUE,1806,66,
b2450e73a8dca5876a4e8a4ca1a4a01f,1853,FALSE,2365,512,Dire
992705ef13f85e454d00907b640849e4,457,TRUE,1553,1096,
c08cd94569325d5e421f43c01fd4e903,1782,FALSE,2878,1096,Dire
9bb2ae0323de69fcd5b9dff9b27340a5,584,TRUE,2640,2056,Dire
e902f3e9b3dde5e666582d2144d74d70,1404,TRUE,2423,1019,Radiant
105ae89ab6c12b0c70f03cbaf892562b,712,TRUE,2409,1697,Radiant
da44f0e1c30e4b7a7e66822c3941b92b,927,TRUE,2762,1835,Radiant
9b51c45ca9114fa9eaa82a4406bc4fea,529,FALSE,2970,2441,Radiant
a09e40c94f8b93096e3e034780393848,2948,FALSE,3372,424,Dire
dee75bcd2cde46633ee6106e3c740c9b,809,TRUE,1635,826,Radiant
aa842383fd7fabe7440b14867c228ff5,580,TRUE,2157,1577,
0c7ef4d4f490c8a00b61e7b152f63feb,2313,TRUE,2460,147,
c2fd398c282a885b5b38b2de6ca47225,1347,FALSE,3003,1656,Radiant
562498d6d7f1bec24781b9035bdd4c8a,473,FALSE,2157,1684,Radiant
adefd7c51c3b0cdb81dc5b38d136c691,781,TRUE,2492,1711,Radiant
e021daba4f385798cdd78f1163da77c9,194,TRUE,1705,1511,Radiant
5fdbdddee58ac27d042b73f7a3588662,1589,FALSE,1985,396,Dire
8484cf8de40d8bded2e42bf8b5c3682a,1557,FALSE,2139,582,Dire
8570362d7e059422bfb4175156309884,2730,FALSE,3452,722,Dire
0ccd03944c3960a52e9fb396d259ab6d,1198,TRUE,2429,1231,Radiant
a3197e683d4523047b4cffc2555791bb,1462,TRUE,1953,491,Radiant
78484b3f01e626de9c8ce341452cb163,834,TRUE,2151,1317,Radiant
bf114acb236b1575a9a29c1edbd20af8,839,FALSE,976,137,
dcf786e83089a0cc7ecb539809b7736e,933,TRUE,2852,1919,Radiant
c7f470aad8ffce625cba3d00ab9ae7c4,1319,FALSE,1792,473,Dire
931ddbb42f03b65f4cf8486da4bb28f6,519,TRUE,1556,1037,Radiant
06d56e35a5106d9855497be354a9c993,2280,FALSE,2816,536,
5917f4737df8085ae634d890d33ad9ad,2829,FALSE,2886,57,
8acfb35bbfab97724eb557455b337cf8,1485,TRUE,1592,107,
df945a3e12e3fe79dcaf6d3ecc06681a,1417,FALSE,2357,940,Dire
ed41efa51483ed2006c236ea2532b1fe,350,FALSE,2564,2214,Dire
a6e5984051584d45440871bf9548abb7,148,TRUE,1886,1738,Radiant
37e146d47ed2e356f312b23b8a8be06e,2007,FALSE,2248,241,
72ccf8874f6e335171c4b9cf0210c70d,1234,FALSE,1827,593,Dire
162bdb4bb1b3389572279be37411780e,1471,FALSE,3535,2064,Dire
3b2b810f8ec508d71d4ed990c2bdf867,681,FALSE,2932,2251,Radiant
679b5e1cf1c5c6a0444979b04d3a3894,1860,FALSE,2027,167,
fabd7bdae1e0aa266c50d6c42b3b1c43,1700,TRUE,2731,1031,Radiant
6ec030ddce8307a217268ab3ff563fd9,194,FALSE,1057,863,
0ba40cf5c41b801da12b8ab13793de77,1102,FALSE,2298,1196,Dire
02295eb730adebd5040b04d96fe1ed83,680,TRUE,4709,4029,Dire
1add41a850ee27fd7f77fc7e01e36e34,1338,TRUE,3001,1663,Radiant
b3642021541da42d6da7b89bf82cbb11,49,TRUE,1575,1526,Radiant
0386b455fffe171d6927b7dd355de938,1157,FALSE,2160,1003,Dire
ad8bce0b563d99df646140b30d485721,664,FALSE,3299,2635,Radiant
adad5e0ab510b8c086d050ee59b192bb,401,TRUE,2172,1771,Radiant
7f855c0818b9a51707c49d0475a15043,1057,TRUE,1676,619,
b4c0cf09a866b335b0bd48b85dd84b68,1382,FALSE,1593,211,
62ff390885be98391f3a6e02294b4820,1294,TRUE,2194,900,
7a94f3c98e01b70955250eb8dcb35be2,708,TRUE,1943,1235,
94b013e4daefe13587687afdef481cd4,625,FALSE,2215,1590,Dire
723ea44635040a815740123b6010ff34,1946,FALSE,3153,1207,Radiant
c6238f361ba8e10cb2648f4f6d290fd3,293,TRUE,2491,2198,Radiant
18cf444b8b36ca8bb389e67a62c09913,1324,TRUE,2403,1079,Radiant
57d9b2f540784963e55c8fffc4f7644f,55,FALSE,1708,1653,Dire
7de236f55eb2e1437c4373e0c24e19af,1332,TRUE,1443,111,
6efcbda2217b6324cd3e68428005baa1,667,FALSE,2152,1485,Dire
a8f6c66c2a0d9bae5d65c25430fce345,2446,TRUE,2841,395,
2cbc9650c0a96fd498a2a8ea758439b4,519,TRUE,2686,2167,Radiant
1ead2f67f1cace76019ba80982aaaa14,523,TRUE,3082,2559,Dire
e77521cb04447464a71af3965054a0a0,1436,FALSE,3175,1739,Radiant
133d1bc11560f30b0a7c8596fae1fbe3,130,FALSE,2075,1945,Dire
45fd8714e026ac1942393621269c0e1e,1028,FALSE,2834,1806,Radiant
dcf083c5a56f71552edb93011196e996,1674,FALSE,3506,1832,Radiant
7984763d0699b076329c531879094cde,370,FALSE,1138,768,
1d857564886be3430d8480e5f3c4f4c9,694,TRUE,2001,1307,
55d347925f19e0366f7a62ddf0914c6e,1285,TRUE,1947,662,Dire
70a84341738a749e596b42ee4e2c679c,498,TRUE,1919,1421,
d2932957357348c986cb59d2c4caf608,358,FALSE,2953,2595,Dire
e81962d6c9fcec5895bf40a8e3e73125,1622,FALSE,2383,761,
4cdbc8a3db8a81fca0afacfea9bd9fbb,1737,TRUE,3147,1410,Radiant
4fcfb3c61076e333ce2045a13b7cae02,1550,TRUE,2517,967,Dire
c56baa92e92b06cf4ec0c72f680a34f6,783,TRUE,2724,1941,Radiant
226a228b037b84a0fbddcb7cd4511563,1956,TRUE,2188,232,
f73fc88ab322ca4c1dee7b04eab6db3f,2204,TRUE,2845,641,Dire
ca2230be235cb4dc95866cea9112a976,2422,TRUE,2599,177,Radiant
f2bb59d8be383f9fcdebffcfb9841ea0,970,FALSE,1881,911,Dire
667c52cdcf86824de879481e2ecf11c2,146,TRUE,3638,3492,Dire
7ffc7cdf8460a91afc7b333059f494e7,348,TRUE,1883,1535,
dba0e7a28e7af143fe6ffdec5f3b6040,831,TRUE,1883,1052,Radiant
d5f4eaaeee5266b33b16de54bebebb67,424,FALSE,1775,1351,Dire
d0664c9a67320adbee97ad7fc33043c1,1738,FALSE,3372,1634,Radiant
0fcb1d8b9ec61b438c9fd1540e12f93a,116,TRUE,1597,1481,Radiant
9e251350b9916cb502bda40ddb561045,971,FALSE,1484,513,Dire
a04a5385cc80981aed50d497a035008f,891,FALSE,1930,1039,Radiant
6e24ac63ba64b99ce45d2b3b1c2fe715,838,FALSE,1987,1149,Dire
20787e75e649381d66acf5609597e327,810,TRUE,1751,941,Radiant
8682f9c3d6f493620654bead62a70269,347,TRUE,1235,888,Radiant
f095b39a23154c7bf3afdc884a6f554b,1021,FALSE,2457,1436,
633fda5f597c9452b73b32a6a965a85d,1510,TRUE,2030,520,Radiant
c1c61a98c246f30fa3100ae630ca913e,2170,FALSE,2384,214,
f409ba0224f751a42036788cc3d2548a,1139,FALSE,1935,796,
0efe392c109dfc03473e179e59161e54,148,FALSE,2206,2058,Dire
ae4c1720c0b92e1dd0faaa789d0740dc,1861,FALSE,2098,237,Dire
e9b9f4903993d31049e71a9d0e2796ce,1315,FALSE,2641,1326,Radiant
0b6636ccca2b632a7ac146a317d6eb26,1141,FALSE,2564,1423,Dire
c6c69c1f558bd1451b05d7ae84ae8e30,43,TRUE,1883,1840,
857623b1fce5bc900feebe3458c9a29e,694,FALSE,1826,1132,
c4bdb59880a2ae374b28dda5fcf0d65f,1630,FALSE,2489,859,Dire
1e7fee87c2436df625c413f905ae1c01,26,TRUE,2516,2490,
7b9025fd1560675b5789724caf94e45b,1462,FALSE,4214,2752,Dire
0134ba680679cf68f6fe9b49d0c4d7f3,151,TRUE,2183,2032,Radiant
60e413bd2554ff0dfac2aec0f3d842f1,843,TRUE,1739,896,
d88acea9ccece1b89a09d82ceb756653,1345,TRUE,2336,991,
d0af5c306db8ef06086069a9f9f59758,1934,FALSE,2294,360,
e9fa949aacd965fe422089678e818ffc,505,TRUE,2313,1808,Radiant
9d06995c75d2c3b21680ee2db8da942d,849,FALSE,2360,1511,Dire
850352d19dd657d9dedc1101bd00c05d,613,TRUE,1569,956,
1be48f9ba74bc1515a3ebad8b109c39d,485,FALSE,1159,674,
336304738dd0718b51f7fabc74b696c3,330,FALSE,2126,1796,
4b45ac301dad98018041aa734294456f,1934,FALSE,2757,823,Dire
0c1d99827e8a4c8626b168569b07e221,607,FALSE,2374,1767,Dire
08db6f03efecc35b29b12401be5b2d80,198,FALSE,1935,1737,Dire
30dbe3a944596666d04ebc303ae62df5,1062,TRUE,2250,1188,
10a012e527782bec07ec3702ff6d5984,219,TRUE,2002,1783,Radiant
909c9549f4e7e16b4815ad8af833884f,722,TRUE,1978,1256,Radiant
9672774cbd057b763a159d2422ae98cc,9,FALSE,1678,1669,Dire
9820c415a840677dd13c5805bee21237,2321,FALSE,2472,151,
ee0af9bfd4319db66aff90e3ff2650e4,567,FALSE,2623,2056,Dire
bd6de77bea09b9f830abae6283657c9e,2090,TRUE,2753,663,Radiant
975d0c64bc41dc634c14f27ec2d5b4eb,475,FALSE,1666,1191,Dire
55d81de3838e44fe499e594b7e162ce2,289,FALSE,3398,3109,Dire
604a21f18b90f1b096c37161b1317134,2518,FALSE,2979,461,Dire
fb3951656664732483ee1427b548a66b,1929,TRUE,2003,74,
b62deb4365cf7deab8a732e2567577d4,1224,FALSE,1795,571,Dire
406d5d425157cd43529c2a37691d58e8,223,FALSE,1949,1726,Dire
c95603e2c3790acf04bb9b678f0222eb,2988,FALSE,3510,522,
be4c7dd4173478d381be90dcc407ccb0,745,TRUE,2609,1864,Radiant
ab235a6ba01946c7b856accffbac69f2,1396,FALSE,1729,333,
cc02eb4014f27a3fa3dba59c047514fc,2311,FALSE,2539,228,
80235902a1b50b5d6e8ca43dafe3b8c5,1946,TRUE,2992,1046,Radiant
825e5712976b82614545f2f74fe265a0,239,TRUE,2114,1875,Radiant
dec9e6260f61f4dcd1876be2bf5e5fc4,208,TRUE,3746,3538,Radiant
018a737fdb6c6f4853cd1381ce977c1c,302,TRUE,2586,2284,
ddadea4c81aea5fa017971a93071f40a,1340,TRUE,2007,667,Radiant
ad9ce1c02c848654ade1c954deafe55f,641,TRUE,1450,809,Radiant
2ebf3cbcc32c8bca887382b9f1fe6cd1,1519,TRUE,2316,797,Radiant
c47c26f33c800be4e974e6148a2dab84,547,TRUE,2760,2213,Radiant
4de03c05a47af6c3ce8933c8fa65bd2c,378,TRUE,3433,3055,Radiant
62210b81afe88cbf9a489ef276bab9c8,184,TRUE,3357,3173,Dire
bccc7b91e0c781898cc33afae565ba6c,3288,FALSE,3647,359,
dfeb06ebda4a939ec5c59abfb8b28810,1253,TRUE,1831,578,Radiant
7094359949f7048dfae7b2c786ba8363,2288,TRUE,3204,916,Radiant
56480ae0807ac2c664d5807ff561921c,1331,FALSE,1789,458,
42a8cc327be7fe347cb88619ef83f89f,1882,TRUE,3051,1169,Radiant
5c956be7c9107277de42ffd725a16b71,2045,FALSE,2223,178,
ae8f5ad18be3201dd4bf23b2dc0b65d5,2821,FALSE,3497,676,
be7ec1c04f1e917ff7351fa0710c513a,1396,FALSE,2746,1350,Dire
ff1fce8600cc767607a7de5f90c53216,2002,FALSE,2188,186,Dire
c85ae9fb92a1ba143d1d72f7e6f60e99,385,TRUE,1613,1228,
6b6ca85b3a3e29c8b8c1db16eb5a4024,1011,FALSE,2518,1507,Dire
1b513a04b802aa4fc7449810ae0d3fbe,923,TRUE,2511,1588,Radiant
3edc865e0218fa6c3e14747808d4f5cb,1029,FALSE,2436,1407,Dire
881c9cc7177b133c82e7e507809d9b58,1649,TRUE,1931,282,
92e5d174c74a978c06d7aa25ecccf503,147,TRUE,2100,1953,Radiant
45b4e24e1d26684c47a4d02ea76f0110,1072,TRUE,2566,1494,Radiant
733a8fde04e4d7afc22be961c590ad0a,1421,TRUE,3513,2092,Radiant
caa19a9232b82aaff6a06764cff888d5,3113,TRUE,4346,1233,Radiant
2b226e064c81e550d2618c7b10d2f8b9,655,FALSE,1039,384,
2b78edb52c6b8e38c812fdb75de1e105,972,FALSE,1652,680,
c7b0399be3f57702ad12edd7b7d8819d,491,FALSE,2802,2311,Dire
5f12cdfa825db91f74e23769ec5bc935,1524,FALSE,1722,198,
ec817c3f315be7acf543b7c8613f07bf,2366,FALSE,2504,138,
54c18e80d99de60bccf1e01820011771,2973,FALSE,3072,99,
125c1ec3a8d8956b9bc2814e86ed5ef6,1715,FALSE,3491,1776,Radiant
6b9672357b15c3abdc7d573f154861b2,905,FALSE,2138,1233,Dire
6669a84dbff33dacc1cf91c7f5313517,1442,TRUE,3217,1775,Radiant
2299bfc2a5885a450d7c7c190dbf4529,1974,TRUE,2884,910,Radiant
32cf4ee7ac121e186d5d9d0249bd673e,2066,FALSE,2133,67,
d09ee16f393ac646935febf2c43ad692,488,TRUE,2775,2287,Radiant
96912dc17894f350cf10ad3755c53923,1182,TRUE,1766,584,Radiant
42b81b28604feac9fdc3f72b9450b4da,1261,TRUE,2332,1071,Dire
ecd04ee1d5a881147a7a2817f003c343,68,FALSE,2776,2708,
6df1c646a8f2654dd77b07a89a183402,375,FALSE,1318,943,Dire
9d26e89cbd32faf859ee5700f7253d02,1481,TRUE,2227,746,
5ba0d2db86383c2298079122dde091e4,1000,TRUE,2663,1663,Radiant
0c604963f515c9469bbd644be8e8adbc,10,TRUE,1992,1982,Radiant
3bc497f37708c51c8c62fb476e6f63a0,32,TRUE,1461,1429,
9f9d247a31a99fd78326a431667c136e,308,FALSE,2149,1841,
648097ab4830b3aaca9d5f84cc467db8,1213,FALSE,2338,1125,Dire
af2c83fe2426522f9e744713b6a61e61,1606,TRUE,2153,547,Radiant
72216be11cf5e9f4458cad1ae389b039,2360,FALSE,2441,81,
3ea9df1ef55edc529334a64004a65a65,277,TRUE,3126,2849,Radiant
a71446478fdd8a0a015900338ed9601a,1657,TRUE,2349,692,Radiant
b219a52cc7ace346cc74b2db89b81697,1865,FALSE,2519,654,
9219bc3d157d69063ee1bce4d6658204,2091,FALSE,2862,771,Dire
d7d215c774acdc73ae3fa37f4d10712a,752,TRUE,2367,1615,Radiant
4fcd8f2da1cf1b5111716fe9174efb26,1692,FALSE,2728,1036,Radiant
a83a437d8caa9c7e29ca3d59427ab93a,1387,TRUE,3095,1708,Radiant
dac73fe3507bd705270badd871410f6c,316,FALSE,2701,2385,Dire
0c5f9420ca69ad119de941c17f6f588a,1619,FALSE,2982,1363,Dire
5025076e190a4c60f6fdbe8a35de303e,763,TRUE,1088,325,
d7cb04970cd0414feca2fb6b57b53a66,1215,TRUE,1382,167,
f16cb62814c23ca06efbfc5aa12e2631,884,FALSE,2630,1746,
842ceabe49615484074e64d66a535d80,1197,FALSE,2551,1354,
f9fcfc542faef7993db4df0f67ea3a0a,1202,FALSE,2307,1105,Dire
adbe6945d1d7b6599e9ad90131e30f27,2411,TRUE,2727,316,
924b2c4b6225f422d587822dc49db6f7,504,TRUE,2819,2315,Radiant
bbc8bc04c438270c4b99680516b29ed0,1048,TRUE,1851,803,
69821bbc4ff105b6b57b1c08297cb28d,217,FALSE,3341,3124,Dire
b16e7e9a2cda27d497e8218462539517,157,TRUE,1937,1780,Radiant
c2af1d9ca65f5d496704285b169aa3fd,1403,TRUE,2992,1589,Dire
56cb497102c48f7270ee2165946172dc,1167,FALSE,3293,2126,Dire
df8a6259ece68355306c8d6928ca52b7,552,FALSE,3150,2598,Radiant
ce776993a19c3854a81e12408b7bce1f,1082,FALSE,3209,2127,Radiant
f51a4901b35156a67fad447c9352fb07,1405,TRUE,2822,1417,Radiant
520919d8fb4fa8cfb46c5bf31b5528da,493,TRUE,1037,544,Radiant
7aff8cc62fb5fe0aef14059ed780172e,59,TRUE,2004,1945,Radiant
b4406c5a9b0212b6863b05e1aefa72d6,1703,TRUE,1806,103,
39c92478f19ca63c4240ed1a77d4f58a,281,TRUE,2648,2367,Radiant
cb97f71f44c3c84441cc4866672c958d,2212,FALSE,2420,208,
4b953b17be1511e6a07ac3bc07d20cc9,1518,FALSE,1897,379,
b67d1573cd2968f6ba59d59f4262b7d3,84,TRUE,2180,2096,Dire
74962114cde6434722b71653b06a89db,2516,TRUE,3463,947,Radiant
3b4e64912d1df1c22d7353ccd2546a66,2388,FALSE,3319,931,Dire
151aed92c32cd15d7dbb9a668c0d8ed8,1497,TRUE,1675,178,
f57ed432d13d340fd962021d7bc9d2e6,1505,FALSE,2542,1037,
e76ece580d2aefd6a842fb1f24ab0ab6,1288,TRUE,1383,95,
a66fef70d674d176c9628f9c98fd35b8,85,FALSE,2821,2736,Radiant
06df8a4952514314bacb0d0fbf58589d,570,FALSE,1168,598,Dire
6586fa55eabb8bc802379a21807f9745,1745,TRUE,2265,520,Radiant
7f3ae5073436e388a1f6fa89dd515717,1085,TRUE,2063,978,Radiant
ec89449dcf909d6937572f2f3cfe3a8e,552,FALSE,2022,1470,Dire
314c8c745b4dabaea143400fe716c07e,2454,FALSE,3211,757,Dire
da3d9e11bd424d6ed1144a1a14dbb6e6,2783,FALSE,3009,226,Radiant
c6968376c364ef55149764f401cdd71f,855,TRUE,2026,1171,Radiant
29dea28339170a4a137374d2574f7adb,1917,FALSE,2643,726,Dire
8d136cf254d4c313ccc979fed7e4f318,3494,TRUE,3928,434,Radiant
dbccf850ffc729243d96261a8dddf4c4,228,TRUE,2400,2172,Radiant
3993ea59e1a37445129e326b470919d6,708,FALSE,1411,703,Radiant
76f94adbab130429f0bf11d359b17dba,212,FALSE,1672,1460,Dire
a576ec95adfc48b1b842b223cf8904c7,1693,FALSE,1831,138,
cfeb7eae096ce7e6ef2e5318f9d94961,481,FALSE,2326,1845,Dire
b98720fca1369b520ca68733ea5d3ab5,1854,FALSE,3310,1456,Dire
00707781427f8ef95549b33a63bc41ca,862,TRUE,2012,1150,Radiant
66e3f3266fe8a20e232c03e2b8ad5044,665,TRUE,2616,1951,Radiant
7f9f76dad91406c435dfd945a5e69c5b,1316,FALSE,2339,1023,Dire
477c3ef2f8b040dbcdf409ba5e431499,78,FALSE,1873,1795,
6d1e51dd5afcc051e01724fccd1578ce,1715,FALSE,1903,188,
91135d159785b9caebf88abad1bc41a5,2210,TRUE,2365,155,
9b8ed7898b459d3407acdcebd980af75,1149,TRUE,1427,278,Radiant
8e819c0297a72ffff520d9def51ad7ff,1586,TRUE,1742,156,
b8b444bf9e68bacfa6375adf3a54ed72,1242,FALSE,2530,1288,Dire
00e8ccdea5a35e7f7813cd35dc741de7,697,FALSE,1526,829,Dire
694676a7af17e88f6c0a9a64b82d7932,1533,TRUE,2179,646,
872569d405de03b8930112b6d8ae4725,1030,TRUE,2359,1329,Radiant
36414384f108a3031f39e197e4f4b135,27,FALSE,2125,2098,Radiant
bdd482e915ff2f9c369e82dc46be86bf,1189,FALSE,1871,682,Dire
abe7a705126b5f3731bf0cc14024b892,531,FALSE,2825,2294,Dire
b37a6f3553b97561e7c8858c2d50daf1,880,TRUE,3635,2755,Dire
89f861e98a5eb91e2250c6733ad3d732,956,TRUE,2550,1594,Radiant
d6a94a18462d2033d6446124780d7e42,561,TRUE,1629,1068,
3ba43b3569d7932dd44544af43d99b74,2792,FALSE,3742,950,Dire
bf5507ca217950e2d47ea8a23fa31481,1093,TRUE,2937,1844,Radiant
4b5033dbfc173082c4ba64ece5304b8c,1797,TRUE,2494,697,Dire
b0a2b99b66ca5ce07ac61f35921ecad3,1115,FALSE,1500,385,
11abeaf3ae52f8819ae7933d90966398,471,FALSE,2935,2464,Dire
60edac7f437c0edf89486b2fa6ac5e88,1029,FALSE,1804,775,Dire
ed29f8b9c939aaf8a2a9b119eac9b3e2,2110,FALSE,2415,305,
c1ab7be252aba1821cf3e49746d8c03e,2019,FALSE,2586,567,Dire
20596574d09e7e47cc2ddf2b1729e25c,1043,FALSE,3564,2521,Dire
9f5654e564649c7b5e31997baf9100a1,2731,FALSE,3089,358,
2d00318b625dbd3f6c19329ca6a7f61f,249,FALSE,1564,1315,Dire
f2e4278dbacb47c95613ab6d397a4950,871,FALSE,2957,2086,Dire
5328286e0c0eadaa814b8f006c4cceac,3431,FALSE,3571,140,
30e6b35c5b99679d3633afaab26dfaf7,1710,FALSE,3010,1300,Dire
8ee2b743195624fa5b17269ab4988124,232,TRUE,2100,1868,Radiant
64df07ff1b35fd86d0374c990d3c3823,936,TRUE,2106,1170,Radiant
33363d15cf7cedbe92ab9de52005fe01,445,TRUE,1314,869,
039b982a9f1a9309db93630b81d74e0c,451,FALSE,1261,810,
9598e8642aa7e71fa970e8ca55f6e8f8,687,FALSE,1491,804,
08ac97a664fb43faf072584d828c4d5f,291,FALSE,1943,1652,
bb02ddde943dee50de7a9feadf3bb2d4,577,TRUE,2103,1526,
1bd0e2e823170d12a4047c99d8d9be18,1016,TRUE,4243,3227,Radiant
0dc3771144d219f00886c3a65c603347,1135,TRUE,2767,1632,Radiant
4ba3c42817ca0072872c58fdb6e3037d,1859,FALSE,2966,1107,Dire
8cbb36117a183c8e92e7b4496942d498,1618,FALSE,2026,408,Dire
6f104491988d3fdde504e252b30c7172,457,FALSE,1196,739,Dire
0dcc83af1caf1bce1d3702f0f2ca5209,1086,FALSE,1232,146,
f59d1b5f764add349cc09456a5571859,679,TRUE,1639,960,Radiant
1f173cc51af28eb18847a417ce8917c1,2470,TRUE,2653,183,
62ef48385a73fb8c24032c9c93749f57,1861,TRUE,1971,110,
1f08416be650d3f66a2edefd77140fea,1982,FALSE,2565,583,Dire
b4da9450b3e120ff85c3cba217054f8f,1530,FALSE,2358,828,Dire
4b502c99e6c525e475c7037b05d8ad3e,2361,FALSE,4518,2157,Radiant
99b0e93ac4d192b40bbf0c3c40db1b0e,490,FALSE,2330,1840,Dire
784252a678823ec4eadb2e0a1ba8787b,511,FALSE,1979,1468,Dire
5e5d229b1867c64ec39d18f055efc474,1904,TRUE,2006,102,
84d59f5f0e440efc444bfba63aca11fa,229,TRUE,1974,1745,Dire
cdc4a7a20b9193733713abc89b9dcea5,2207,TRUE,2445,238,Radiant
d4853eae170dad200c522fab198dbc19,1407,FALSE,1917,510,
6a207504ad5fc525207a81d1516d281c,2903,TRUE,2947,44,
620c3bcbea2a20564124b1dcc3a44676,1050,FALSE,1894,844,Dire
092bdf0e25f111ada74e5749addedca5,635,FALSE,2493,1858,Dire
61db5df785e150d6500c77f19a831ef3,1129,FALSE,1193,64,
c07fae0ff5e8bc335a4591e27e9d89a7,1875,FALSE,2691,816,Dire
1266b60e5a7f48a6204b763232ea21da,848,TRUE,3804,2956,Dire
f3bf0ff5b2e0ad587031a12ed845c245,1535,TRUE,2303,768,Radiant
00ba0b60238aab9e50593beef509d48f,641,TRUE,1160,519,
5d9a59390c257ebd0a4ae0623aaa45bf,1843,FALSE,2007,164,Dire
22efae2993990ec70f1ad58bd0bb131b,1694,TRUE,2792,1098,Radiant
e2355ffc261a5ac1549613f98927d2f3,280,TRUE,1115,835,
cc4825eb4618d4421ac65a4bc81abb51,2173,TRUE,2266,93,
fff6df5c319b6c7b591be47a9fda299d,107,FALSE,1895,1788,
34191ce28d6d758e3304d8503a258d43,922,FALSE,1744,822,Dire
b6ed7dccffa9c11907d751a82e65b1de,467,TRUE,3213,2746,Radiant
67d7bfd9c12ab7adf7d8181f5bc7968b,1904,TRUE,2275,371,Radiant
5b34af43b9b79e0b99cd34a8b777e0c4,1442,TRUE,1748,306,Radiant
7e0bc8d9f3ad0c4569e46bb3bf64e2a1,1625,TRUE,1921,296,
8adf97f411ca98f17c848c6e239b4911,994,TRUE,4059,3065,Dire
228ccbe249349073027953ab468ea98e,44,TRUE,1371,1327,
5f3f4c1b1111a233228d889e2522c8e4,889,TRUE,2352,1463,Radiant
9b45ae98e16683778a30c5f933507cf9,623,FALSE,2803,2180,Dire
cb78b5faa60f0890f1070aec9b12b50b,407,TRUE,991,584,
5798f8a6c52b194e646eca0b3067d2a9,211,TRUE,1938,1727,Radiant
decec93b067649113e28fbac8435ef3e,2820,FALSE,4170,1350,Radiant
4c5826e4fbb0541657214786deb87950,551,TRUE,2001,1450,Radiant
b930fbfe62d4cb2cef0856272adf0771,1036,TRUE,1813,777,
f77f775ffcfa86b2e90f355bb682db47,145,TRUE,2014,1869,
77fe99f07ec9116d18872d4e6da0cb76,16,TRUE,2149,2133,Radiant
3c4def7fdfe740cd05471c8eb80a89f7,1352,FALSE,2185,833,Dire
8c5631ec87cf3b77c125a1fd960b7c51,202,TRUE,2211,2009,Radiant
7315a5d751a05be8a00b6a91d1c4c303,587,FALSE,3017,2430,Radiant
357f40f415ea79586a9d189232a4beb5,133,FALSE,1939,1806,Dire
4ba49c774beffd39d171cef04716062f,824,FALSE,2308,1484,Dire
c5cd7db0b5b90c321cae66df8c5a2ceb,166,TRUE,1639,1473,Radiant
e1709e1f4e50fa209251125fa0ac7f8a,904,TRUE,2696,1792,Radiant
9df04f0786f3dfd43f11002dc4cbd6d7,1831,FALSE,2305,474,
6a734109aa8e8393d6b613b1a296cad5,907,FALSE,2737,1830,Dire
ab53c7b394b19761bee05c2b28e5bfeb,878,TRUE,2627,1749,Dire
69a0a4b03b9baa66198fe4b3523e892a,1111,TRUE,1298,187,
f6581acf1d7ef147057fd1071d43678d,1241,TRUE,1566,325,Radiant
4d37f4b4bdab72d664e181eb48b72976,418,TRUE,1883,1465,
63fd03a7485c1d2797aa03efdcb494e4,1214,FALSE,2457,1243,Dire
809c4a6d22d51d48f11ae05a99071226,596,FALSE,1608,1012,Dire
9c8743a839ded2856f98e8f4bd89076f,2885,FALSE,4682,1797,Radiant
5af20763691773d743954c019ba93bc0,1194,FALSE,1975,781,Dire
e90eec75255cd6f9aea4c56cd25a10d9,1710,FALSE,2498,788,Dire
178f21e6a83e7b107dcb41fa27794e48,2098,FALSE,3169,1071,Dire
45d008f209505337a3ee28bb9f14472d,1715,TRUE,1960,245,Radiant
c71139797dcfdb5a3a30b40b92121973,1114,TRUE,1534,420,Dire
ff3d4c3348e1986907743721aa8e5238,64,TRUE,3828,3764,Radiant
8834b31fa949c9ab2be6b848a3aa2e22,2265,FALSE,3062,797,Radiant
4ef7cf91b6865035b07701841ed49411,328,TRUE,2120,1792,Dire
34c5cea5318a9cc09694a8d86405ed5b,1067,TRUE,2606,1539,Dire
c5e18aa835046340411d411721911b71,657,TRUE,1250,593,
50bbbe4b9ac6ceb9ea51112372a6951c,1773,TRUE,1944,171,
95e784df391dbe822992ff340b05fda2,653,FALSE,1932,1279,Dire
d90457052776ed00761c5f2f750ea1db,778,TRUE,2229,1451,Radiant
49bb1baa109a539882a70f55447ece02,576,TRUE,2489,1913,Radiant
d00bf85ac248e4dfa2355f678dec7a7c,845,TRUE,2445,1600,Dire
431e8a53d00ebae11928008ec1a57ad3,3,FALSE,1969,1966,Dire
44c320b2d69cce77a6c13ee3a6ee967d,2863,TRUE,2907,44,
d9eaef3885967f5f8edaf1848c99cd7b,606,TRUE,2295,1689,Dire
a6e157b1c65724799366e1e76a19219e,2529,FALSE,2632,103,
0e8e161e19119ca0454c9a86662482f4,353,TRUE,2155,1802,Radiant
d65aab824f19f8419c5392ae48ade148,1640,FALSE,2085,445,Dire
ed2774c162b1b3f008f54c7be0bf0c0c,1222,TRUE,1858,636,Dire
cfdf4d4ba45192da20a64a6bc495fdf0,349,TRUE,2166,1817,Radiant
bb5ed11f822fe7ae35d0c4758950c772,2310,TRUE,3563,1253,Dire
af0c6e5a1696ccdcc4b8e4b51e44a8c4,673,FALSE,1766,1093,
ec539d6e70a04cffe3e7c6cdb4a7b01b,946,FALSE,2092,1146,Dire
a1adb974d3c82db604cd9b0c81b718c2,614,FALSE,1537,923,Dire
d718e360a3d679a47a464f7c718046db,1879,FALSE,3357,1478,Radiant
8a95315dda60e3a4437d210861e05aaf,984,TRUE,2895,1911,Dire
10768be05b7836d40a29b1bdedc01634,1902,FALSE,2365,463,
295a57cb94c6664dbe901b4bb6acdec0,898,TRUE,2192,1294,
686b7b2b0738df5bb64ab468fa8b86ad,4119,TRUE,5432,1313,Radiant
abd4feb102462c719a29586d860fb1b7,841,FALSE,3201,2360,Dire
777b1b4b7a8f876a8f6ed21254d10558,1104,TRUE,1340,236,
16caf925a456ee07fbb6360816a81c01,528,TRUE,1666,1138,Radiant
cc29d7c82ced78bf403664d3ca8fff59,1910,FALSE,2129,219,
9b861ff117417482904ff90e9a2e8e4e,580,TRUE,1989,1409,Radiant
1a06a9c292ac5e24f450fbc280b373ae,1626,FALSE,2645,1019,Dire
47e25d11d3f12f636e84db5a708e0c3b,1866,TRUE,2266,400,
84c2c1079f2c08b39a2447024289ba22,1163,FALSE,3309,2146,Radiant
eec95c24f74c4b8259e2fca8b06ca452,435,FALSE,2734,2299,Radiant
8f46ad29a9cfaf544e294aba7350b6ec,246,TRUE,1583,1337,
72877da249dce2a6f9f2edf618ecea2a,1817,TRUE,2882,1065,Radiant
f1dfdc14b07c21c8e2884d156647df56,318,TRUE,1875,1557,Radiant
6ffa8384e90981f1d097aa286c3e8846,2519,TRUE,2760,241,
d16f2dd7bfd426d181882822c8a1e754,1067,TRUE,3132,2065,Radiant
ceb98544ed2981bcb512a81a3cafdb94,1699,FALSE,2208,509,Dire
5591b0f48b935727bba515ef606d56db,65,FALSE,2204,2139,Dire
62078296cc26fb97ef7e6d347451ef80,216,FALSE,2755,2539,Dire
30dcdc1b22210c5c24f47af318d1d5a9,199,FALSE,2719,2520,Radiant
27e976aefaa30404c7dcf75be5722831,1821,TRUE,2253,432,Radiant
e0a14756353289053cc7590cb8c1f7d0,268,FALSE,2602,2334,Dire
507044ec7702e0962869157ef3e961ee,397,FALSE,2461,2064,Dire
24fec8cb7d1692d0cf7f46c21502e683,340,TRUE,4117,3777,Radiant
14da77b33587720a0ad297c6d58474ef,1841,TRUE,1930,89,
130b874f25ce1ba8caab069e1bcadbaf,1398,FALSE,1860,462,Dire
926b66177f1ca5cb540b7433f1d13115,957,FALSE,2539,1582,Dire
e389d7959cb52c70c3b39f8a0003b3e0,1293,FALSE,2788,1495,Radiant
2701c9b9b38f50c89dae0bc1ff62408f,1287,FALSE,2672,1385,Dire
8bdd707e86464ee248623a77d49eb030,942,TRUE,3779,2837,Dire
2a880ba6b1c81536fc6f345f4ead24cf,1295,FALSE,1485,190,
f5a90b9807f03346b2a83cb490bc49ac,2057,TRUE,2172,115,
b9fa429dcd4787ab1adca07bf9c507f6,1522,TRUE,2085,563,
4cf7027a8ba18284f0a51e9b3ec08e4d,470,TRUE,1230,760,
b1506c73de1a0bdb466cef853ec0bd1c,236,FALSE,2089,1853,Dire
dfbde195326cf12dfe6509f41519003b,1081,TRUE,1720,639,
62ccb575abd3eb803e77fac2064be655,1645,FALSE,2374,729,Radiant
3e0acba7dc9f757452de0319936d13b0,1483,TRUE,2716,1233,Radiant
c81625e6107c15b10070bf6c6693eb1e,2004,FALSE,2659,655,Radiant
1a53b39a948601c564bcfa1ed74dadd8,10,FALSE,1900,1890,Dire
25f6ddcdc0382a60cceb650b68ca744d,2386,TRUE,3057,671,Dire
97490c7bdac8398f071929f1ca5ebae7,1143,TRUE,2996,1853,Radiant
aedfc19b8c977d168f74e7f87598189d,1784,FALSE,3439,1655,Dire
2d672db4fb3da934190ad5b9942de282,341,FALSE,1885,1544,Dire
b9393c23ed3c3302e8784ed4d1b24049,2037,FALSE,2480,443,
e5f8f1b431cbd276f4cfbe81a9710785,896,TRUE,1830,934,
f39572cee303135f0baaaed9852277bb,514,TRUE,1649,1135,
ffadfbd9f7b448c51eeb70be769ba0ee,1656,FALSE,1774,118,
1d09da19f9421e4cfdbc192235fa8758,170,TRUE,2326,2156,Radiant
df509ab6f3868b450b735a6f0e9713d6,728,FALSE,1868,1140,Dire
dd96d1e2b2460321e55d126c06fb50ce,172,FALSE,1498,1326,Dire
0c752a09fb6a5af682a88715498c3e6c,2392,FALSE,3020,628,Dire
9feb01559b41b294f880bdff2579c1f5,350,FALSE,2945,2595,Dire
61c2ffe53cf8bf0e5bbd70201c0dce87,1827,FALSE,1884,57,
74b4b4038b81d6b86e3583b9ea4637a3,37,TRUE,1869,1832,Radiant
3feb5f0503ed13be4d088d8a54e04e69,797,FALSE,3716,2919,Dire
4f9cf1b4155a4f080e4818a6bcce61fc,1483,TRUE,1879,396,Radiant
a9134e5d09f1308756dc9413288071b7,2270,FALSE,2994,724,Dire
6a9de922ff3ce96e4bccc9313d74f265,1509,FALSE,2979,1470,Radiant
0b8d71f5d24114129cb7196ba762098b,542,TRUE,1366,824,Radiant
ac357f465beedde02020f708c59527ab,376,TRUE,2250,1874,Radiant
9595632e3be70b60fc2ca8375c7c5bf6,2718,FALSE,2776,58,
9b746f490f168752ef8eefc5114ebdf0,2431,FALSE,2871,440,Dire
3941ea4fbec502fedb702d9c34e11c25,993,FALSE,2216,1223,Dire
f915813b5289bdb2e722859af33a0ca8,563,TRUE,1927,1364,
565f17d02a21748f568a4a8596ef4ecb,1715,TRUE,1838,123,
00a4bf84f59b6b03e0c741c456529c19,746,TRUE,1770,1024,Radiant
89c02d12cad455bd30c5de87bce38f88,1393,FALSE,2660,1267,Dire
d2b932aaf863d9c95365a1f87d428dff,419,TRUE,1667,1248,
7870b1a132aed389184d83bfabf92a11,499,FALSE,2295,1796,Dire
30fe835a90ef3b5e1355b406b46018bc,1153,FALSE,2537,1384,Radiant
11223c25ffbf1dc2e1175c9d97a51039,2755,FALSE,2795,40,
6847af7e7b0d82d3682ceeb361d7d525,275,TRUE,2379,2104,Radiant
d01764c14ea77a1d792223efb29e6b06,668,TRUE,1395,727,
fb4d769202c0059f19c13abab141abf8,2589,TRUE,3936,1347,Radiant
eee7dff560387d49a4768004d6c8fce3,2424,FALSE,3817,1393,Radiant
a9fc0e61de81e1896c50c68a9c4b35fc,1272,FALSE,2549,1277,Radiant
9939fe41cbd8e04e350955e0e43346a5,676,FALSE,1485,809,Dire
df0000bb0d3084cadeb25b7717181702,2583,TRUE,2896,313,Radiant
bea92b6698efcac8ab8e880b123edb19,965,TRUE,2098,1133,Radiant
c6d921ab632350880b88d9fd6f7acec8,1372,TRUE,1614,242,
4558b463b77ae652f10b4561d78c6c62,1012,FALSE,1905,893,
c394d89414c20108c3bc5e8f0312aedf,110,TRUE,1780,1670,Radiant
379657f3363404eafc679c2d41c89011,1926,FALSE,1979,53,
ee71761d8816737708c63f42d0a29e98,2389,TRUE,4165,1776,Dire
9f360bf6c7e6c736453d0928bb31713b,905,FALSE,2586,1681,
47b6f5f194cc9912ff42233162c902e4,69,TRUE,2893,2824,Radiant
9b67b8630bc1f0cff9b668363d65b3ed,112,TRUE,2636,2524,Dire
4f54207892d51b0ec54c7dc5812747b6,367,FALSE,3713,3346,Radiant
b807d0c1d58a5d8f9d09f42d1fefefe9,1963,TRUE,3064,1101,Radiant
997090d5b19089eaefa82a53f179e61b,1665,FALSE,2509,844,Dire
4973c00625e4a4732c1aea635d50e223,540,TRUE,2307,1767,Radiant
5eb52915d5d3c8226c1ea4d6d1161ba5,922,TRUE,1638,716,Radiant
f9093d0195cea0e358a82fb0716ee21c,2600,FALSE,2805,205,
69c18ecd595c682c6c69fb13580fa343,160,FALSE,1821,1661,Dire
bd17971d66004bc56e6f432eff526d65,1257,FALSE,1698,441,
08f09bedcda2dd443aed4f04fded9b23,969,FALSE,1401,432,
fc09ab015283a2dbb2f24d4b7c578d24,841,TRUE,2094,1253,
c82968ac9413bb9ac1ddb2365d68bb71,1505,TRUE,2394,889,Radiant
6c6427042f462bcdcad4ab00275389b7,215,TRUE,2105,1890,Radiant
31d7390fb6376b87d16ea18bc8c36b4a,1400,TRUE,2008,608,Radiant
43279518e04929a98fc1b05defcf18b3,553,TRUE,2562,2009,Radiant
35c9cb576fd43d2465576d385a0bccca,2209,TRUE,3115,906,Dire
2bf9c51058d9368f0f92c8767803ed1b,869,TRUE,2832,1963,Radiant
073b6f1209fa498759c60de50e302746,40,TRUE,1383,1343,Radiant
166a5ce6b9bc7ca434a052b8eb71bb11,1862,FALSE,2018,156,
487de83b34bcbe6cd7c9efa987675d06,1131,TRUE,2406,1275,Dire
eded223caef5a87f1efe27f45f18cdd5,2357,TRUE,2451,94,Radiant
faab01d316326a5651d7058736c758be,545,TRUE,2114,1569,Radiant
3e2b18cdee41e889f9359aad37538c6e,873,TRUE,1819,946,Radiant
e91e8c5a36d161383e3cd600b975f6b2,1442,TRUE,1575,133,
855b9122c3fcb484aa7dafbbc5f8462b,761,TRUE,3270,2509,Radiant
f70d7369e969b636ab9576f2677dcb42,46,FALSE,1274,1228,Dire
036b235abd5210a67776ae66604c2d8c,2041,TRUE,2961,920,
e873564615791b980e0835b30ffe751f,585,FALSE,3124,2539,Radiant
babf2965554cb554d7544f63e1d70d28,433,FALSE,1885,1452,Dire
1304301cc96bf22c97eb570bfb99050d,891,TRUE,1585,694,
4c2193e453af8301979816ab33a51f68,2637,TRUE,3209,572,Radiant
66d43f2cb59a035d2294bdddfdc9bc1b,2030,FALSE,2423,393,
784001a0479c2111611aee344787ea73,621,FALSE,1693,1072,
13c68cc2c881b2f7a3343686da5439fa,78,FALSE,2495,2417,Dire
8e1f9ff55b6871faf34fbb7cfc14ad43,1398,TRUE,1664,266,
76a32946e08ef540caf65ebd8539ec06,581,TRUE,2553,1972,Radiant
63cd87a7f8a70c1a9aa82f971e6bc49b,948,FALSE,1723,775,
485d7e49a5e53a1a1f70a898817f63e3,1412,TRUE,1474,62,
37c0bf136ab285463d26aee839f2967f,989,FALSE,2607,1618,Radiant
248e3aaad13ec8521331942ed2a45f98,2328,FALSE,3425,1097,Dire
68397d03e9d89139edfc350ae9633065,2241,FALSE,2667,426,Dire
09e911db230fe1726b96bf99becf7a9d,221,TRUE,1806,1585,
bed1730fd7c3b0b9c8b518bb881cf141,2199,FALSE,2869,670,Radiant
25bffd8e42583d44dc48029992516f57,1584,FALSE,2479,895,
9b8c0d184280fc0a818ae4880e668b71,1600,TRUE,2896,1296,Dire
619c8a62e906649a49a92aceff97ed49,1119,TRUE,3075,1956,Radiant
ef27e8faf254011280b1e1a8aae578ef,2373,FALSE,3144,771,Radiant
1d2e4c8be7b445e16464a740e3ccfe4c,907,FALSE,2493,1586,
c633718afe9133f39f8bc4f209aad757,786,TRUE,2176,1390,
03e5ffbefce01742ea06940ed41b942d,1365,TRUE,2505,1140,Radiant
94e94ef5680c606aeb4d87aa9932205c,728,FALSE,3106,2378,Radiant
c508f72a3dac0d60d8ea15bf37dbbd44,856,TRUE,2215,1359,Radiant
10e6d8f3c1e6cad915935b886b4676f2,422,FALSE,3464,3042,Dire
b2d4f9dd8eeac83e3a37ec8bca927052,117,FALSE,1291,1174,
272e4f602cecc4cdede5c6259698355b,1882,FALSE,3199,1317,Dire
dbdc35266985950996d22c53dd0f65a8,1833,FALSE,2047,214,
e820be39db98294a9d5a7f631a2d1c2c,1044,TRUE,1818,774,Dire
3ea278ce8738d8cea2e5fda17b0bb891,3204,FALSE,5055,1851,Dire
5ed9b4604f16acdbfda75c28226a6b4b,1431,TRUE,1788,357,
00184d97d4748d901c668ee873296d4d,3035,TRUE,3965,930,Radiant
4c0fccfeae5dc2cf9d13edd73fb1c990,268,FALSE,3149,2881,Dire
29fda660768f2af397ad858d51ee46c7,1056,TRUE,2503,1447,Radiant
855c69fd3d61655ccf35d70752e1573d,1924,FALSE,3039,1115,
fb202d81b9c56cbc32905a62b47e55e3,747,FALSE,1348,601,Dire
bb30c841e0532e88b1ed0fe962a16eb6,1179,TRUE,1809,630,
e934bc9a05c9898a85c82d3507afd4e6,134,TRUE,1183,1049,
5a202278d4cc1df0f5527bb6160fe084,1235,FALSE,2444,1209,Dire
91a0c667b58c72e08d85bfb9911aede2,646,FALSE,2191,1545,Radiant
961e518cac585d96b3720eabf8ef4ccc,445,FALSE,1806,1361,
703b54316fc05c8ec0658d2438ed5644,1171,TRUE,1906,735,Radiant
80676fca708c0b8a12de4f0e2fabb39d,1098,TRUE,1799,701,Radiant
3ba67c3d31b1154eb908817549576990,33,FALSE,2283,2250,Radiant
47677a5c8eb0874d1260c91b9cbdd9b3,1033,TRUE,2615,1582,Radiant
16694b57b4d93b88c7f2d2cf01bd8fe9,949,TRUE,1538,589,
eadc7090c07c49622bab1510d83aeb65,2394,FALSE,2666,272,
34f764d6deb20455f0f68c19a6f8fbcc,1104,TRUE,2989,1885,Radiant
469b273dccde79cbfbe9cbe1c7b9dccc,520,TRUE,2198,1678,Radiant
71c82823cd7443b34fb54f3792d4a7a7,801,FALSE,1772,971,Dire
a888e9ee751a0f1902ab188436a5140c,2353,FALSE,2614,261,
e897ea1e07cee1161e10f343508a180a,2499,TRUE,2553,54,
894d9db6733c3ac30cde3a9d69bec6fc,1475,FALSE,2095,620,
9d4569cc63c175a22c8906561b79b0df,1227,FALSE,1265,38,
3674fc83265006b5e5572cef1f14ff1e,997,TRUE,1509,512,Radiant
ca6cdd6d4c366a482b387c8ede076fe8,1788,FALSE,1912,124,
610eb42d704819409dc45ccd7e1a7e0b,165,FALSE,1784,1619,
aaadb19dd5c13021402e0dbe85b70e22,353,FALSE,2585,2232,
539ac478f36fccce6479412a30363e56,1480,TRUE,2009,529,
5e89bfc5a603d4346e15c05211ad2607,293,FALSE,2995,2702,Dire
fdf3f3f7143e72d2525d8c5ac6ad05aa,2523,TRUE,3461,938,Radiant
f539d04e949f549b3f6f4c39bb1360d1,1424,FALSE,2068,644,
f485d17397bb51092643e38cf75a5637,3136,TRUE,3302,166,Radiant
8a88ebbaead3eb8348e9f331de497b79,584,FALSE,1257,673,
3c0b9749442a44a760657f1d42c2c80b,1806,TRUE,3144,1338,Dire
bd05c229570ef2864184ed4ff2fae8e4,2016,FALSE,3495,1479,Dire
eb857081a02213da48774872a4f91f19,34,TRUE,2213,2179,Radiant
9d6c084acae01621f52ec26276a3505c,3028,TRUE,3539,511,Radiant
6a30fa3a322edaf279046d0ab02a1a7f,1703,TRUE,3509,1806,Dire
229eba8a4a035f8d352fa587fdf8fcbb,646,FALSE,2128,1482,Dire
6c43b14f5882277efe064a8791e053cc,618,FALSE,1811,1193,Dire
96a732f66af27504dfde3213674b4ec0,1716,TRUE,1976,260,
be8c15ca534c17367372f1e90d0d1a18,1729,TRUE,2244,515,
f8146540e3988d5596dea5c76e80b6c6,3335,FALSE,3756,421,Dire
19e031a98d0bdd3aa5d9a40383d39edf,587,TRUE,2139,1552,Radiant
179022cafdfc40f2f3c0196c3c6740cb,1413,TRUE,1563,150,
b84ae33f4d451734d9075c6eed8e9e30,391,FALSE,2114,1723,Radiant
bf55f1e27147f3ac124fcbca5dbca122,659,FALSE,1730,1071,Dire
199f9dcac9c37734eca07a40a95364c5,294,TRUE,2463,2169,Radiant
d3c2837cebb2b835c68ece51a51729b7,783,FALSE,2431,1648,Dire
b8630c1c73be08fbe6629cd545b90003,1425,TRUE,1883,458,Radiant
9230a3c914b074426fc0c6a09f13be92,3549,FALSE,4383,834,Radiant
ad715746ca5080d39f28fbd29ae9618e,1108,FALSE,1723,615,Dire
ab209da28d7a2d309b2642cfd166b697,1992,FALSE,2437,445,
dc43a1fa30c71ce48b1da14ff5a7bab4,1322,TRUE,1410,88,
6b1d1526282a37be15a78c7e7c40fd26,492,FALSE,1876,1384,Dire
7d2a3d71cb1ae91b0f2370007f946aee,574,FALSE,2043,1469,Dire
70ec37b596fa17dd58d631d927565837,747,TRUE,2839,2092,Radiant
3f2420b55816f69b9d69fb055f09d8f5,965,FALSE,2023,1058,Radiant
c83d6c38468b7bda85e4285aafb170a4,837,FALSE,1526,689,
b4f610ebd01eeb592c1ce2685e6794d2,538,TRUE,1927,1389,
0d195ef344f99cbba162b22780814a56,1486,TRUE,3873,2387,Radiant
9db679d066550e264eb5741969999cf8,1651,TRUE,3226,1575,Radiant
76df10aa3ca2b84c142c0e2f0e86502e,20,TRUE,2479,2459,Radiant
f317d87167d3fad0c226f017aef749a2,1976,FALSE,2454,478,Dire
afcfba96cdccc5b0a9a23230c0a337fb,738,FALSE,1940,1202,
c0a914bf58e4c7d7aa7d806666ada0b0,339,TRUE,2437,2098,Radiant
affe8b6dbd5c5f03cd706f0bf8fb3855,2350,TRUE,2725,375,
3a8e9c8dc3edda02080b2cff60fd8b55,1001,FALSE,2872,1871,Dire
698fe3dda8242b2f07e15bea817ed497,460,FALSE,2512,2052,Radiant
3ea9fe1330f589fd736f68feb85fa910,1262,FALSE,1866,604,Dire
8e14c71830a68067f595f38dee6babfd,2191,FALSE,2526,335,
3af9b99fc58d8a3138f1bfbf9f72a287,1088,TRUE,2623,1535,Radiant
65fb7e3af0445437221884b65a3dda6b,2583,TRUE,3109,526,
149425200c023ba254ebb360c8ca43c4,889,TRUE,2309,1420,Dire
3e1394aaed9c5f69593189017b619a1d,496,TRUE,2298,1802,Radiant
06fea046d936f04d7a57b2b82d21a6ab,1242,FALSE,2329,1087,Dire
0a73ef9d4d7606b48f57318b2f6b5e59,1841,FALSE,2387,546,Dire
6508a08ad504956d4e564955cbd9699e,1848,TRUE,2486,638,Dire
ae3493cd0b9b779c931d618f8cc3c412,1551,TRUE,1986,435,Radiant
4f95e7835d79f2546759be3083c76a5e,813,FALSE,3329,2516,
682def5541e8e1188c054343ea0953d3,189,TRUE,2493,2304,Radiant
1803aafa0350e5313c63e0f3c2d8bf28,536,FALSE,3097,2561,Dire
9cf50ce41d58490c95ae61041a725b2a,2386,FALSE,3036,650,
be92d8c940acb066b6fb3d605f6127ec,1704,TRUE,2286,582,
f7ce9c1c4f0f96a381b558c7f31971a3,152,FALSE,1107,955,
0e8b09733f73c048002e0045c5c09eaa,3304,TRUE,4302,998,Radiant
73561315328cecb9662a30b22df665bb,506,TRUE,2303,1797,Dire
590df5abf9483b43ff8bad4d561700d2,365,TRUE,2095,1730,
14aaa934dad0af7c6ab2625b2bc95a13,532,TRUE,905,373,
99ae62563c478c59cb562294f2594cfc,1224,FALSE,2844,1620,Radiant
60e393b6d8da90669dfcc247c700a6b2,961,TRUE,2233,1272,Radiant
0e2ac6260bdb5aac0b7baadb0783e5c9,887,FALSE,3092,2205,Dire
b150e4c20b4ed59891c52abad38446ca,1788,TRUE,2357,569,
d962a9667d32aaeb20ddfbcf8bb078e7,591,TRUE,1895,1304,Radiant
0a49886d368e35aa8f8f0834d3627edc,140,TRUE,1238,1098,
42416637a4d5e99287f8d3a014ad96fc,596,FALSE,2902,2306,Radiant
c3a17ed18bd0cd7689f91f30ea5a5e84,1246,TRUE,2070,824,
3eb77dda2e7c10760d4ff5bbfd4f098f,74,TRUE,1781,1707,Dire
f4deb1a061e06775752594a1a47e29a7,2043,TRUE,2099,56,
1d1fa06d33c3401d6e3208a3e66a20ea,932,FALSE,2723,1791,Radiant
6c9ae96e801e78fe89224a8ce9137a77,1771,FALSE,2646,875,Dire
3313fa297b75a40a38e6074b753e0ac2,555,FALSE,3569,3014,
069a7131c08ab66d9f8990448155a076,1640,FALSE,2099,459,
cdbf50c94a82d425670af491a142d207,1000,TRUE,3831,2831,Dire
408bd7c2079c6f1ca73a4ce19d48f3ca,2273,FALSE,2571,298,Dire
7cdd1cfcca9b4c968369c67971c08f7d,1737,TRUE,2856,1119,Radiant
6a93eee21a3450c15744b96610673c56,112,FALSE,1895,1783,Dire
e684f5e064ae62716185ae0332b1ebcb,2229,FALSE,2812,583,Dire
8b8c27f46a92911993f21e1148e1048a,1673,FALSE,2172,499,Dire
c87bc6869639f9f18e7e9fc9b7235002,411,TRUE,2707,2296,Dire
3df96ce80c757e1e49a58e6fe800b876,1216,TRUE,2440,1224,Radiant
a6cfc06fb7e267c1a43fd07c9d2a74f3,1204,TRUE,2614,1410,Dire
27b9e44c69c23703c7d4121030522781,3022,FALSE,3446,424,Dire
ace57e07b03e5aa11c5cd4ae83c8f31c,2313,FALSE,2612,299,
707982d7f38f3945a3f06cda4d528f79,966,FALSE,1933,967,
31b4b5e2f8d823911d97151e414647f6,282,TRUE,1332,1050,
e69be69affca57eedcb63833a3a1f8a3,1098,FALSE,2250,1152,Dire
f03addafeaea5b379975e79cb0cbbb64,243,TRUE,2449,2206,Radiant
02c35789d8474452fe07fcbe61e128cc,153,TRUE,1810,1657,Radiant
3018282b55c1a2742bf7a9b6927939be,447,FALSE,2509,2062,Dire
e73efcded921f4267765fad20eacf1a5,547,FALSE,1266,719,Dire
67b9e08cfcd5c117fdb9dfdc994b4620,873,FALSE,1829,956,Dire
e42f7fc19faf6acdd2c19d20c3bec5da,1086,TRUE,1248,162,Radiant
09edad7d84c614a55c553b0e2ddbc57c,2752,FALSE,2926,174,
4c1372e23b8f74727eca6bb14883eb9e,1015,TRUE,1865,850,
73bd8a5859681e20c1f89910b3dcc2e9,1693,FALSE,3317,1624,Radiant
94613a2c595f30b074e2253b204bc1b3,1848,TRUE,3474,1626,Dire
00e163a7f515c783325582b020232a7d,2,TRUE,2187,2185,
666ead29feab4a1c028af45687a4ab49,2082,TRUE,3173,1091,Dire
aa9830cc07995c4083254d081bcf4715,1293,TRUE,2893,1600,Radiant
e50ae020b745bbc1c19db30cba1f97d0,1470,TRUE,1561,91,
e6a5a8c89d95b633fb68b55593998067,23,FALSE,1175,1152,
bd3676275d112876c0db078124734d30,501,TRUE,1842,1341,Radiant
cb9205f3f5d87293afa6058bd041f053,1054,TRUE,1591,537,
482e585d8dd025d04880ed399f033b2d,2218,FALSE,3073,855,Dire
d7466e45678b7d8d8cc73dcc5ce72e17,1552,FALSE,1958,406,Dire
c657acf34346e41e65536241a090b4e7,1441,FALSE,1945,504,
363ef3c9443b5e6c8a18ba3c7b929dd3,2446,TRUE,2634,188,
001485875d89a24c2eff87d16ec3678c,1958,TRUE,2182,224,Radiant
29ffe788ac6c93ef1cdd492d52c04287,1786,TRUE,3124,1338,Dire
32e3b02b8c52d3c2d1c0702532d210bc,1044,TRUE,2147,1103,Radiant
2246508768855293c1d1e13b2b96c76b,834,TRUE,1124,290,Radiant
169be520cf526082dcfc1fd34cb953e0,1403,FALSE,1577,174,
c6594f66c780b00fcaaa72d0b2aa4e7b,816,FALSE,1665,849,
5b8662123c4596795a7fc13ce3e48ae3,973,TRUE,1564,591,
48209f50b17673ed574e5b58dfbd8ba9,802,TRUE,1657,855,Radiant
b9bac54ab0394e1a859524734d61df1c,2603,FALSE,2776,173,Dire
bb397f861359a1caf2487fdf25371e85,1075,TRUE,1902,827,Radiant
74306e86524088d82d4a2c2c8c9c38eb,1381,TRUE,1732,351,
19c98abd01050602d08af92244cf68d1,841,TRUE,2523,1682,Radiant
8e467b81d10357ac1617d29fb73d7769,200,TRUE,2088,1888,
03d249a7380de51375bac41ecaadbbd7,751,TRUE,1738,987,
16a2b834f8d2e966770fc11c1b2a32c0,2860,TRUE,4858,1998,Radiant
4733a8d61aaf9d37a8f5951ca63352ff,1634,FALSE,3163,1529,Radiant
1fe277b0c4446ac7a36d0f0aeeecb433,593,TRUE,1910,1317,Radiant
3839f4d3fb465b13fa63e73feabb329e,1749,TRUE,2011,262,
5b1fef110da064f04b9efbc81f7cefd0,225,TRUE,2456,2231,
1b0170f98cf78176c43410e2d7952275,113,FALSE,2431,2318,Dire
996164a5621df4656d560e2beeb91220,1438,FALSE,4021,2583,Radiant
f53a3be96ebac149aa68e8d2a16a78f0,1893,TRUE,1929,36,
2f30875f8428cc81c0b360e8652d1020,1712,TRUE,2778,1066,Radiant
a9d6db546ba035aeb254ac36e236d467,1448,TRUE,2744,1296,Dire
20676ddabef56ad32922004800c6e690,1119,TRUE,1948,829,Radiant
1c62faa5b2d8f20422ef37219f982a2c,1008,FALSE,2169,1161,Dire
acbf5a414015aa6581b385fca8932fd1,1038,FALSE,1843,805,Dire
45ecaeb90455de3da7955d2d4b9d6da3,1162,TRUE,1483,321,
6ae5eb990886e8d596630355c98b9143,153,TRUE,2223,2070,Radiant
23eeac1243c316c74e47dbe6f73ba29a,972,TRUE,3991,3019,Dire
9baddcc3e83459a1cefae678c60c0a63,790,FALSE,1758,968,
e001d220e1a2dd2495b5c71ac328a3f2,948,FALSE,3584,2636,Dire
8e7bd5f7f250512d7009b35bd859c5a7,2218,FALSE,2269,51,
2795373522a741372f43919c7d348dc3,1935,FALSE,1976,41,
fc16cfee379314bfbf5c36e18f3f4343,2539,FALSE,2637,98,
7e798638044b680c5fbbaca6f87c61a6,1760,TRUE,1938,178,
bc1d8abb320d2cda808d937644ae3ef3,2240,TRUE,3511,1271,Dire
e3713ae6f494640f2dfe20098a2a868d,1039,FALSE,2230,1191,Radiant
8f07a1f90e3826805b6519bf4a61eb19,1503,FALSE,2138,635,Dire
e03418b955772d4d538e9a16fc929aac,666,FALSE,3386,2720,Radiant
dc4112c5869e30ea68a7ea522a3c7ca5,671,TRUE,3445,2774,Dire
01d35c673f7cf84c3cfc4acfef240def,1736,TRUE,2341,605,Radiant
c2ce63bf776d11340d10a4a3cf3bb7ac,1204,FALSE,2025,821,Dire
e53363c4f6d7aacfa7d9f0058dc8b983,2752,FALSE,2842,90,
ca5d988907f14155f0cf830e622326e7,1973,TRUE,2496,523,
5b4396e5861e9b2aaed9a358e000f0ab,911,FALSE,1939,1028,Dire
b10d99bb0a19d7f1c71465d83bbc2d1e,689,TRUE,3245,2556,Radiant
062be796b22b0d205eb35b7ee4bbb5a4,2328,FALSE,2491,163,
09b90c12ab14cfa52c95c987b0bf560e,1700,FALSE,1734,34,
b168302d6ecb8c110c950a1632998f5a,1527,FALSE,2545,1018,Dire
2981a9b01c4b3ca8c418889923089331,279,FALSE,1889,1610,Radiant
fdd064800dddc2a610f1a3c2a72dd487,297,FALSE,1961,1664,
e84bc557c99e3e1f3d3da68b896ff72e,174,TRUE,3673,3499,Dire
4318f00729433a7ffb8f7e4a9629a5ea,2075,TRUE,3517,1442,Radiant
3a60d28e1e76fb3c6fabb700b2d12a5d,1001,TRUE,1496,495,
ab44e493e639be14c0c6de4336c3b020,1341,TRUE,1696,355,
6e72345046451de5bf5d41534116ec24,291,TRUE,1611,1320,Radiant
cb378ca304ccb982742648d4b0342baf,406,FALSE,2495,2089,Dire
11fa87f437b0609ecd971ff41eb5c173,230,FALSE,2174,1944,Radiant
dfe24a3d9bd1aac4a123aaed40ffb0b5,1209,TRUE,2599,1390,
c357461781348b199433b72175b52bac,1279,FALSE,3282,2003,Dire
7a1bd067b3411f3f552f8e268ced1049,1724,TRUE,1761,37,
39a676bd4fd4753baeeccf5d18dee1ce,2576,TRUE,2804,228,
587a5f3e572767714b8f677a4ab409aa,1280,TRUE,2877,1597,Radiant
6853fac462a2affa1b8deed5a374209d,1895,TRUE,2216,321,
b64f76d7ee3bc07ae85f92bd8260dbdc,206,TRUE,2215,2009,Radiant
f860ec277b0950876a94bc7eaa0c9e69,727,FALSE,2786,2059,Dire
d9e1b3e5882c728fd975330889db992c,26,TRUE,2128,2102,
e82fe49452f3db83aab4fe33e71b05cc,647,TRUE,2049,1402,Radiant
535114c8cbea55b3bdf45e36c3802363,1507,FALSE,2687,1180,Dire
98c9c4a1060112c80abd6a9fdbf37591,848,FALSE,2293,1445,
d88ee96ae6c83791f35a2c11ed468d4d,1888,FALSE,2154,266,
886cb16d3d40efcf83e6a52b3e6b8606,1667,TRUE,2703,1036,Dire
a6016782a5aaa74449c861342c21a8e8,1290,TRUE,2031,741,Radiant
762354544be5f996277219cf1bc8b3a9,363,TRUE,1095,732,
846becee884b6c4eb7a24b9d8cf7775a,206,TRUE,1869,1663,Radiant
25d0cb1e48f1b53a8f444785217729c9,558,TRUE,2574,2016,Dire
8fe51cffcf7bdd755e1e8e95c13276cb,453,FALSE,2183,1730,Dire
d8fc74147055e89fee603fcd480bf669,476,TRUE,2434,1958,Dire
60fc31267641f475db3a49dd81325d80,1465,FALSE,2242,777,Dire
77511b19867abe6e17f0e564d9cfea39,1772,FALSE,2278,506,
20d027f7724f7d07cf4b45f69faf4441,457,FALSE,1248,791,
7ef4d6d61e5ee5ffbaf086b55255b932,1429,TRUE,1671,242,
68c851b21a8f7b5abe6ffb4d6d5576a1,389,TRUE,1219,830,Radiant
9a07ea7f5c542325bfe4681aa057607d,973,FALSE,2329,1356,Dire
415759a66f40b11fd362af1c7239a5d2,1987,FALSE,2491,504,
fb1208b4c86f70a1551e14beea73d0b1,1588,TRUE,1790,202,
00b9844e956f01c351bedd88ed53e217,455,FALSE,2952,2497,Radiant
ae4ba80ce577dc0c0b941eb72dda5570,641,TRUE,2375,1734,Radiant
bb134ab000e7bbd24a80c50cde8c13ce,2481,TRUE,3260,779,Dire
0517b4527de4cffce2a4af762d949d9e,2063,FALSE,4295,2232,Radiant
676bceec33f988a9042461a0d419bd2c,1646,FALSE,2288,642,Dire
74ff408c714bf7b7b39311345afdde72,192,TRUE,2463,2271,Dire
9ee129296ee8c8607f2341de9d60a4f5,2893,TRUE,3228,335,Radiant
79ff6d83a204ae85d83de520168f653a,1699,FALSE,2795,1096,Dire
2eb0d5ff2a1b114364b4ee1f58b99070,735,TRUE,2017,1282,Radiant
75add27da79276c67aa9426e49d51690,299,TRUE,923,624,
066d58babcbfb6ac09a4437be6a4955f,1826,FALSE,2705,879,Dire
60ef3ed64f091615d8cf5f5a5baad460,1974,TRUE,2922,948,Radiant
e1c1c5b316ad4489e68f4ddf6fc5c52f,1364,TRUE,2430,1066,Radiant
b7506f1dbcdb693bbaa12116eca21691,2709,FALSE,2845,136,
20217441576f187e26fe2d1ed3119ac0,2485,FALSE,2899,414,
2bcd517a8c0a94746f0a10f59a11eb3e,2329,TRUE,3626,1297,Radiant
2d70e974ca1e15c4a28cbbbd6a42fe5f,58,FALSE,2239,2181,
fe1358ca283b5fd58054e3241a3cdd24,121,TRUE,3163,3042,Radiant
beb5181969423d0c8d559f22a7e64430,364,TRUE,2517,2153,Radiant
536afd80cb5ecdd7653b305e6eb7f310,2070,TRUE,2563,493,Radiant
75067aaccc3050af1742c58e2f3c5660,1767,TRUE,2623,856,Radiant
5c5a996087df0405b25aeb41de2cf266,88,TRUE,1575,1487,
c9fb06e89079c4272e3eeacd66013441,2616,TRUE,2763,147,
cd20b79a329cfdd98388dd7dcae9fe3b,1327,TRUE,3472,2145,Dire
43a484099279ac4c861579b4ee1eb2bf,211,FALSE,2654,2443,Dire
a66067c18e8356a64d6e86de2c2432dd,1849,FALSE,2254,405,Dire
f707af63450fb77267d9ee9d9a1d05a5,425,FALSE,1195,770,
2be52f84292873ec9cc169ab4ed75aa6,1288,TRUE,2615,1327,
a3187bfaf56d0391bc5f7a87f63dbefd,1624,TRUE,2006,382,
4685e260d28ba7cbbef3a74e4da83704,1101,FALSE,1695,594,
bffddd5715d302453d978875ece4d4f5,1462,FALSE,2286,824,Dire
935881b466ca2653d7e547b15da3c06b,938,TRUE,1000,62,
2e6eb4d4c2979f5d91cfd195ebfabaf2,868,FALSE,1461,593,
60c65f56cb894e45f7778adb2ed6127d,247,FALSE,1898,1651,
9d323b40147499c44e08c2bf43b526b5,245,FALSE,1260,1015,Dire
7812dac4ca258eff792fe0b60e1b8a66,1458,FALSE,1918,460,Dire
c8b59ed4e8438f6dcc65ecacf3047b05,626,TRUE,2200,1574,Radiant
e9087fb457796598c321d315580e93af,624,FALSE,2228,1604,
1a57967e87024bb010b0de9f760243fc,1338,FALSE,2200,862,Dire
5bae0e119d06953b0323942585cbe218,434,TRUE,2494,2060,Radiant
075587e3ad5699ade9f3da43d6d14bf7,268,FALSE,1972,1704,Dire
2d95d3833264cdaa4fefc7052ab2f1ae,3149,FALSE,4121,972,Dire
87e65fbc5f99a48ae70c100c7e469b51,779,FALSE,1552,773,Dire
3acb7082c7b291becdc807b6a0d31ee1,343,TRUE,1697,1354,
e37c3933b833a5d7b58a5feb67422040,1350,FALSE,1597,247,
bad89bb40c48b1ad1c52319799d45c15,1248,FALSE,3067,1819,Radiant
ee8959b51c28f39b6d56e83d9a0807f6,820,FALSE,2392,1572,Dire
040d63cdec44571daa1b475222c25032,371,FALSE,1478,1107,Dire
739d4e6b566e2074b09c3ac05451414a,2416,TRUE,2529,113,
9bf04d36a6084b8d6e4118fe96e7e630,809,TRUE,1425,616,Radiant
23e32db1bc3cb6e4f4c69132b36f76ec,2296,TRUE,2559,263,
cda45cbfa96d91e4cdca6e55f5ab8fa8,2011,FALSE,2454,443,Dire
c629b6db15f3d604ba16b7065cefd7a4,910,TRUE,999,89,
ea76c03145974178232229cbe5e09410,768,FALSE,1993,1225,Dire
3a774e1e968195d9dc11a872f9c7ffad,319,TRUE,1389,1070,
7e34c0bac7d11ee62239c7895c77d437,102,TRUE,2867,2765,Radiant
ae93b2d5be9804cfa7c5e9a3d03367cc,1375,FALSE,3098,1723,Dire
f51a7573d09103c3da63ecfab0a6bf23,8,FALSE,1715,1707,
bf36705879a8a6e5878a85a72b8fcf23,1618,FALSE,1906,288,
b3eec342ec6492c6e6fd6402776e77f2,85,TRUE,974,889,Radiant
54ca6d11fbf77dee8eddbab44c6510ef,3354,TRUE,3442,88,
242ed68564a5ad6c025d715553f3ab63,2610,TRUE,2883,273,
7d5e0e32fe9310614e615b35ab4836cb,1820,FALSE,2271,451,
32f5a282b299628936d283a1b5e68b0f,675,FALSE,3361,2686,Dire
5304ea1a006d12a53a9a309845982dbb,853,TRUE,2780,1927,Radiant
dcba1a389fa630f33405b704ba50b192,2300,TRUE,2658,358,
6f59097ac01e7ad7c48a421d0ce06fbd,880,FALSE,2177,1297,Dire
11ee4d6500a3bac6f2dc2572e1d41171,2023,TRUE,3046,1023,Radiant
9434f7e43d9d518767552472a93c5a64,562,TRUE,1448,886,Radiant
b2c54efcc892dc977f4f83f45aaedb50,1515,TRUE,3997,2482,Radiant
f5c435dcd5b77bf40a29172eeebdbc3a,1836,FALSE,4189,2353,Radiant
101544b5d2ad56f508a034437e91f9c1,2355,FALSE,2420,65,Dire
43ac117b346348c38b5c02152d7b86d6,3048,TRUE,3184,136,
83fd72c1839d9cd5ea21e97f33a1e9cb,216,FALSE,3219,3003,Dire
568f877ae90fc6efb6b4babe7794322f,2525,FALSE,2832,307,
1968f74b79344b49488070f92c48ce2c,723,FALSE,2523,1800,Dire
d477fafcea7e147324031ee12c8281ce,352,TRUE,1919,1567,Radiant
6dd2c7488378ea8ea13804383a046ed5,1217,TRUE,1325,108,
c5d660618c7e6e90b291cba7b567daf7,246,FALSE,2512,2266,Dire
82282b10f73e64db0d48f56820b90f18,1104,TRUE,2008,904,Radiant
9caa302c07f28d9aa18d8e9d81d5c2c3,1136,FALSE,1992,856,Dire
3b0cb6890b3eeaac681f524dbfe22365,854,TRUE,1550,696,
5d7b364c11729f2a875dd9ac361ce04b,1503,FALSE,2461,958,Dire
983c1e46d7ab6af24750def95b8b0e84,662,FALSE,1578,916,Dire
fffd0c0cf7381099fa76beb168f59f75,927,TRUE,4198,3271,Dire
ac7b56cf0cb7ecb269966d8423a29f27,688,TRUE,1950,1262,Radiant
347caf6fae30293374c1a3059527125d,2293,TRUE,2649,356,Radiant
4a9c35a778e01644010da2bc04a43739,2673,TRUE,2822,149,
8287c7629364597945bdca5f8757a9e7,2360,TRUE,2960,600,Dire
286fa8a171bee2570d45f8611f920f22,3498,FALSE,3582,84,
222a2b83ac9e3901fb4c28e49b499073,1658,TRUE,2274,616,Radiant
1f12582da4de21ef1542e4f9267a4b86,532,FALSE,2373,1841,Dire
fadcd5be5e980449a94a6b523c37a310,872,FALSE,2197,1325,Dire
c54ee34ce3e82a23d882dfa4b8c7907c,447,TRUE,946,499,Radiant
a1c870c03709ad015ee323b90102369c,1346,FALSE,3220,1874,Radiant
8f2e7b327624e302f1cfd3931fdd0053,1066,TRUE,1956,890,Radiant
069fd814bea94f187234209442ed1745,39,FALSE,2336,2297,Dire
b7b4098bf32da7989f44c4f3e0aa5b92,2613,FALSE,3090,477,Dire
dbee93b54a7482bef2b5cef7d4f4d291,1541,TRUE,2344,803,
9f4d699e229629c6e33cb503cc6aa248,983,TRUE,2088,1105,
ef23cad0e08edf14f229efba8a5ef14a,657,FALSE,2251,1594,Dire
f01435b33661feacd22ae733a18a9559,687,FALSE,1812,1125,Dire
08349cecd68b72b1467018ea0d4446ee,295,TRUE,2388,2093,Radiant
1565f664eb09a216edf0308c4241851d,1035,FALSE,1848,813,
16eefea6293a67ef2ec06c1af4fa4da6,1327,FALSE,2490,1163,Dire
8950c87655a31b18b2fad434d1412a53,3007,FALSE,3113,106,
eaeff97eea2d054b0b0b42744c2cd73a,1923,FALSE,3513,1590,Radiant
e119cde0da6edc78af04c683cb7abc95,459,TRUE,1879,1420,Radiant
90a547a5c0f855a45029cd5fe3522b9c,2921,FALSE,3601,680,Radiant
226bba6c93fadef64bf76a60ab6431ab,1221,FALSE,3136,1915,Radiant
24becfc348f1381ab51b2c8c53980e02,2066,FALSE,2116,50,
ff50a269ed2f67bd1be319317f1b5b50,158,TRUE,1196,1038,Radiant
228d4e58abd63104a0621802f3f48b89,163,TRUE,1664,1501,Radiant
d474615963a212923cfbfab57cf3b575,345,FALSE,2452,2107,Dire
d18e741230fe6b3a87fdeed8df28651a,1216,TRUE,2127,911,Radiant
1ed22181b5fbf1db7bedc7ecf30cf041,834,FALSE,2074,1240,
c1a87ffed103c59c287a133089c4d77a,1704,FALSE,4047,2343,Dire
b1a2f98f18091e166187264f17abfc5c,683,TRUE,2156,1473,Radiant
07913e1ed52142b74c2791deca474bd5,198,FALSE,2548,2350,Dire
93c91c88bbef4e828d6db375e5ad7856,1472,FALSE,2866,1394,Radiant
0d1e19e71c1393ef0ac6f48437e198ae,1478,TRUE,2741,1263,Radiant
3391510e7d9790088f99da38b4a6df0a,95,FALSE,1737,1642,
e6b5b4056b7ac938c2757e9b818bb279,1539,FALSE,2760,1221,
ae1a8423106ced8dec980daaffe102d6,1475,TRUE,3374,1899,Radiant
289885f65602f3ec598768e9733d28dc,89,TRUE,1800,1711,Radiant
5cef3405744b1e86d7e7304e2fdd7f03,1074,TRUE,2125,1051,Radiant
789c4888e2ccaaef57b1b375f430d8e0,815,FALSE,2878,2063,Dire
4c218ff5fab85626dbacecaf2adf1ce7,805,TRUE,1336,531,
00faed3b8889ee0959d5b3264a244c89,808,FALSE,1056,248,
2aabe5ae5c5c5a9f4918bb2aa4b16d7c,475,TRUE,1856,1381,
3ae6b0622cc0bfccb15adef764766bc3,1461,FALSE,1550,89,
7e09beb03559541c19ea1c51d6067ef0,1240,TRUE,2137,897,Radiant
b17d58b030253a0ad20fce4a5172ad0e,580,FALSE,3006,2426,Dire
111dfafe19c7a9a7c2f0e8b98388fc0a,1228,TRUE,1822,594,Radiant
f2e29a1dd9cef7b9265c7768149db973,1201,TRUE,2017,816,Dire
ea37ef85a2cd27b6abc46d17d0bf1252,1334,TRUE,2255,921,Radiant
b122716e03db9c7c2c4fe98c82509c50,614,TRUE,1110,496,Radiant
9b23c2a2f1d9c996e3ca4e728a042074,2687,TRUE,4219,1532,Dire
44917b64055f3d4610bdec27dde2b6a5,2112,FALSE,2695,583,Dire
65987581f5be92a2609c97fe50fdce74,725,FALSE,2150,1425,
e0a94166f7ed48a62d446d61b4a26997,1614,TRUE,2037,423,
7cb7220004ac1840736427b31b5cea2b,531,FALSE,1021,490,
2682ce165d30e33802a9f983779cc307,304,TRUE,1793,1489,Radiant
8e27a644668326363e7ef4d32a8e1ff6,753,FALSE,2526,1773,Dire
ab735b885109faefe1b6e7d8673a4058,1297,FALSE,2386,1089,Radiant
5bf4e3b6d1a569d3ba2bc18b1dbefa79,1042,TRUE,1720,678,
839ff13b3ab292aed9e0e8797159a429,818,FALSE,2847,2029,Radiant
55cab50f0f2c80e124f3b8257849b71e,479,TRUE,2408,1929,Dire
f483ad9a8d117bed2b7a371791c39a2c,769,FALSE,1895,1126,
9b3acaa94012bdac6150917add0504b2,2017,TRUE,2759,742,
04ff18acc95a817997d2b4b0e87e6c32,2038,FALSE,2492,454,
cebab2a2bde79d6574178603af81b94b,1460,TRUE,1669,209,
16564cb79d2bdbf7f62ef58f8325a8ab,362,TRUE,1592,1230,Radiant
a091e7c44e884f48660b587edcfb0ea2,1269,TRUE,1772,503,Radiant
f52443d5bb0cd3b515504933a6d1dd27,872,TRUE,2773,1901,Dire
44a6e5b2f80079bbcc5e41009b527da1,2566,TRUE,2633,67,
97c276896286751d415c2d683232ccf0,980,FALSE,2480,1500,Dire
6af83b940add56ff9f605ae869a3f570,703,TRUE,2312,1609,Radiant
c0f8af8d7f837f69df947f6f9fae9b6e,216,TRUE,2813,2597,Radiant
7c7605d548b991a527356dc0042c466f,806,TRUE,2517,1711,Radiant
f2390dd2757b242533a5435d9ef9901a,923,TRUE,2141,1218,Radiant
07a0d3902c8d3b1dd2f507e82decbe40,399,FALSE,1464,1065,
ed9428784224e51414e30cf69c10500f,2149,TRUE,2708,559,Radiant
0320209f813645d1c922794e47fd2cec,418,FALSE,2373,1955,Dire
1df610eda0b6d228506c59ce854dba25,632,FALSE,1963,1331,Dire
54f85de646de986c92c2bb1d3797c843,1914,FALSE,2857,943,Radiant
9552e9393b1a1c844017b9934793777c,1291,TRUE,2186,895,Radiant
9d2622bf82ceffda8c702799bda6b9ef,914,FALSE,1264,350,Dire
0b4e1710f4ffe5130f4cbf5e8f751487,2969,FALSE,4417,1448,Radiant
f60261a11fc8dc26090199ae63c876a6,1101,FALSE,3372,2271,Radiant
de84be6d4ae9c5c1f27da449535acca0,284,TRUE,1912,1628,
a5dadaf9fa7c9456479dbee7353ba788,1105,TRUE,2316,1211,Radiant
a914a486ec950cc2d1efb9e51780e66b,413,TRUE,2173,1760,
9b15ab3ad10cf61747a2a731d3621364,65,TRUE,1017,952,
9fb93a9f7a1a89766e0c2a47e2fc1cc3,1609,TRUE,2921,1312,Dire
b02c39e450b22040ea9415385b352243,2016,FALSE,2799,783,Dire
32d0a9b3e28f74b8d15f01c9df6fc1fb,1146,TRUE,2085,939,Dire
f366db9b7ad06439e7472509e8acc8ca,1229,TRUE,2071,842,Radiant
b773bc9f40194b1cd00e4920e8645d0c,326,FALSE,1162,836,Dire
1504abf3a6e21cf8fd05e04755379ed7,1845,FALSE,2175,330,
aa92ea84bf14c4389f9cc6a189a908d8,685,TRUE,1660,975,
6b08d0a9a9fbb88b975808baf9efb89a,28,TRUE,3503,3475,Radiant
7db39e75fc0cfe0b256c28cddcd89f1d,1028,FALSE,2104,1076,Dire
f51027708fa4a627c5ca54f5c874c55a,584,FALSE,1559,975,
f8ea645f6b33c2f6b039ef2ae91a4b3c,891,TRUE,1692,801,Radiant
fac5f598e3028e82f195c7ee6a235b7e,1752,TRUE,3292,1540,Radiant
a9462ad509ae8304fecfb94db7c76a84,2227,TRUE,2685,458,Radiant
1feb00706f74d8195608dd2966635284,246,FALSE,3061,2815,Radiant
325e3377fe271392534637e59fb990e0,526,TRUE,2368,1842,Radiant
1ee7e628d2429c7affc4c7b5d5d75e92,2915,TRUE,2996,81,
8d0a0871903e5633a01ee1273942908a,430,TRUE,1990,1560,
4b2027ba3c825aa6989bf545b392f4d9,1235,FALSE,3351,2116,Radiant
ade88986194005be126c9607738598ef,926,FALSE,2308,1382,Dire
69728355e33764579fe469be6a74d860,1753,FALSE,1976,223,
21abe22cbdc12084e749b0cc146413bf,531,TRUE,1887,1356,Radiant
4e6705f928545b9f12d07133498f5760,477,FALSE,2950,2473,Radiant
5a1a47c07072fed4566ba884d5b3d930,1398,FALSE,2275,877,Dire
b9f1ba26f5bd1d79f910f83f56a61f34,1070,FALSE,2920,1850,Dire
27db9837a5264246c57120bf953f5dff,139,FALSE,2187,2048,
20e9e65167146cabf938d48a49a90d95,999,TRUE,1953,954,Radiant
7e2beb4415dfdaf905f64fe1633aa8cf,1084,TRUE,3100,2016,
952f1c44f428bd2f2728f72620ffb6b8,386,FALSE,3386,3000,Dire
eab759188c509248a6b84c2fb9b850cb,661,TRUE,1886,1225,Radiant
ebeecb063a25323369011fa41635c94d,602,TRUE,2804,2202,Radiant
554323c1db4f3654e9ff415142d33f21,1362,FALSE,2067,705,
9362cbd840b7a2b68cfe6ab4976cc420,2987,TRUE,3111,124,
36ff7a80dbed05bb985c043f67e40ff7,1344,TRUE,1886,542,
a54d1945312f2479f0bf9931320f59f0,1124,FALSE,2539,1415,
71200b7a17f89e246e68b5d87e9c0c78,1521,FALSE,2134,613,
29af1a306009d77e19e696c063b2dc69,1261,TRUE,1414,153,
d62dc19397408405caa4514cceee2645,1021,TRUE,1232,211,
2e36ea1d04eafe6090eac893706fcfa4,292,TRUE,1255,963,Radiant
f92416193f3dd30545785900f1c91510,2191,TRUE,3063,872,Radiant
8a8b2d2e601a94049569c4606035fba9,1688,TRUE,1925,237,
1bee822e06e8e9da825bbd72cb35e4fb,1198,TRUE,1343,145,
8f84e3b7f7b87466678003a46750be17,1748,FALSE,2316,568,Dire
6542ff27a91dfb65ab01e0cf5a19f9f4,558,FALSE,2448,1890,Dire
16ccbf4a9170e5f5ecf2ac54621ee208,2856,FALSE,3580,724,Dire
4678e2ad601b51b7261480a598fbd5cc,338,TRUE,3158,2820,Radiant
b2b223a4063d46d65e616aa4eca0b83f,976,FALSE,2236,1260,Radiant
d547b513c766f3bd439409b59c50dfeb,2157,TRUE,2828,671,Radiant
d057603070dfbc0baab08b8e9c7b0f2f,495,FALSE,1272,777,Dire
1111d9a24570eec8f326c6f8ca63f4fe,1172,FALSE,2643,1471,Dire
7422f93dea1a701d84312ed99cc6119c,86,TRUE,2924,2838,Dire
2545b8f8f8f157c82437f4732d84e525,121,FALSE,3189,3068,Dire
f9b9705d46dfc196fc5162df459e64e8,493,TRUE,2791,2298,Radiant
d77f02cf9b8569c999601d9682b91e4b,185,FALSE,1501,1316,
0eb1881171900ad9feffcae0666db501,842,TRUE,2203,1361,Radiant
1b196662809c871bb80592924799de0a,281,FALSE,1526,1245,Radiant
39ed758d4138695390eb6e361a70eaf9,1444,FALSE,2477,1033,Dire
208ae42099101976ca1235e89c1b539b,656,TRUE,2816,2160,Radiant
92c7d37e622fd4fce58c50a5cc737d7d,1892,TRUE,3273,1381,Dire
91f939b7118c73597c8f3162d1113a0a,295,TRUE,2583,2288,Radiant
3c430bef7bd46e1ccffd4854d50b5605,838,FALSE,1468,630,
68762f025c8c5167f410360e38eb77b0,980,TRUE,1997,1017,
fdbb3e7233b915a77e2e35430fd0ba38,882,FALSE,1490,608,
08adc48a9e23d82154f18233ee1bb3d6,1235,FALSE,2752,1517,Dire
9c9da77c3b45bf367cdcd5db0d0381f1,3606,TRUE,3716,110,
06885c3da91824f9588d57c44b2234e3,928,TRUE,2037,1109,
d1b2234b195e5b584b65dd592af2329d,1372,FALSE,1782,410,
3190350105e3e6445c9c7a68ebf0be52,1392,TRUE,1516,124,Radiant
192f222704db96537241057f78532f7f,1394,FALSE,2238,844,Dire
efb68168910498d18c019b382bae458d,1930,TRUE,2326,396,
c57a0567c1125d638b40abf2e46a0a45,250,FALSE,1398,1148,Dire
5cc7ed64a309fe000a6b993b58e68454,309,TRUE,2383,2074,Radiant
1d229abdc6f333690e8dc9116a558b98,1042,FALSE,3279,2237,Radiant
60dd6243507a4a5dc10ab18856fc0b06,592,FALSE,1934,1342,Dire
31b798e197c59ad5f02903585a2d9190,445,FALSE,1700,1255,Radiant
e8fea72935652a603d52c2bded65ec46,766,TRUE,2499,1733,Dire
12221bb3b75e736f97448aaa1e2e9d60,1305,FALSE,2660,1355,
d9f50df97f3c64d514281f388d27a686,192,FALSE,2307,2115,
585bbd3e1e166822cc47a961614ca43c,260,FALSE,1325,1065,
395118af07efbca13638328313a8bc55,2642,FALSE,2862,220,
e394dd37ca3d719c9bc4d2e527f9307c,1678,FALSE,2052,374,
3453dd317ef5c47c5e19e9741b631e61,1496,FALSE,1574,78,
64bd6ba273dc344bcefe84a15e4ec169,1036,TRUE,3358,2322,Dire
0468d2694c4e71ebffd25778d75ff69c,608,FALSE,2465,1857,Radiant
20d1bc9ef3b81905451ec282988e4414,527,FALSE,1564,1037,
64d4b1bf350d11150548e02c8ecb931c,921,TRUE,1898,977,
26856f6596658150384676164b320fd6,754,FALSE,1943,1189,Dire
6ee295aedb1b9a6011c9148b746d7bab,1328,TRUE,2574,1246,Dire
3524a3190353ac24f91393ce7294b9c0,3916,FALSE,4101,185,
313c9e2fade48c5d9cec352fad751c0b,136,FALSE,1954,1818,Dire
706e7733132ec53f78a4edb7871fc0d5,81,TRUE,2195,2114,
6cf6ba06c5cc824e73bdea7016e5481c,1238,TRUE,2563,1325,Radiant
fa73c0ca1506b0f2f85b4ae22b8db7c2,260,TRUE,2012,1752,Radiant
a3d1638fe67be275b28f419684506b5a,8,FALSE,2550,2542,
8074d2f99ca1106d4c811d74cd58ce4e,592,TRUE,2578,1986,Radiant
5964a09eaa9543c2f39d0eee1e95289e,185,FALSE,2191,2006,
9a440a9b3fa2b36f780cd5e1474850f3,237,TRUE,2324,2087,
17cf7edbfb27552d14e681badd1aa2c5,757,TRUE,1319,562,Radiant
cd46dfa379d8e143890c5789cca12e35,1637,FALSE,2583,946,Dire
cfb408c37fef8bf52b721f24214bfe5a,1466,TRUE,2575,1109,Radiant
81eac0c138fc12501db43e5ebe723e42,344,TRUE,2158,1814,Radiant
427de414528870aebef3ccac84e41066,297,FALSE,2757,2460,Dire
b1beb38bfbebeb4553be8773eb983793,1906,FALSE,3453,1547,Dire
817631a222b7896bd463b5c68c46b377,301,FALSE,1936,1635,
6bf6ab52b9a6e0d81efa8f5de3648ede,1050,TRUE,1203,153,
10a884baff090b71b53e0614bc1194ce,651,FALSE,2781,2130,Dire
6bb5db066d8d739284e713fbe46d3f6c,32,TRUE,1614,1582,
f348933eb169e27f60a3832e25465848,678,FALSE,2173,1495,Dire
d34a2029a0d97cc286cdcc730b2aa49c,2485,TRUE,3713,1228,Radiant
9a1de771426bb4032b15f57d8c49590c,425,FALSE,1292,867,Dire
6344b589637ebb7be4c6fa79053138be,363,TRUE,2182,1819,Radiant
8ba08748893fa16616b5e3f6a40727a2,1182,TRUE,2788,1606,Dire
b4b6a93db7271d50fd5ed1b5b524a829,3570,FALSE,3906,336,Dire
c41041b4ffb26e5509e3babdc5a9c4a5,1941,TRUE,2753,812,Radiant
e6c87119a2438f3746d0cf1b32bba475,123,FALSE,3220,3097,Radiant
446e19f1e3ec3a3ad4408b1edacbd1a8,1457,TRUE,3434,1977,Dire
44f8c9398840df3fd2f87c1a7bda9507,1372,FALSE,1534,162,
06a0e0b3c3debba32469200c51961bde,444,TRUE,1066,622,
599fe6962093d7eef93492c50163b707,631,TRUE,1756,1125,
63b026b0dca99e37e67b46006940f173,1193,FALSE,2124,931,Radiant
72adc9c2752b41cf280306697d1dabfc,1542,FALSE,2137,595,
57c6e92f931edef6a75e1c46d221d6fd,968,TRUE,2395,1427,
573f32f4106fc33865874f4e8daf1e5b,937,FALSE,2252,1315,Radiant
db7c9ba7c7808a3f1f3c1620cdc3d55e,750,FALSE,1967,1217,Dire
d4ceb7f021587799aedd9e3fabc4bdbb,1081,FALSE,2182,1101,Dire
2695fdc7e755ca5d358a6885fb422d09,2572,TRUE,2651,79,
dd78f0a12e2b995ac97b5ac28f659288,293,FALSE,3003,2710,Dire
9c3efe927c58ad41cdb16d7447f933ac,690,FALSE,3502,2812,Radiant
2c7d74f41a3b7eeeeebf3dfe73280225,515,FALSE,1589,1074,Dire
0d159d027276732d19e239cfce51690c,608,TRUE,1141,533,
e35b6c5f489a6d84bb43ed4ac4d7633e,2741,FALSE,2806,65,
1cdd5731ceaca23179902ade26fdb5a9,691,FALSE,1597,906,
8e3d5e8ef33ab48cefb17e9f81562fee,1281,TRUE,1485,204,
48909c32855c14229e1f86fecd60b1c1,760,FALSE,2120,1360,Dire
e76fdb815c2b96848a52caa331d15bbe,1801,FALSE,2174,373,Dire
69c90140813780d269f50c22c6cf2b3d,1478,FALSE,1764,286,
c80d39ac39e33c391ef3f10e08769acf,221,TRUE,2366,2145,Dire
c5fcaaafe584e324096617d96970e072,36,FALSE,2448,2412,Radiant
5daa8ef70f4349f2c98240cce2bd4d4f,777,FALSE,2795,2018,Dire
f09d219f0de97098bf1c1e6db60701a8,434,FALSE,2184,1750,Dire
fb9266ff011cb9fcb8249e44730eb25b,301,TRUE,1973,1672,Radiant
502e0d2f09a9f0a5fe40abb87fe84316,751,FALSE,2899,2148,Dire
b60995fffe1427bf401371628ed6d128,974,FALSE,1225,251,Dire
1d51c04131adb45238a881b2103dc8e3,2022,FALSE,5501,3479,Radiant
1ab784793f2bf23bcb68c65ded8a07bd,155,TRUE,1642,1487,Radiant
9aed902d4352b846e2e4364cbbd2913d,1136,TRUE,2504,1368,Radiant
5166e5354830bdf771e99947cccc6c54,913,FALSE,2127,1214,Radiant
886135a5d0707415e5c83aae6371c1b7,80,TRUE,2210,2130,Radiant
302e5253fe3027500af063d0390f69ca,8,FALSE,3191,3183,Dire
cf7949764f95591aa8ecf4c949e2dfb3,1760,TRUE,2093,333,Radiant
a53763033b968fd26e99b8ac53e9f4f0,2238,FALSE,2298,60,
809a5ce75ff394b3c6cd803b2b7d5e83,1538,FALSE,1843,305,
bb4f6199e3e885a39c6f23c6adadaf01,97,TRUE,2779,2682,Radiant
02c5f6ec402addf0ba8925dea70414a1,1099,TRUE,2222,1123,Radiant
7810e3c41c47ecfba74318074f7ee956,523,TRUE,1467,944,
4b255985976319de3d0ba3d732d1e602,2023,TRUE,2354,331,
d8b915facdad118ec795b45955d80785,1480,TRUE,2549,1069,Dire
259606d7ac9978d83e677ba7725fb318,1528,FALSE,2766,1238,Dire
9d9e22b4b93fbdee2e8847f1653583fa,1808,TRUE,2448,640,
83f3e0539e854da054004e564ba8a6d7,169,TRUE,2745,2576,Radiant
77ada571f266eff66d66cfc08fcedd98,2142,FALSE,2933,791,Dire
cd8586dee9e921eb626c01115c809b05,1284,FALSE,2658,1374,Dire
e75ed5dce956d3186da381142bd13155,190,FALSE,3104,2914,Dire
714265992212587badfbac90eac0e972,165,TRUE,1332,1167,
d21655908d7a538df57419cb7dafc091,241,FALSE,2834,2593,Dire
9f733c2bd74494353f6992acc9b7291e,841,FALSE,1590,749,Dire
a035409dc6bc164d1ea4d58eff2e5a17,1012,FALSE,1278,266,
1c44bf39a39c57d7d257de0c8889f2c8,705,FALSE,1701,996,Dire
2bc5af17704a8a7bd9ad02822d176158,1943,TRUE,2079,136,
3669903cf54e6a97406292a1afc7ac6b,825,FALSE,2155,1330,
777d97f4a87aa64798d8658b6f68ee25,2006,TRUE,2940,934,Radiant
2694360f359040200307e48a5f114303,469,TRUE,2187,1718,Radiant
9233d574993dcb9fcde577ac41324bd6,230,TRUE,2907,2677,Radiant
0f6a009cf4dd8fa8251fc4622a3c0baf,777,FALSE,1900,1123,Dire
07af4de7ac67ed60fe69949ab469b31b,2323,TRUE,2507,184,
dbce051358127bc52a1d0e125707a16c,1726,FALSE,2602,876,Dire
8ccb7235a10ab01bed9f2352dd8c56c5,666,TRUE,2471,1805,
7cbd15c6c8335a4cb45536a87bfde377,1167,TRUE,1951,784,Radiant
66c11e89ca844acc92693d3e5cfcebc7,1063,TRUE,2624,1561,Radiant
d32078dba924db131f6e68e97400cc25,924,FALSE,1659,735,Dire
fe3f96e42b9e6c4fac14760a90555d5a,908,TRUE,1384,476,
9fa0a56b2650d4b1b6e25eea8b273ed4,1776,FALSE,2292,516,
e26fd12d84da5abdc4e7d078523b0836,1226,TRUE,2324,1098,Radiant
6e06cca99b225909f11938aa067b0591,1649,FALSE,3245,1596,Radiant
c3383221078ac7ca4ae0b77466ebccd4,1494,FALSE,1769,275,
49858b7792754534c2465e5aaa634c9e,1883,FALSE,2860,977,Dire
011b93124d604d92bff3ea1009497019,736,TRUE,2388,1652,Radiant
3bc756b645452754170f4bd12c6519ef,496,FALSE,2811,2315,Radiant
7ab98c95163a850dcdf981fa082eee0b,2102,TRUE,2374,272,Radiant
3f799fb345a33bc72bda1b3ed37bf0cc,1286,TRUE,2253,967,Radiant
9b765bdd23070b0a647886da9165f5eb,1990,TRUE,3087,1097,Radiant
c7e61421fa19982531c2a9717c138178,1007,TRUE,3034,2027,Radiant
6ff10846683fac2bb65c5dc81135791e,1192,TRUE,1975,783,Radiant
8d9c66cadcccb899df1b489003603b35,976,FALSE,2190,1214,Dire
6719a920725c5aa9c2c351256f36a3a8,276,TRUE,1724,1448,Radiant
093cd20a967685baab7ef890743875ea,75,FALSE,2074,1999,
b0adedb297ccd18caa93ac09ae2fb46b,1709,TRUE,1922,213,
8476190e7cc0ee1439c8ef54fe619534,802,FALSE,3076,2274,Radiant
00674e2c5c9929d9d0d1f4be22a1eb08,109,FALSE,2087,1978,Dire
e96a3b9fbb492a52b5410c665dffd944,304,TRUE,2349,2045,Radiant
c0e9bff7865aa5a078fe829c8c275c78,286,FALSE,3289,3003,Dire
697dd12aff326bb9b3a723c8f9b1d63e,394,TRUE,2612,2218,Radiant
57b7afb4de58da630c23981759c75551,3200,FALSE,3311,111,Dire
3def20d104ca7428abf6267e52d98962,635,TRUE,998,363,
42cf889e6e4ba9aebc240bdf05e2a2e8,2674,FALSE,2727,53,
6d22cd79016e8fe507fe67a90aff507c,2171,FALSE,2534,363,Dire
591296f47d3fb9faf5a42720cbab45c6,1588,TRUE,3132,1544,Dire
77d0ee2f8994a5ac0aa4b0b7f58b250d,280,FALSE,3711,3431,Radiant
2fceb71670d7c74f00a03d0969fa28a9,184,FALSE,2500,2316,Dire
921c98166bc1f41802ad948176ef1736,277,FALSE,2035,1758,Dire
57c395f03104222959fbf331521f0661,106,TRUE,1389,1283,Dire
05de96195a533b00b12ab07dd1e18d7b,2203,TRUE,2932,729,Radiant
8fd766fbbf8edee41246b8c489fadafc,156,TRUE,2941,2785,Radiant
9fe5ddd53df8f30dd43fac5785ff32d1,1585,TRUE,2849,1264,Dire
e4e8f86e3f04d891662319a8b6d90244,122,TRUE,1601,1479,
1e6716231c10d01acbaea37132fb84b3,118,FALSE,2053,1935,Dire
f30bbf888495ffefd85b63f9922b163c,71,TRUE,2252,2181,Radiant
878b05592ac2acf322c0be48681f6413,332,FALSE,2580,2248,Dire
bd0b24316991bbb6f6486e94a05dd443,2041,FALSE,2979,938,Radiant
c3a95fcad96b6bada32527d8001145be,18,FALSE,2756,2738,Dire
d529cda131c8099578ca5d6af6b87b85,426,FALSE,1046,620,Dire
c208e8a793ee58704b5caccd99cd46b1,672,TRUE,2807,2135,Dire
6a9d4fa866c3e9abd6ebdc3f49f6bd13,1104,TRUE,2481,1377,
8f8f433f129501afa42458f2e89fd28c,2086,FALSE,2753,667,Dire
ec0d198e58749d738efe81c77e3e7049,971,FALSE,1974,1003,
36e5007b74ed9f8e54dac2b608844f81,1911,TRUE,2135,224,
44628ccb6505f46d0acd9b9cb15d7ed3,1843,FALSE,2471,628,Dire
6db924629f4e126bafef55d6c8fe90a3,2120,TRUE,2204,84,
2a368c66d778750dd64d9a8bccf6d5b8,818,TRUE,2315,1497,Radiant
6575b6affccb26ed5ace9200c7ac500d,124,FALSE,1941,1817,Dire
705c3809c9349ac365c61e0589be6ec7,1081,FALSE,3270,2189,Radiant
a63fcfb034687cb226f3b74e06a34398,543,TRUE,2168,1625,Radiant
b6f107da412aa7df8a0a83fc84c72106,2834,FALSE,5260,2426,Dire
d204f5050719ff2a50a213b151077724,1713,FALSE,2500,787,
4496594ee3a769ad256df6b748033116,2409,FALSE,5530,3121,Radiant
72b29135b1ad7125fd2cbba409533d2e,1028,FALSE,2090,1062,
535e825100e933607afe7bc13e96affb,2785,TRUE,2953,168,
15d356fe4dc3c7b3798163fdb098dc91,524,TRUE,3363,2839,Dire
e2621a880ca5512529f3cc43da8a95b4,2338,FALSE,3197,859,Dire
2647db06b3f4610c3fcf5d7d46473e13,240,FALSE,1817,1577,
1464b78fcce0b1712da1ebbef05657bd,2782,FALSE,3444,662,Dire
a4953061b2e63cb5f9f9b431a119c8d3,850,FALSE,1859,1009,
2f07807622682a47eddd5cf1040e28e7,1308,FALSE,1907,599,
8f82cfa6e8718b39246a9a786d4f3350,1027,TRUE,1161,134,
7cd0c65e97b7fa7d55d31d93544371dd,834,FALSE,1397,563,
68aed75b6ec7720b2b068265876ebf58,2151,FALSE,2971,820,Radiant
1bfe2bcc827db62604a8f3c6567167b6,260,FALSE,1516,1256,Dire
57a37a350e2f0587566cba007b3a10e3,332,FALSE,1512,1180,Radiant
27584a2007fb3d5f1b259828ab2c6cea,46,FALSE,3171,3125,Dire
bc77f5c854b3247bf0177c403d3dc073,83,TRUE,2951,2868,Dire
1227492745a8ef1369c075db3c05fdc7,1906,TRUE,3062,1156,Dire
048f6b3f764d7899eede74e4a38117fb,1753,TRUE,2176,423,Radiant
3d9123a3e30291a3df36ffea90bc8657,1038,TRUE,2001,963,
7af075e8b08647fcf8f4948ce14183ae,1931,FALSE,2293,362,Dire
1b8446ab0d9c7170ec948b3c2bf4318e,1778,TRUE,2904,1126,Dire
ee5e11d15ae41c9233439e248d200a69,1900,FALSE,2711,811,Dire
8f1d5926ebc40c9e66b9d59f4ee8f925,521,FALSE,1466,945,Dire
dd1aed41e4ff383642b07d8720bf068e,1605,FALSE,1637,32,
fc21aa63ee5e23723e519623cdceca26,943,TRUE,1762,819,
f813aa931a0e94b15c03626d8d4a0658,1854,FALSE,2721,867,Dire
cd8e5fd8ee1747b3f32fd6c99f1c8be1,933,TRUE,2022,1089,Radiant
ff1171f443e49c3e10001e291d03daef,681,TRUE,2238,1557,Radiant
25ba28e3c2cb46c15ea1ebc5b983f906,743,TRUE,2951,2208,Radiant
a8a456d6b75c9db664736b1f4b4565d7,1200,FALSE,2505,1305,Dire
c9911db5a65d9e1d98235c8ede8912b8,1446,FALSE,1979,533,
2f18c0a0acbb9ad1c6ed49a1a2d6d61f,601,FALSE,3633,3032,Radiant
8406ad9b54498a2581eef5c3262d67b5,1752,TRUE,1820,68,
4e07d92411699795be05adca80f113c7,1632,TRUE,2705,1073,Radiant
992bf03653f77e86169720ca176fcd88,2220,FALSE,2789,569,
c984fd4b23283e49e2e1dc46d053bbfb,264,TRUE,2459,2195,Radiant
2e4e62e1a0e8e1ced3803828736fa57e,1380,FALSE,2727,1347,
c80e52c0bdb6268abb02f688ea0c102d,717,TRUE,1027,310,
bd09fc8831220628cb707dd64bb491a2,1138,TRUE,2007,869,
63e59eb7ac1e4a641a06c9aa6e31e32f,364,TRUE,1416,1052,Radiant
5f866db4c8d3e21373c6b8fa473f6a37,460,TRUE,2085,1625,Radiant
462e226edfcfad91e01636b5879d1f8f,563,FALSE,3363,2800,Dire
98b4689ef36ea1712455974aa9800822,1134,TRUE,1190,56,
087b658211fd61eb211d0ca9577594a0,1149,TRUE,2815,1666,Radiant
6cdc6f51e73b9fdbbbb769b1e1aeb953,130,TRUE,2675,2545,Dire
b001da755de57aefa63967372ff3b984,2899,TRUE,3425,526,
2d48d8cdac0a960dd4b336e2ca33d0d4,176,FALSE,2304,2128,Radiant
4664cbf1bbfb29d8e36eff5b4bc5cab6,2319,TRUE,3262,943,Radiant
63b50a06be72c3f05428d3fab8155d49,661,TRUE,1874,1213,Radiant
befdc216c517f915e61f30f465ddd2ad,532,TRUE,1592,1060,Dire
ef3c9dbe8e9b5a7bbfaea0785ff9fc95,907,TRUE,1888,981,Radiant
0b42d2ff6a56480ce5effc38bb1bfffa,1793,TRUE,2297,504,Radiant
b10bbc8cddec309993db5e529df71ca3,553,FALSE,1559,1006,Dire
aadf2982b7efacdbe0e987cfa16107db,1324,FALSE,3650,2326,Radiant
006f9deb0f20abbc1cb0a00f9d0c0dbd,483,FALSE,2184,1701,
60a26636865792c1709e4234e0d36517,940,FALSE,1102,162,
fe05e053f638ffc25300ebad795a7c77,802,TRUE,1629,827,Radiant
6a1fdfc9ccb367255b351f61da9d80b6,506,TRUE,1315,809,Radiant
e5dd7033b4f1090901b15510793e9556,2256,FALSE,3460,1204,Radiant
b3cd5ffceb7c13301179ae26e1b9540b,831,FALSE,1313,482,
04df523a5953e288a2a69d04adec8332,49,TRUE,2154,2105,Radiant
c6d9c2220857aa31d53c1a4af3bafdf2,572,TRUE,2473,1901,Dire
2120800862147cf93645251b16835bef,1653,FALSE,1783,130,
324e7677d150316875726bd95adf671d,132,TRUE,979,847,
eecf648804b251dde5156adca1e9794e,2453,TRUE,3882,1429,Radiant
09f33f9cec9823d04d571ad4622d367a,1306,TRUE,1850,544,
c31844d03c321af93aeeec4f2de52c8c,352,FALSE,1731,1379,Dire
1ceed527e552cdd7a9e287f5dc07b320,1963,FALSE,2206,243,
2eea6d0623db8f5f3f4367aac5cca982,1387,TRUE,1513,126,
c50bd1bb943b806e227b1fb28cbeddaf,495,TRUE,2371,1876,Radiant
987f32787f0577baf25344070b1bc210,712,FALSE,2647,1935,Dire
f74f3ea662b32113bae649d1b8b65af6,1192,TRUE,1616,424,
f14fa9b0bc38a7249f5a06f7ea51538d,848,TRUE,2281,1433,Radiant
5c00fa29df816b65b410023ba12a3a08,1378,FALSE,2849,1471,Dire
8b7d04c0719cbd96b66ff0e142d1d4dd,791,FALSE,2204,1413,
562694731e937d4e2dc18566bda39494,2069,FALSE,2723,654,Dire
58a4e3051ac02d7a45083031944961c7,195,FALSE,3234,3039,Dire
586ffb5021d8337bbf64661468d260c1,1143,TRUE,2354,1211,Dire
737ec8522fe3b9a959fd927e5f42dc3a,2970,FALSE,4036,1066,Dire
87bdda57776eba465d9b6abf1741aeea,79,TRUE,2175,2096,Radiant
17edbb1c6f58c4624f663864ee91d1c0,1457,FALSE,2573,1116,Dire
c1cffc8d7cb7e31a3bbbfcd78bd94e6a,699,TRUE,2614,1915,
3d96b25a6cc7f611277cc63594e7c53a,1452,TRUE,1690,238,Radiant
84aed169222d485ecb6785644086aca5,945,FALSE,1845,900,Dire
4ac45e6aa7cb97119dbeda2d951fb8be,1188,TRUE,1918,730,Radiant
c44cb9037bc6ebb0717e89b9256818aa,1371,TRUE,2476,1105,Radiant
60b21cce17f89018bf4d74ec046dfb66,245,FALSE,2877,2632,Radiant
d59f7587cb6b2a0af43263ec6d972039,1175,FALSE,1983,808,Dire
adc2e4c3f38fd01230a30a45ac6b3006,865,TRUE,1944,1079,Radiant
783ec3bab881fd58af9031269a83264f,3077,FALSE,4103,1026,Radiant
636ef235094781bf2a48ee5a443656ca,670,TRUE,1608,938,
70116449acbd166239a885bc5e7f2a69,1135,FALSE,1357,222,Dire
dd4bf190b8830e81278a9dbc1e07bd47,205,TRUE,1592,1387,Radiant
15fca716d57a9d405292421717b65352,789,FALSE,2233,1444,Radiant
409ad482476874dafb9998781aa2ea22,219,TRUE,2382,2163,Radiant
5f6c7fa5acc0f30716a96cf6f53f28b6,391,FALSE,1541,1150,
21122cfb8d58bbf7e8c20843715c6ac3,276,FALSE,1107,831,Radiant
26218ea964b5ce6a9a3e8a134819e0ce,971,FALSE,2612,1641,
69ff67fed0d21b863e7fc0933fffdb13,1094,TRUE,3755,2661,Radiant
2a984ef46a5c311a0279d24485a2c45d,316,FALSE,3123,2807,Radiant
2aa946c4e40793c63091a5ce08fffb84,1829,FALSE,2428,599,
c909a2cc1863cc5d5e8dc6d7266848fa,1817,FALSE,2350,533,
7befe4149bb2108628cc8607a63faf55,1448,TRUE,2381,933,
662478855719398c617f3d285a25dfec,2103,FALSE,2550,447,
03db70fc1c790b431755c5422c834ed2,1157,TRUE,1477,320,Radiant
0fc661fa21ecf8ee0cc00cc867a41a0d,1968,FALSE,3114,1146,Dire
ce5f7787d0b86a65dc6e77a6bb35748f,832,FALSE,2096,1264,
a49689f1c783ae5e470fe58158ad5a83,2211,TRUE,2282,71,
1b7e3c31140269e49be43c25eb5c5692,1264,TRUE,1522,258,Dire
64c7003bf49315de5bbc6ee7be0781a1,2317,TRUE,2404,87,
dfe5389fbcbdf0080d7b7029fc8b4c38,479,FALSE,3112,2633,Dire
3e85e4d32dcbf73b27b8b5e509d0c089,707,FALSE,2994,2287,Dire
f547488c90fa5b20ccdaab358fb24162,797,TRUE,2816,2019,Radiant
5ebb4658e9c8f3bdfb1314dd6c4a95e3,1698,FALSE,2344,646,
f48a8aa46ea800e989016d5c4bdedb28,968,TRUE,1421,453,
dbf184d28b44b0fb7f66dfcaed1c3c86,833,TRUE,2224,1391,Radiant
8203f5dc87fb574dd0ea0503c861060d,1279,TRUE,1561,282,
e0f18d58d84fbb01aba72a78856b14fd,11,TRUE,1167,1156,
100b74df528c8665cc39d0f7cc90d79d,333,FALSE,2718,2385,
82ef75dbc9f3ecc481958c37b505d923,1169,TRUE,2016,847,
f932e26f0b75d6cc307a15575bdd255c,342,TRUE,3485,3143,
b1a97aa7e2840a77d2229c2ff89f1911,274,FALSE,1813,1539,
431328d53e6505f1c9897c7025a5a63a,887,FALSE,1509,622,Dire
0bd0517dc73faf2fec346138bd4b5875,1582,FALSE,2190,608,Dire
9e9523e46b7cf1a3ae931c55e277e7ce,525,TRUE,1580,1055,Radiant
c8104863d734e0e8a78db97a06e7bab7,1301,FALSE,1920,619,Dire
fa1c0283a82438a965bd7c5ac58ed09e,1644,FALSE,2475,831,Dire
1ab771635859abc6562512db0d3efd47,840,FALSE,2507,1667,Dire
81245c203cd4df0786ba290a78be9577,125,FALSE,2659,2534,Dire
d352c9b5cdfd1f4ccbbefd7e2f9a09ac,1735,TRUE,2773,1038,Radiant
a8ba4dab414910ee0def88cafed1a112,2958,TRUE,2996,38,
f96e9b8ca9b35dc34f4d810abf5e952f,1930,TRUE,2542,612,
5bd8187af983992378c8cc3ee1a80b46,1915,FALSE,2732,817,Dire
bd8afcb40ff7ebfd70218951c7908304,27,TRUE,2318,2291,Radiant
79f8cd2ce9005e1393b633499902dcb6,48,TRUE,1689,1641,Radiant
e504dc12ae540cc006a6d8c05c7bf74c,550,TRUE,1483,933,Radiant
3a58fa59971ab9308006f445ddcbb29c,91,FALSE,2915,2824,Dire
5728818eef19e4ef9748c8b784179f1e,1410,FALSE,2975,1565,Dire
1146326f945ddea5d2d8c05ee11c7037,2131,FALSE,2432,301,
fa6f4884341ced41da64c7941077c006,734,FALSE,2029,1295,Dire
204ae75ae8793e5643cbae9601834d7a,2326,TRUE,2583,257,
a4f74778383fd288838d68e2a094a999,2243,TRUE,2350,107,
bb0250891dc012ff1a926f7170e7b3ec,1224,FALSE,2810,1586,Radiant
0840491a3e3d366adc7296b23d827f05,760,TRUE,2431,1671,Radiant
0eaf94362a1d7f862755519d22f19c2c,1105,FALSE,2509,1404,Radiant
09590e1b8f1db2e05106f029dd425922,468,TRUE,1610,1142,
af8ac3cb3c06e20a5c2703fcebe3010b,1061,TRUE,1822,761,Radiant
b816b6ebb062054dd5cc84a54ce30ad2,1674,FALSE,2019,345,
926772f5baab4af9bb82c00198b835a2,1782,TRUE,2132,350,
5c62214b10643e294161a11cae83c2a8,1867,FALSE,2039,172,
c3713eae3ae590ec770daf199032da84,657,FALSE,1904,1247,
7b3cebbb6f9da9c05d0de2fecb64ed45,510,TRUE,2118,1608,
5e88982a0312d9a635908452c433da7f,2332,TRUE,2402,70,
bdbfdb86d788f57abc8e75e6c0af4782,1669,FALSE,1934,265,
032bcc64e32cfbf8f63f0de789b68bd9,1209,FALSE,3162,1953,Dire
48d4b7f9b75b801e0449357e09990700,372,FALSE,2158,1786,Dire
1a653dabf5c9a92dc7bf44d4c8450aad,1410,FALSE,1897,487,Dire
0d4e368391578765011b94d22493fd13,1975,FALSE,2291,316,
a52c3d78b8c99c586e8563313c933947,3479,TRUE,3846,367,
5f4ca28519ea5a9fe330c5073e292125,1770,TRUE,2329,559,Radiant
e57f8a594d15244d91359405be6b2829,2134,FALSE,3459,1325,Radiant
0c5a0afdb472db52497e553c4ba9a438,1147,FALSE,1348,201,Dire
55c5eb677d18f1358f64d8a0754ea628,469,TRUE,2792,2323,Radiant
49a95d81463c840076c4079657fa52f5,2488,FALSE,2697,209,
4448d4eb545f64f77683926968aca293,934,TRUE,1177,243,
25c2d7f732973f57a75c8c86b1b391e8,927,FALSE,1690,763,
d448e236d2f6d4f75935a4c8962f714a,2613,FALSE,2740,127,Dire
045f7d30f53eca78096b034f56263a49,592,TRUE,1963,1371,
6543b3708220b1944757acf12a2f7501,1705,FALSE,3119,1414,Radiant
8973a7f5ad3e2ea8a387e9ea38ee0a39,163,FALSE,1994,1831,Dire
11c2ecca355317edb65e14553bebaf41,972,FALSE,2270,1298,Dire
cd28f27320fc49f49873c6318557c674,400,TRUE,1847,1447,Radiant
aac8a8c4b5c6b20be7be76b5db82df96,2525,FALSE,2743,218,
ae2d62acd4bc9b8cd7383e0c32d8640b,1419,TRUE,2130,711,
fdfb452656e1ec89943ba48fde0d46ad,1783,TRUE,2128,345,Radiant
6f2923a0fa3a29d2e95652fe02aa734c,1360,FALSE,2202,842,
b4fb01bf075147c9d5276e7f1400e8ab,794,FALSE,1802,1008,Radiant
315c1b0bf5526e6eba6c1b0dceb0460d,632,FALSE,3363,2731,Dire
180fb623c701a675a2636207a3071d27,203,TRUE,2859,2656,Radiant
3f64016d8cef3db84b898e85a40aa8c8,713,FALSE,1360,647,Dire
37aeeb3f6610d5a01c89ba9a74f2c2bc,1389,TRUE,2446,1057,
fe8d0f3a02e49cbcc943220f6cbc8b83,1186,FALSE,2571,1385,
72b75a24d44df692e67a3e0dd1f53ad3,1215,FALSE,2124,909,Dire
d78b715728660113560e1d4f0721afeb,1354,FALSE,2444,1090,
b0b0f5961fbbd85a5fbaf26a14f51e70,2267,TRUE,2490,223,Dire
8b5dd72c6168f9c29faf94b433eb52af,263,TRUE,2364,2101,Radiant
d07013e8e075e051b02e2297720f9ee5,2633,TRUE,2904,271,
c3d6c39e4e5805a9cf99d0dc7a610042,849,TRUE,2447,1598,Dire
49dd7416482c818175b5dd199fc99d77,189,FALSE,1840,1651,
3c8f584c3d16812b33a9700a280c1a1e,1700,TRUE,2105,405,Radiant
1772381a54dcef883d58b19f18803671,3039,FALSE,3559,520,Dire
6a72c76b718bcc88ab64796e04540f28,1852,TRUE,2026,174,
a71958a14159571577a41c7c4ba7d2e6,1973,FALSE,2013,40,
0988244bfa9e46ef6ab9e3d14e9e6a1f,1054,TRUE,1476,422,Radiant
f0df3001f0a443f56a1fcac6c903ad8a,1314,TRUE,2078,764,Radiant
6b387b8fc8d7712ffafbfd10ec6ddf82,1902,TRUE,2511,609,
3108601a273e585a92425bfd7b9c94c0,1402,TRUE,1802,400,Dire
f53a8148db1a4280b54c30bd29faf2b5,2023,FALSE,2782,759,Dire
57c75d1b44e2acd33015f05f68c067d3,217,TRUE,2805,2588,Radiant
a7d339657b208d0d2878933f36af5ed0,1574,TRUE,2369,795,
e7c5932b127dea6beabb9e2c97883061,831,FALSE,1933,1102,Dire
b4e34c4b8ef1e900944b1c96403808cf,253,TRUE,3272,3019,Radiant
04f60eed7e3d90c640456a35d33439aa,2180,FALSE,2308,128,
54dc3ae77360aed0f8de2c512f645ebf,200,FALSE,2295,2095,Dire
5270597af1b1f6b7537e7d35d5c0157b,1651,FALSE,2076,425,Dire
3c5c66a2266a300932cd9651b25ec60a,579,TRUE,2527,1948,Radiant
7419e2ad1c580f0ef66c6a316caa0c73,1097,TRUE,2501,1404,Radiant
5bffdeeff23528f0c3aabf3996493fb4,1245,FALSE,1708,463,Radiant
7d5cdad9481e8e69405cf330bc10dd67,894,TRUE,1169,275,
af64f5c61aaeaa2d252db15b7ae0af2a,1062,FALSE,1519,457,
b98a696c261117053ad3a0287e169f60,961,FALSE,3094,2133,Dire
daf78b72dcc3d834c4959691d2d6c855,1435,TRUE,2332,897,Radiant
6b2f657851edb0c10806e5525aa0afea,40,TRUE,2379,2339,Radiant
28df284fae7228e2c0f45e18c9ca5587,517,TRUE,2044,1527,
98c2582d98dd4f0a946d004a601d9b3a,394,FALSE,1855,1461,
75a6d37c37d11d50ea6556347fff2509,2347,TRUE,2753,406,Radiant
e9011ce8d3d1a70adc4b789a056a3e82,2070,TRUE,2188,118,
976ff006c596b0faa09db24b210c503c,62,FALSE,2719,2657,Dire
fabc8c6a56c38afac75aefb5b5b3de87,843,FALSE,2752,1909,Radiant
60ad3d9cbc5dbe004b93b6884c687651,1421,TRUE,2167,746,Radiant
8790245b253436ac4b73f61d821f8506,145,TRUE,2085,1940,Radiant
fbf3f24fed34760faec939642f904c2e,443,FALSE,2931,2488,Radiant
abf83d9b7cceee6d4b2df25004d7e11e,1327,FALSE,4072,2745,Radiant
1cf9b4fbf21c3c329d8326b1285b6b8a,2405,TRUE,2851,446,Radiant
c34be8e42cc3e5f5d858838818792878,794,TRUE,2134,1340,Radiant
4315a550b5734ee9e3b08afefc459aa0,45,TRUE,3194,3149,Radiant
be0f00a5676db03a42488bca11ffb561,2443,TRUE,3247,804,Dire
8939c022bc678ee830c5c7569b7329c2,1403,TRUE,2327,924,
cebea2540ab934ef4725a21ec7859669,1682,TRUE,2067,385,Radiant
88dfc6e70a0fc9d59c6a40367a592bf7,1667,FALSE,2311,644,Dire
e73f00370c1f6b5c1afa957c3031f192,14,FALSE,1595,1581,
0f795b4191f8bbd3e4def16c59bf9c60,274,FALSE,1252,978,
73959fa4f25c0f446a16efd445ee6630,2338,TRUE,2933,595,Radiant
2cf4732e6e810549b07f155b16df2960,2713,FALSE,3951,1238,Radiant
3c65e981ee075db59c47cd8665479312,327,FALSE,2194,1867,Dire
09f6e56f0649f3918e7cfd556ab2d869,325,FALSE,2542,2217,Dire
3f69ab79b4bc14ee8aa47e141739851c,1902,TRUE,2867,965,Radiant
df4f27ca130a81584fcd833041052446,889,TRUE,2216,1327,Radiant
c327a208a82bfa20b6b2316341cbd118,1359,FALSE,2160,801,Dire
d317931286bb4106d72bf23da5db832f,2153,TRUE,2258,105,
0ebbf523c08e8be19ca2c1b12406cc2e,236,TRUE,2219,1983,Radiant
2cac9e2e4b1c7a799eba7ff085a746c0,855,TRUE,1913,1058,
5e8d187076c059bd570fe2713229ea2e,454,FALSE,2552,2098,Dire
e4fbeeabc70499ad8ce481edcd1ffd52,904,TRUE,3455,2551,Radiant
a9b7c78de418103a442229f171938e14,493,FALSE,2387,1894,Dire
08bcd6f4ab8804f91a7acd8b5da5782e,1858,TRUE,2642,784,Radiant
eab3c9bddd8fdc0fa70ecff001430426,1662,TRUE,2495,833,Radiant
43a948dc3084a384258c21beafa2ae71,812,TRUE,2090,1278,Radiant
16779e1c5afdb51dfb74678699385a7e,17,FALSE,2494,2477,Dire
bf8374d14712cdb570dd67c3139df7f6,1079,TRUE,2471,1392,Radiant
d0077959753c821c3b3fcdf000856a25,625,TRUE,1988,1363,
3564c3bc0bf653d996ca25fe9074481e,1603,TRUE,2005,402,Radiant
8a7d96fecb952cf9d981b60527abf19d,1831,TRUE,2182,351,
86b7ad54ecf3559459ef0f4f9e48f5b8,1408,FALSE,2364,956,Dire
dc468993a8521381a66d09806fd79779,2084,TRUE,2166,82,
62c90b337384976229290a4f9f4bb774,2103,TRUE,3119,1016,Radiant
d312241e21860eeb12f878219df9a855,373,TRUE,1756,1383,Dire
ab6cf47d6e00bfd179f651753c432a10,1174,TRUE,1612,438,Radiant
c36199dc66a1ec6428c3f3d786feb831,1159,TRUE,1308,149,
df3207a6f0778337384b10ccf574c4b1,2054,TRUE,2465,411,Dire
855201722ae0b1c10d76979e6e965335,8,TRUE,1716,1708,Radiant
35250574e04aae0a39df4e09701f2eec,984,FALSE,2473,1489,
11325fadc2bb7274f5df0eafab2f4944,265,TRUE,1045,780,
022052f1c2307779534a22c945abcacd,2356,TRUE,2730,374,Dire
c956c9cff71c555d70fcf030b33d31b0,62,TRUE,3041,2979,Radiant
4dc902c6bc70af8182ab95e302cb28d8,1118,FALSE,2653,1535,Dire
1818b3afa67224e4872a745521fa6cb3,406,FALSE,2320,1914,
61697dcda20d9e4d6c49267375aa6adc,276,FALSE,2012,1736,Dire
8b4156fd2adb90ed09d11244fbc341c0,1279,TRUE,1823,544,Radiant
9eaf1f99041839b5ce7759853a4f554f,275,TRUE,3335,3060,Radiant
1b758bae764e241618bca68fb119d313,1830,FALSE,1899,69,
604939cb8d1c2e822325f9e06b0cd6aa,501,FALSE,2308,1807,Dire
0fcca869e139dc6b6740aa66cb3cb1b4,685,FALSE,1907,1222,
3352380bed47321f88929952ba17ae3f,2231,TRUE,3044,813,Radiant
ce36504888b1dcbab8f6cd218a9052ea,299,TRUE,2435,2136,Radiant
ef4092b3083d1f9109dc9ad8a8951a17,471,FALSE,2966,2495,Radiant
49b086346133daa2ad05c797d08dce8e,1242,TRUE,2732,1490,Dire
218f52a4140820e1b5a88413e7aa1727,51,TRUE,2642,2591,Radiant
8439079cc1fe9974493858e8ee255c7f,630,FALSE,2038,1408,Dire
f2511ddfd36a24e19f9e37a33be41687,2173,TRUE,2246,73,
832bccdb10276dcbfc91f9bae44fb5f9,243,TRUE,2483,2240,
119545c4fba7cf3861cb6a3519b6d30f,441,TRUE,2448,2007,Radiant
8db00c302f42685837090c5e10030ebd,1778,TRUE,1867,89,
13e2b6ff7ecee5f37375efa168207146,1979,TRUE,2521,542,Radiant
dea5a989dc974e6770324ae0b50486b8,1872,FALSE,2342,470,Dire
05beaf9f29404075b137bd842ff8d877,483,FALSE,1920,1437,
67b65c3dff45eceaa3ba34201591e9c8,1317,FALSE,2082,765,Dire
86ad943dfb0c90126b5523e4b1fcd4cf,1282,TRUE,2243,961,Dire
48d5cdc2ae68cb9c77cb833f8ecf94f5,586,FALSE,2669,2083,Dire
0c9621a7d5a477f850e8ac8576d815f4,1045,FALSE,1470,425,
c1da25f3ebc12a8b84af072f660a3afa,219,TRUE,1875,1656,Radiant
f31ced5f6af49d2a3cb71d1674673cdd,403,TRUE,2758,2355,Radiant
58595bdd660f01ed85b5d244cefa3d78,1399,TRUE,3704,2305,Radiant
bb1d5302f7278271decd3ee42dfba469,664,TRUE,2201,1537,Radiant
c687d78218f1cd205b8087c15dd1671d,1323,TRUE,2134,811,Radiant
34753c8132c1f0cbd8a73b926953ed4b,1243,FALSE,3254,2011,Radiant
8de73922b47f03d5023ae2e54b4bae3a,346,FALSE,2308,1962,Dire
abf6f045f6fda72d15814e8c1621f9fb,969,TRUE,2322,1353,Radiant
4ed09e0015a3093e98fcb0cdc8e6ceb2,4424,TRUE,4576,152,
592951d7b3579621bcc8814a82a5a348,1195,FALSE,1448,253,Radiant
39843f7644260836a797107c530e1030,1038,TRUE,2556,1518,
16e3b1bbd14768ed2ec1824fc60056e1,1358,FALSE,2168,810,Dire
ef5aa1dc54a34b8e1e17cd7baf7e5d06,1427,TRUE,2104,677,Radiant
670382732bd7fcf523786dfc64428f9e,1669,FALSE,3258,1589,Radiant
80cea3ccdd804d51f1fb158a53c0b0b3,1018,FALSE,2075,1057,
78a60fd5d4f6e1f7d3cbcccf3eaa71d1,1804,FALSE,3953,2149,Radiant
69e27aea9f29430eaf738aab6c79de4b,281,TRUE,3049,2768,Dire
87acecd07b504f5403491d38203b8ec9,2741,FALSE,4941,2200,Dire
220e66d0b9a0e7a2ef472e07c50c7b13,55,TRUE,2123,2068,
380ee04cf9e2298fb5431dc55ba174eb,703,FALSE,1480,777,
4e110441063fdcb44473c1fed414fbe7,1215,TRUE,1799,584,Radiant
238c3f63281ca4d627f65733bbf1ed01,374,TRUE,982,608,
dcb605366ea747f6cd97d99bf7097707,2414,FALSE,3629,1215,Radiant
27805f9316c1e06550935830d728d6b2,1005,FALSE,1584,579,
b8fec0001e25fa300bcd9cdbbdce24a4,1571,TRUE,3171,1600,
696a56ef9cc8363ca4f4ab77fc6ec8ca,691,FALSE,3240,2549,Radiant
c1eef51f7dbf542ca9f808444bbfc84b,636,FALSE,3116,2480,Dire
50c09364b6f33c38cc3e2c074281accd,1506,TRUE,2184,678,
02cafc3c90c34100cea408a6036df3da,2153,FALSE,2683,530,Dire
b9414c4c9a75a49d3c809440e401de72,1100,TRUE,1371,271,
81bd9d0a10c8aaaf3f3df680a0c09e42,731,TRUE,2901,2170,Dire
dbfda3c9ff0c4f067f999346437cf428,2162,TRUE,2229,67,
940dd0ab9595949b6a95661b9ec80b46,322,FALSE,3208,2886,Radiant
5612a1c0f08cc556864aa5fb567870d3,2208,FALSE,2777,569,
cb9ebb8d12b3463425cb9a476a287240,260,TRUE,1479,1219,Radiant
f8fc6d1cc2db30d4ea1b5bf2ae1c87bc,351,FALSE,1815,1464,Dire
558df91290184c093d2e3485ff15bfb7,452,FALSE,2821,2369,Dire
973380fa01f8956954951ce9be592f79,1018,TRUE,1862,844,
ad1a78b800bb23fbc9ee3e815b311ddf,496,FALSE,3889,3393,Radiant
ae75b88407a5723d4a47bdeeb860af2b,823,FALSE,2514,1691,Dire
b5d8869aae0330d47b094d5b7a353528,980,FALSE,1593,613,
2b858b7bbfe59fdb5336575ac8975eca,2401,TRUE,2836,435,Radiant
d8c56aa355a3069b1c5e10302159ad56,972,TRUE,3225,2253,Radiant
a0670f0783d5db7491268ac13207ebd6,366,FALSE,1188,822,Dire
faf45dc2632be6b2353d5c9e2132cd39,1594,TRUE,1936,342,
357f486d095b9f1681b92de8af8b67db,191,FALSE,2496,2305,Dire
e0fa319200b29cdac65b2c79a29e0f83,1748,TRUE,4531,2783,Dire
76ef9da4f1f60d1c3164686a79a098c4,477,TRUE,2084,1607,Dire
901482d423f3309ccf7939be0c08562b,306,TRUE,2091,1785,
175666bc242c3ebd66f5827488579510,632,TRUE,2613,1981,Radiant
b0231fd251ff9b2001721e24ceb74a27,1608,TRUE,2112,504,
c305e61beb630d18d199d869f665f0aa,312,TRUE,1511,1199,
8fb7392575e94e8c3ee3d6abcf4aa55f,673,FALSE,2571,1898,
f448df37884c5fd95fccf8b465c427de,2482,FALSE,2578,96,
fd3368fd96192212df1c2e8a2ae3d4c3,772,FALSE,2724,1952,Dire
3fc5f0db5fbc91307b95cd1ef898a684,1510,TRUE,2000,490,
e56d626a09bd548d1fed67befcc4b570,529,FALSE,3385,2856,Dire
536b6c31307470adab7bf6c537ff1ab1,679,TRUE,1214,535,
20d0e65925b9851781015fbddcd88d46,1802,FALSE,3945,2143,Dire
5012d904dc31ce7e4e5a68945bd2b290,1863,TRUE,2546,683,
31606bfd202fbbe90c7c7b967ab6c953,1870,TRUE,1907,37,
9d16c0103ccdcb0186e0706826b5c320,3996,FALSE,4415,419,Dire
7a3be22ac4c5deb1dae49d56e0182462,280,TRUE,1556,1276,Radiant
6dda12fe16b646a21155ace787a44832,1418,FALSE,3364,1946,Radiant
670f1693531e520833a2c907c869556f,453,TRUE,1574,1121,
2907356ff490ecf79007cc9bf2ebc9bd,1617,FALSE,1920,303,
f1d96062c1d0e161d64827378b26937e,246,TRUE,2406,2160,Dire
e2e8998245bca588e41b6cc1fe17b390,1063,TRUE,1273,210,
64b9983b3132048f9047a2824345c15e,2082,FALSE,2474,392,Dire
0c66247d0d075350b39c0a6f6717aab3,2113,FALSE,2254,141,
2eb4af92bf07a3f4593d9616cccf3341,226,FALSE,2516,2290,Radiant
d3282591bdb6b65504682eb504e1b902,1969,TRUE,2036,67,
8f96c40350e0114a5b5662a52dcdb455,26,FALSE,2591,2565,Dire
fc0ca2067d0c92452992df59813846a5,524,TRUE,2395,1871,Radiant
fdb2f5f0ab90110c0a3383cb79d2b7df,71,TRUE,3894,3823,Dire
178f91875f7f596863fe186bb4ba683f,1619,TRUE,1711,92,
e5bc576561d6f35ca420dc24b7facded,150,TRUE,1378,1228,Radiant
4caafc873e1dde208ebe1b64a9a49c20,642,TRUE,1865,1223,Radiant
c9f53a8d9b504abb6ac9cef9ff4c6be5,1314,TRUE,1789,475,
8ec3951785093c2d07f320befdf1d8c8,1743,FALSE,3925,2182,Dire
b15776045b7df33bea96e05fff4d878c,163,TRUE,3690,3527,Radiant
b9bd0cd0bdd6f519069fba7c02003cfb,549,TRUE,2987,2438,Radiant
bce47bbb8691e9a2f1576ce85e3ef70c,626,FALSE,2762,2136,Dire
ffbcee4d8d3bc146525e94426ed89cc9,1865,FALSE,2356,491,Dire
7f62d31691e1eebb000ac0841f31c8b4,342,FALSE,1634,1292,Dire
d6f77644c6be3a5ed8ed33fa406f76da,883,FALSE,1855,972,Dire
4228ea0474ec70664010fe32b5d38ef4,182,FALSE,1455,1273,Dire
5e87a67c9d0ccd2fed5d78ba6e33615e,3056,FALSE,3199,143,
23c82af9b727c960cff55799af64615e,71,FALSE,1620,1549,Radiant
0996523dcba40ea394553f203b18f451,1262,FALSE,2496,1234,Dire
8e41482b016f54a60d3e1c494bcd2696,593,TRUE,2306,1713,Dire
b844b15dd0911f4121867caba9e73adf,95,TRUE,1845,1750,Radiant
315377b46dad6362e38eb46bacdbe049,1997,FALSE,3146,1149,Dire
df736ff71af6386c8dc2f7d482b15072,493,TRUE,1370,877,
b7e2d78ef1c4e6e0cd41b43e8a12e0fb,395,FALSE,2808,2413,Dire
37aef45612a3c9b221ab835656b2b53c,1946,TRUE,2460,514,
fd32cabd1076465c05bc48af9cc6e217,1052,TRUE,1816,764,Dire
f1e7546c92aa37f01eb7b92ffe4db09e,293,TRUE,2434,2141,Radiant
187748988eefeb11a28d510dd41a61e4,1360,FALSE,3692,2332,Dire
d99ab7b2c5927450de1a663de3a942c0,89,FALSE,2600,2511,Radiant
f04a2df4b1f6b17bd23107d4c21f15c4,191,TRUE,2198,2007,Radiant
c76f20b2b8d6e5950a62087e8d0a6901,3983,FALSE,4776,793,Radiant
3c055a2d5fa4980dd6b9bce6ca9b992c,1007,TRUE,2480,1473,Radiant
4436f9d06d59f076b5dfd91f4452ad3c,400,TRUE,1495,1095,Dire
45d0970c43ed53efff673983c08de570,1202,TRUE,2300,1098,
e45289f6f62495fdfecc0b894b01dbcf,1074,TRUE,3106,2032,Dire
2451c446079f7cddf3928b4e3858509c,1072,FALSE,1655,583,Dire
c369d1ac473a08cde6249f5c1deb7d6f,1687,TRUE,2392,705,Radiant
205cd47dc6a75b7dfd04328808626c8b,510,FALSE,2303,1793,Dire
32565c27747ef2a464b22a2dc9d6b497,1006,FALSE,2190,1184,
2f482ae252e8046ba80bd8595daf736c,576,FALSE,2131,1555,
0080cf7fc113814c984a18007d5260c1,728,TRUE,1799,1071,Radiant
e052d689e6acaf002da4d30427eb349d,1293,FALSE,2926,1633,Radiant
e65a0eae10c6cb2d95c81a138faa7e03,736,TRUE,1876,1140,Radiant
e9b8bb76441a004c382cbadf88415ea9,1893,FALSE,2547,654,Dire
5b8e5da2d9e3f85d4ae349fa00ae72e2,923,FALSE,2015,1092,Dire
4838b5fe1974520998cec401e735d29d,637,FALSE,1501,864,Dire
e619c7054e1e4be89cb54ffcced124ba,1681,FALSE,2742,1061,
743a55859ef0be0fff79d596a0ee9cb9,1240,TRUE,2668,1428,Radiant
297296a75eaae6084d40ee82a9756a1b,660,FALSE,2455,1795,Dire
849a3a172e3432947945e0bc11de8369,564,FALSE,3043,2479,Dire
d6c9da9018c5032d535da21066c1bd7b,2697,TRUE,2769,72,
f74687116d1e434ec20780003bbde8f3,2118,TRUE,2638,520,Radiant
11c8847db9ec2338f197a397a3b6f43f,19,TRUE,3995,3976,Radiant
b235760956aa8318f7c9bd3938511329,1376,FALSE,1936,560,
ebe079e33aa635f96d98f58b022fa72e,358,TRUE,1749,1391,
1c5b1b83529f797a59b37413aeafd1e7,2075,FALSE,2671,596,Dire
0cc6e10c5595da043660a3777d92e0bf,586,FALSE,920,334,
d354be25469dfe9b591e7cd85c1baa9e,3361,FALSE,3452,91,Dire
5f9bf1ebb871309ca1a26ecdac06bd69,671,TRUE,2567,1896,
aa0d64bcea8dcfb674f2d340c239a2a9,597,TRUE,1728,1131,
115a310fea76e93c83e81ac691ccb57d,2142,TRUE,2564,422,
d8e8b1fa5af9a75a05ab98a5ebdd589d,2311,TRUE,2433,122,Radiant
98f72b2bec75b9475a599cd8d13c063d,591,FALSE,1833,1242,
040d06b6fe6c38bd0a259604939a66e8,2524,FALSE,2816,292,
c2a6b1f3f54dffb7300aeb1a62664714,122,TRUE,1657,1535,
c1e63bf1969e5e23909d27e1451415e0,1207,TRUE,2487,1280,Radiant
f90cb3d8ad1080cae1f13385182ecbd6,255,TRUE,2375,2120,Radiant
66b0d561ef429d439dc1ad7c231a252c,896,FALSE,3796,2900,Dire
c64d09ee450bc2de10746fab883265ef,557,FALSE,1989,1432,Radiant
d281a6f8bac8d7c38cb2caaaefda6d40,383,FALSE,2448,2065,
d2522b9719c789cc14df4dcfa41ca577,721,FALSE,2753,2032,Radiant
f4e49726be80e0da6c429172e42baaa7,725,TRUE,951,226,
4c2b9181809c8efbdb747334fdb8df3d,1107,TRUE,3401,2294,Dire
c6ec8f8d25877246a35bcfe569e2c52a,206,TRUE,2469,2263,Dire
fa13315eadb4bacabcdb848d0eb221e3,1095,FALSE,3151,2056,Dire
ec2281ab3a571a172690e7c30b2713c7,1388,TRUE,1926,538,
a7dd3b138945be644092876d91aaf82d,1171,TRUE,1506,335,Radiant
2c1b7a10241eca1449914b824810080b,1860,TRUE,2566,706,Radiant
f273e67eb02e527f3e7132ca931ae056,1875,TRUE,2014,139,
ed28c0fd239572131a0080d1c612e39a,351,FALSE,1877,1526,
dac0c15904dd1063e011cb7d7bf9afe4,432,TRUE,2204,1772,Dire
c65405b3f1e70804090e498a7cfbd833,1147,FALSE,3748,2601,Radiant
0e39019565097a00181d2e79eecbf35b,1599,FALSE,2692,1093,Dire
d04f53bb45c8219b16b6d7489b749809,3694,TRUE,3982,288,
2151ad4d1d8c40d5b0b926dd023e7dd6,2414,FALSE,2596,182,Dire
0a495bab068b82f8ba116904a8f4f92e,1753,FALSE,2704,951,Dire
882ea4d5d285e11fef26dc07ebb2f1ca,1840,FALSE,1994,154,Radiant
dd7a55b2201c353a21ab66a3181870ab,3056,TRUE,3135,79,
0f8a78d058b1988dfb4dc26ee0f7a833,2295,FALSE,3539,1244,Radiant
6a312c56ec75f851a839b6fd74c02c51,21,TRUE,1625,1604,Radiant
90f779d7fcb777549c983aa5f1fabe14,1434,TRUE,2712,1278,Radiant
17d1e838d6fa6c76b03f128874405b25,1520,TRUE,1943,423,Radiant
7269345334d855eda5fd4ed4ccb7d3e2,1632,FALSE,2509,877,Radiant
11156840283e83c91913b4e34d567d1f,715,FALSE,3291,2576,Dire
bae22f58932cad77883fcfd493ecb3b2,2249,TRUE,2511,262,Radiant
e7a925c40a66c23a5263322457b39899,2485,TRUE,3600,1115,Radiant
254b8359bf032cda9861033e7f83559e,1153,TRUE,3296,2143,Radiant
ea2e0ab08ffff718d13a2efab2239e08,227,TRUE,1723,1496,Radiant
6992140d8ab2a15716474752b93401af,865,FALSE,2460,1595,Dire
06c78c978c33491e583a0d1429b6f434,55,TRUE,1468,1413,Dire
ce63a057fdc3db04c04775d6aa304ef4,1618,TRUE,2502,884,Dire
a0dfc63ab5999453d07bdc64f2867e12,1368,TRUE,1455,87,
4da17693fad5a323bea33ab3f317fdaf,2153,TRUE,2699,546,
5a3da6703c51e8ce43ec96f1096ed5c0,105,TRUE,2206,2101,
4e7dde296b75b411746cd8d316108dac,1594,FALSE,2243,649,Dire
2f9aaa45c1fac6d2a99cb1acf1c4d9e0,1014,TRUE,2502,1488,Radiant
bb51345147995a7ae3eb15852d05a63a,1176,FALSE,2587,1411,Dire
48c3ed09ba0b44c5bd2d7c606e1fbccd,692,TRUE,2196,1504,Radiant
63e69769b6978ab5134c735153315156,1474,FALSE,2146,672,
3058bafc40b4c847cb60ac8801bad6f1,694,TRUE,2584,1890,Radiant
86e8991df3fa8b1f5fc79fd4676bc1ce,2231,TRUE,2285,54,
ac5fde5c642b2b1f7953ae7d634098c8,234,FALSE,2505,2271,Dire
6abe16ef36c844e78452db8e404381fc,2576,FALSE,3123,547,
91e345f1258e969055bb30c5e70602c7,1817,FALSE,2157,340,
1224c7328d7f694e0a6b407249cd0e07,2210,TRUE,3207,997,Radiant
b501b0377f0270d516d10e5e14324427,680,FALSE,1302,622,
44a83a5366a021c75c8508df199704e5,3014,FALSE,3277,263,Radiant
85b335513ed1a572eb2073df3bfa7552,1057,TRUE,3598,2541,Dire
3dcbcf45676663368ad931d2a321b1de,691,FALSE,1476,785,
133ba01f1b65326338fb0650064a6205,979,TRUE,2513,1534,Radiant
865dfac002706fe85d3e68ed12b653f3,817,FALSE,1315,498,
14d6c690870f2b7d72725da0559e2a8e,1040,FALSE,2963,1923,Dire
897d43d5385bc5f55146b15e43ccc17a,1645,TRUE,1697,52,
1d3081db87e7d56199f3e578b5fa4e21,1010,FALSE,2015,1005,
a9140ac7dc8e9395b45ac1e990e8ce46,1498,FALSE,2968,1470,Dire
892b8a9da960defa8ba9cf35e330d4ff,861,FALSE,3311,2450,Dire
6c5fcec6fd0754a9d785ca8947a22c05,1083,TRUE,2299,1216,Radiant
4d3d1734dca2407afd1b06ae3980f020,528,TRUE,2250,1722,Radiant
9c137ea5883ea8cccf7006d16a2cd9af,745,TRUE,1536,791,Radiant
93cbf5cf746002aa94177f5dabe23407,50,FALSE,1682,1632,Dire
31c4e2f53e547f8148cf9581f2fad0bb,541,FALSE,1211,670,
dcc1c66035a165b7b5ef715de97358be,418,FALSE,1641,1223,
00e9af0e83db9f7d51492a0d6c3ca02f,1648,TRUE,2750,1102,Radiant
4e93074caa5e365553ad07307c8b4760,731,TRUE,1853,1122,
03b8a063cc84f4eda509b927720e38ba,677,TRUE,2327,1650,Radiant
bf94b0a37a7787ce416807dfebdb8ced,60,TRUE,1688,1628,Radiant
2d7a4b01fa767abdb6e21a1adaae194f,225,TRUE,1722,1497,
437386d2614fdaef7f58e35f43571ab9,450,FALSE,1757,1307,Dire
b84a879a449ec8c97151e3b738d3f777,1488,FALSE,2215,727,
c2106e1f6bdfdab3361c43bf3fbe14b3,244,TRUE,2319,2075,
47bd8f6aace15b77f440d8146759818b,408,TRUE,2254,1846,
1ee26a522319a9fb68b05b76fb4128c0,1335,FALSE,2682,1347,Dire
913b4b52a1dc16dd2600ed1074134250,552,TRUE,2010,1458,Radiant
02fe8504ec2784b9635eb70abd98b975,187,TRUE,2629,2442,Radiant
ceda6ce5ca815de238807ccd501d90bb,579,TRUE,2095,1516,Radiant
2ffd4c60bbeced92aae06022f2a5005a,558,FALSE,3163,2605,Dire
328f94fe95b5e3cf8c8077ceeb57c3da,132,FALSE,1716,1584,Dire
87169e0052a98e224c6876840fe3c11e,2308,FALSE,3845,1537,Radiant
cd8c984f1f94b5b05470521f517f2f2a,397,FALSE,2898,2501,Radiant
bb003a44515bb6194e47a57ab560414e,999,FALSE,2024,1025,Dire
5a2a5f17936bc90b43babc98f005d73e,2198,TRUE,2603,405,Radiant
42ea8f5e7b7b03d84528ac0684700471,1425,FALSE,1888,463,Dire
ee8f3653f12fc2eec1dfc79d00927915,196,FALSE,2209,2013,Dire
5786f89b93b99a67fd5c8af8328f1b67,52,FALSE,3492,3440,Dire
7a3410b138d33979207a6d42199a66eb,1793,TRUE,2907,1114,Radiant
1d7f6a14fe8c63652decb002082f7533,3336,TRUE,3437,101,
8fdb94a6b4767b9507b5fe66eb1b8ae3,1432,FALSE,1527,95,
9cf6074015ab2e1331ee374ddc1899e5,498,FALSE,1268,770,Dire
8952edbe371493b63f779207f985f60c,11,FALSE,2308,2297,
5f512dccc0049b7993edcc56fe01664e,820,TRUE,2525,1705,Radiant
659a31201e240310a4308194cb4908d1,2213,FALSE,2782,569,
d4641855313514d7eaa528c74d5ba688,368,TRUE,1955,1587,Radiant
a8ae84dcaac045d56f98015091a13530,1766,TRUE,3480,1714,Dire
8dfb158ebde6fab6e4a5483d860ac47f,1837,TRUE,2041,204,
c1a7b16b4241ceb7e4de722acdad169e,1746,FALSE,2343,597,
ac5d49acb24b38bbe7858bc3a320b5e6,1361,TRUE,1931,570,Radiant
af630f8b3d2cabf626075650daed9e49,165,TRUE,1310,1145,
4e05e62e654512bdfe8617cc6a617256,46,TRUE,2923,2877,Radiant
e998a523d726c861d121f90fb81296cf,554,FALSE,2530,1976,Dire
4a66435c72b3f7f3527f16f4f4919d6d,981,TRUE,1131,150,
a1e82340dfba80f161a74cc11608aebf,944,TRUE,2611,1667,Radiant
e4825ab2e2e273b779b0f0074b5d9ad8,696,TRUE,2811,2115,Dire
cbc625c017ee3712176121cb767aa6c6,1643,FALSE,3282,1639,Radiant
750a2f1bb352a4a5ad5b20e3d485f7e4,1525,FALSE,2516,991,Dire
93856a750aac283f5dee720d5940f6ac,1915,TRUE,2150,235,
6a8432b9603f7a894319f851a7587b90,645,TRUE,1653,1008,
e2cd6187fadff7124fbb46f8fdde54d0,1899,FALSE,2373,474,
6df1ee839fe89ef94bda129975db880b,202,TRUE,1728,1526,
c6172814b51f54ff0edaccfb86618664,475,TRUE,2091,1616,
714acd63786425d13ac4d6876ee9197b,2707,TRUE,3498,791,
6cb5d130b4d125177bc4160dadd08513,1697,TRUE,1912,215,Radiant
237cd9af975b7906ec1ff9641c9ab6bb,1170,TRUE,2212,1042,
5e796e94603a630c1bd7cdc469f9fc1f,342,TRUE,2201,1859,Dire
4ed2d137564080ac3ef0c8911c209bf4,1875,TRUE,2836,961,Radiant
4b04094fb2429d30e42b29c6716bcc9e,2772,TRUE,3292,520,Radiant
97a7a69a19eaf9c7460c57c74172d105,149,TRUE,1212,1063,Radiant
2d4ab643ff8bb44ec6f8d940b56bde92,1038,FALSE,2734,1696,Dire
4acddd5b982a9ca869245320ca555cc4,941,FALSE,2840,1899,Radiant
b501d3c6a71c475be687b47e0c53f591,226,TRUE,1938,1712,
b165ab98deef6ea9499e92050f408486,439,FALSE,1710,1271,
8d50695967712b5427085bc61a2a1cd0,1721,TRUE,1963,242,
8df83a345c8c3d2a5b8ead8f092581f6,1195,FALSE,1917,722,
d7d971d36d12d98e6a373d488dde5f8c,3662,FALSE,4147,485,
6748a42ece64fbfecbdf9da6d9c9dd59,582,TRUE,1938,1356,Radiant
f48bdc507507bde81eb5cfeab6d22fa0,21,TRUE,2370,2349,Radiant
1297b8557bdb662b6f0cd591d1162431,2302,TRUE,3164,862,Radiant
d6a72eb4990303b4863eb84cf9fb9ec9,72,TRUE,1700,1628,
aa7221b6a1f8867fce89814bd1324d28,1404,TRUE,1694,290,Radiant
ce40966b52933e53771186544bac5cff,1117,FALSE,1531,414,Dire
869cf7138e8b7627463f8f5b01b94f74,1752,FALSE,1887,135,
03a9ae20d74ff3b13aec9cdbf53fa488,832,FALSE,2559,1727,Dire
ea81e68712b819caa93ba611d9c04188,279,TRUE,1255,976,
5c033ffa5d467e321114350b0342ea66,1714,TRUE,2726,1012,Radiant
4e0718df040526de9b6b4a3a82ba0a89,1179,TRUE,2494,1315,Radiant
cb65525dced52fbd1ff2005706e1721f,1203,FALSE,2833,1630,Dire
dfa3507f86ebac876ff406456101a970,1171,FALSE,1566,395,Dire
63b6b0a37cbf35ab3c5a51ba2e30139d,711,FALSE,1659,948,Dire
85e3c822fd5b50124f1da9df29d46006,2030,TRUE,2547,517,Radiant
40cc94736faf1fde43299e73e45ab66a,1920,FALSE,1990,70,
a265c2fa81d8414b38a799e154610cfe,813,TRUE,1737,924,
b5f10e860d00ef0bdc830179f4e99a12,983,FALSE,2339,1356,Dire
b507ec8ea39cbfb1f44bc9395adcde25,285,TRUE,1836,1551,
e0af105bb5b1206dafeb1894c389814e,521,FALSE,1770,1249,
7e04b8dd928aba11de173c5fb57866ab,1283,TRUE,1514,231,
0ef7a69e33a44836aaada0f1e58f19a1,313,TRUE,3187,2874,Radiant
4fd2a883f709bdca44f13e03fbd2c320,484,FALSE,1388,904,Dire
18f2669576ebc7ca7efa3938d30f6c7e,484,FALSE,997,513,
3f8b7c9a25c8d2c56349a01241aa15ad,1202,FALSE,2605,1403,
d32fc0ec92ccc8701d25271beb7a52ce,858,TRUE,2654,1796,Radiant
9a7c752688d85aebf6863fc2de64e858,47,TRUE,2936,2889,Radiant
46e56009f0f666899a4d56299a9682c1,365,TRUE,1453,1088,Radiant
fc755f526f2b0a4f0af0dd67dd44d828,782,TRUE,1916,1134,Radiant
fee8c368a26e8a03017974d0cbdedca8,224,FALSE,1665,1441,Dire
d28dbc71c97a0f04350c33f4b2aff3c1,83,TRUE,2241,2158,Radiant
3f8e7bcc7268bf382456f5288e405fa3,3553,TRUE,4253,700,Radiant
a4bb6f608fd16c367decaa5a9711bf78,4272,FALSE,4605,333,Dire
1d3859d1cf50b9a6fb40e40bda2cf268,1353,TRUE,3118,1765,Radiant
6e6b1f9dce1b0bd247699cdac9ce1d95,604,TRUE,974,370,Radiant
31a157788a56e47f9ccf3b8c6595137c,1506,FALSE,2102,596,
b9c5259daa99e84b5edfdeacba793aef,1119,FALSE,2168,1049,Dire
49150ff82cf0e862692d8a98bc64f764,402,FALSE,1494,1092,
9c2efc2282a8c3f10f577409f6b65bd2,482,TRUE,2896,2414,
617f7c954a05a839cb24d5eb066268a2,829,FALSE,1388,559,Dire
e1e151c73019031378e832e2d6f8de5c,1868,FALSE,2267,399,Dire
ada7d41c7b7b15bac71ed10478c72761,2237,TRUE,2909,672,
a763a1aa9efbac3a794d910e1b8445b5,2064,TRUE,2218,154,
a9b14138f7ca22640478b3c9b26cb83c,610,FALSE,1756,1146,Dire
0f53e8de744ab9d1b3d5021d0f14aa4c,150,FALSE,1996,1846,
bd2be9754f5ca0e4ec1b5848a2b5e09a,751,FALSE,4089,3338,Radiant
dd8bc73080596a962785b73e0edea447,1236,FALSE,1819,583,
adbf6b084105b5d7b392707c9269e766,926,FALSE,1879,953,
b34c55cbbfff3f0e6a65551a411cd9aa,343,FALSE,2496,2153,Dire
2da4b35c6b2b926a26ad090231becf9f,2454,TRUE,2912,458,Radiant
7c80871d3ef89247513b411bd1f09b24,2085,FALSE,3295,1210,Radiant
73afe1f54242e92a4a5b7fd776aff953,406,TRUE,2869,2463,
6b6344ed0aa3d3b21c10c18ebbadf704,1041,FALSE,2157,1116,Dire
e7ab3b619eba92bf5a37bbf24704688e,841,TRUE,2225,1384,
544d3843331479cf83175d8d5782a4e1,619,TRUE,1615,996,
d8648ceae60b6ef2c35cda7b06d28ade,304,TRUE,1096,792,
bcf1be2c74ec7bc1c0e1252494a451c3,436,FALSE,1721,1285,
9db8778a31db64354bd820791b504b9a,750,TRUE,2775,2025,Dire
a8a010112840d3046c30654bdd52db6c,752,FALSE,1713,961,Dire
0b12b8ff1b61f47c50ce26cb64b51760,459,TRUE,1800,1341,Radiant
85798938c39ee2663a4a7649bbb01892,663,FALSE,3758,3095,Radiant
497fcc3427ed9cb8ec5489c494cef51a,2543,TRUE,4559,2016,Radiant
c507f7a34dc5e550964abb1570ba34b0,996,TRUE,2153,1157,Radiant
9ff266826ed21e353a236113923836f1,946,TRUE,2618,1672,Radiant
48b68e59e662765cf886a74776230f40,386,TRUE,2348,1962,Radiant
deffe9881777f82ee35436aeb89655a6,166,TRUE,2328,2162,Radiant
5a4106997d554eb39a83fc1c66e37b44,1114,TRUE,1472,358,
fea7396bc119c0146a2857788c16aa9c,265,FALSE,1776,1511,Dire
330a6d42c86a1a24b4c62f39ba3cf2f2,911,FALSE,1525,614,Dire
205d13c07abdf3dad5f598ad3f2d4033,1174,TRUE,2111,937,Radiant
31a3e3e4f7f84713f73c2080e532a193,796,FALSE,1857,1061,Dire
4ee4f1be157f0c8d54c57c3550f76ce9,1280,TRUE,1827,547,
5b00322e6d8f343ccba49030501cf549,2791,TRUE,3393,602,Radiant
7063a0e82ba4c498392eee03cd894b63,1183,FALSE,2493,1310,Dire
1cb8a31e9745e3d59488cfabe1e47f1e,305,TRUE,1573,1268,
a26df251cae579cb5342d5ee32d14004,211,TRUE,1336,1125,
0bea05c773d0d0c1087187db1a145c7f,340,TRUE,1634,1294,
3992a8b6c641c5077d4597017b323893,130,TRUE,2490,2360,Dire
4649ee90dad6d392ea0519b660af53cf,2400,FALSE,2608,208,
a94e44fa1a12a4d071c06628f073cb92,565,TRUE,2274,1709,Dire
60d1a0138cb05c6dc744ed1f878fa82e,1007,TRUE,2503,1496,Radiant
a098b7071304fc7053ff40e3020adf60,1852,TRUE,1908,56,
51850f2ac33a465f141e1d1555299006,86,TRUE,1632,1546,
786aec430e2358f2c23bb2b18b58715a,715,FALSE,2335,1620,Radiant
6923c1f5a02554f4837d5919ca4a4c0c,2966,TRUE,3051,85,
132c831475b849e47971e592d70e7ec7,1015,FALSE,1586,571,
716e1851a3b6c3640b595a16bc509434,314,FALSE,982,668,
51eab3ab91482978624adc3cab34c783,1526,FALSE,2149,623,Dire
57ee8e29ee7f4b17812d15df5f6681ad,1025,FALSE,1118,93,
24f812bf62de2320488d0a6e2c5d48f8,293,TRUE,2268,1975,Radiant
2e4a9841028bccdad656abbc0d7e9caf,773,TRUE,933,160,
182ecbce2d46a2a6cab0b3cedc85805f,780,TRUE,2134,1354,Radiant
c325f21790cda11aa242b9719a08841d,2287,TRUE,3371,1084,Radiant
be76b4200ec4ce4965f8819db1043eb9,1436,TRUE,1895,459,
90f06d542a8d4c4a056bc410508fe602,3162,TRUE,3565,403,Radiant
d3717825faf4afeac5a73240a7ead7a3,2294,FALSE,2822,528,Dire
5f6aeec9dfa51897f94942a1ef7dd460,1241,FALSE,2512,1271,
4b90217a80a01a01b55f0e3f41905df3,1741,TRUE,1883,142,
6ef2af0c3031b108c6f8a109eff2c498,1315,FALSE,1618,303,
7eafacb50cf4d29e049aa08f89edc879,2776,TRUE,2812,36,
9475cb112cce8c0b3e5f67666f2c9490,1766,TRUE,2403,637,Radiant
49cf8770abd92caf855fe4cb71a878f2,1681,FALSE,2040,359,
9e53485430c719a61d5b4e6aa4f79b0e,1220,FALSE,2802,1582,Dire
cddd48a420a26170621ea94bce7b075a,823,FALSE,1049,226,
dafd971e883f6dff6a6e6f2137265624,117,FALSE,3387,3270,Dire
e03e23ed58bcfd2876f035932ce0a745,164,FALSE,2514,2350,Radiant
0f6173900e17fe1848f78c269fd9eb44,2681,FALSE,2875,194,Dire
cfdba632c61e14e5f5a9d1a1d2fe65d2,211,FALSE,2947,2736,Radiant
35a55a1c2950c470e4d4560a3c049d72,567,FALSE,1763,1196,Dire
7fcad38c557da2fe4d4465c98c5a9b79,1417,TRUE,1787,370,
e0bc809399b82891348fb295d26d64ff,674,TRUE,2723,2049,Radiant
043b41f14549a43e6c3238b07d50f6e8,2535,TRUE,3062,527,Radiant
4144e3fd1a043c62845d266801ffbe2b,1940,TRUE,2001,61,
933a82bd8f1ea3de28ec730350e7a395,1146,FALSE,2364,1218,Radiant
598fa50c7b3d0fec761b48f43fd71502,111,TRUE,3707,3596,Radiant
4769f65125980100c690f74d6617788d,676,TRUE,963,287,Radiant
2c5d2dba6a1615460ec5a2eea4914efa,123,TRUE,3812,3689,Radiant
83850d2bd1c84d630c2a9fde483767ea,1996,FALSE,2162,166,
122ffba5c491e828a96360e1871f4207,2363,TRUE,2939,576,
0e76bf6140dac96a14753de248f03a94,1408,FALSE,1980,572,Dire
413dc57101694c69c68d57b5ec07d016,1918,TRUE,2985,1067,Radiant
ef9929cf730c77f4d12437eeede6681e,1141,FALSE,1986,845,Dire
97ee2d4496c08717e71a07756be2eedc,2164,FALSE,3360,1196,Radiant
c0eb3e12e7c92313861a5ffbae3a135c,1217,FALSE,2869,1652,Dire
123e023245aae6a6574d72e393dd376b,1393,FALSE,2128,735,Radiant
b897f6423ceae070210a3293b33a2612,771,FALSE,2225,1454,Dire
23aaef25cbbd2dec63261adde8273244,2647,TRUE,3860,1213,Radiant
f4cfea09a92e49e009556e84ffdb300d,520,FALSE,2348,1828,Dire
4b42cbf3721d7fee2eadc13412e00c51,1455,TRUE,2204,749,
81a64b44a4959a5f676479abb20d6eb5,1148,TRUE,2302,1154,Radiant
6ffa14b45d073b6cd68f1c1e19b48630,234,FALSE,2133,1899,Radiant
a4268033b03bc34675b78706c77729f8,1652,FALSE,1892,240,
de793998961f4e5cee17ee280f3023ed,1907,TRUE,2181,274,Radiant
40a61f60050a45378cf86acb39f53848,17,TRUE,2397,2380,
433f7dc13d68c0d471f0b874a87d5d4a,326,FALSE,1643,1317,Radiant
e59a7548f6d6b2b917d265d071778d02,3348,TRUE,3462,114,
5cfbb588be330f563d315b9cc85e1221,728,FALSE,2614,1886,
6d3750e47ff8b37e8bc2481a406a80a4,1385,FALSE,1705,320,
f9dbf538687f8b7ca8b0035ca411b042,1544,TRUE,3058,1514,Radiant
6b8344542d479d832e3be88fadd36238,1172,FALSE,2696,1524,Dire
2f13170d69995858fcf1ee15ee0aec53,1110,TRUE,1598,488,
62d20abc8ddfc3edd926267f11f04848,501,TRUE,1773,1272,
1e993de5b8a62387f16c090a522c9fce,167,FALSE,1496,1329,Dire
7dfbb88bbf7aa608d3834c105d3f7867,377,TRUE,1072,695,
b5a9039d3ecccc2d86a782e54c7ff383,231,FALSE,1801,1570,
052bf0cf405944717b4b600a21decc93,122,TRUE,3486,3364,Radiant
12ecb26ac296b58104ed7740c4beb29c,1017,TRUE,1783,766,
2b8e9986e6c59041d736d6c26be61195,1341,TRUE,2682,1341,Radiant
5d4ee6cec3a8caffdebd4bef3fa5e06b,2373,TRUE,2680,307,
c57ef3180a38ccca69170dd502252e93,716,FALSE,2571,1855,Radiant
272d1a8c88ae1d9f99345866845481f3,491,FALSE,1085,594,Dire
219c0a60c4373cb380bc91893adeb2de,492,TRUE,1577,1085,
707a7c49e51755e63462ee6c0ae6b01c,128,TRUE,3956,3828,Dire
75016e49e3c54618c6509159dd0ada4e,2942,TRUE,3071,129,
57089c34e624288cf55b2a280f3e1310,1218,TRUE,2608,1390,Radiant
9e33a4e9316271d30c0be36887d290bf,2299,FALSE,2686,387,Dire
139ae0d560e0e5a673ceb65913f1e41f,456,TRUE,2558,2102,Radiant
15ed2ba624ba6d6413440b0e7f7b74a4,748,FALSE,2954,2206,Radiant
cf5c7b800d0abea08c44affab38233b7,766,FALSE,1203,437,
c730aae95b95d7cfbdc242161cf9c305,1362,TRUE,2069,707,Radiant
dbc8f7080c007e71fd67e720cf99eb30,917,FALSE,2846,1929,Radiant
cde8348aa8b959a69bb96ba40a4be1ac,294,TRUE,1119,825,
aed0f77b891993372edfc588392a7fba,1190,FALSE,1775,585,Dire
0631ff3d41a4c41a03b414f9419bd955,1571,FALSE,1925,354,Dire
add5b697305ec886f563aa5673972757,17,TRUE,1791,1774,Radiant
1cb886d6f1b32fde25599988c2d7d301,3104,FALSE,3326,222,
89470302f18133e4cb4a723fc33656bb,1426,TRUE,3065,1639,
744fd76cf4fd42379e5bb16ee709364e,573,TRUE,2816,2243,Radiant
c40ed08e854c9429356377ee3ac1b5b4,2273,TRUE,2534,261,Radiant
ec4f0b632a3f5ebc46d33332ff67e152,663,FALSE,2394,1731,
5bfaa690423be2e77da558689aff785a,1650,TRUE,2472,822,Radiant
40afae25a56c9fbfeb9d44c8501e64a3,1142,FALSE,1633,491,Dire
69b8f526e75f70aaab85ad41eacbca5b,1401,TRUE,1736,335,
8088a8096550fddc1e0163f81c94bc7a,1310,TRUE,2257,947,
118805bb1ee778c9d610e4ce58685e65,1326,TRUE,2418,1092,Dire
05cb8108353343de2191c5113d855daf,496,FALSE,2054,1558,Radiant
01aedcc5150e332adec7dde6cce58b83,1116,FALSE,2626,1510,
fa54dab179ab0343c45a3c350db04e81,794,TRUE,1402,608,Dire
853cb33dae5c828fd90a1c5b60a3618b,177,FALSE,1668,1491,
406427c53faf3d03898871ba2a3eb065,1256,FALSE,2502,1246,Dire
63f8e2af06581197fd14d6c9673e355c,1993,TRUE,2460,467,
fa25f1d995aae8b88498cc8ce151155b,750,TRUE,1647,897,Radiant
fd000856842e76f41b38cd3c2bc2fdc4,279,TRUE,1732,1453,
cc84ee9cf2ac306ca6a60559b5f9e6f2,80,FALSE,1885,1805,Dire
2b2f03671d4c9319849041fb3fa095ce,1808,FALSE,2304,496,
7a6dd522fcb1889967f651080409432f,327,FALSE,1858,1531,Dire
b73272f9bf64cdd24570391ec7e3f505,1463,TRUE,2254,791,Dire
0977f9c3042bb5e5808c1ff1bd99703e,1009,FALSE,1676,667,
341635b30963fb928b311ffd12646372,794,TRUE,2509,1715,Radiant
24fe7d2f4dac9710e5939fc070f0fe6c,916,TRUE,1952,1036,Radiant
840c34e5710134b885f65d40e90198d7,77,FALSE,2115,2038,
a99ab3c6807561a2504254c472143ea3,2159,TRUE,2468,309,Radiant
24ec86102a7668a0305d053dd8d18f52,881,FALSE,2122,1241,
bee7fee0f1cc6930d8cb99299f94b04b,83,TRUE,2014,1931,
62a418357ed19ff9168a77b163175ac1,1866,TRUE,2010,144,
a7c7559b7697b1cf1f7a4095776e58dd,1581,TRUE,2014,433,
6a988e15034607955963f978a39cd4ea,518,FALSE,2067,1549,
642b46f62434208b12cec184e44a0727,2585,TRUE,3210,625,
e854a85dbad0a9a5666eb210a5a5e10f,869,FALSE,3048,2179,Radiant
e56d503877c404c0869f00768c40f927,1563,TRUE,2963,1400,Radiant
e11606076e569af752714735d021ff0b,2167,TRUE,2368,201,
27a7a1361c110b00e202b54d0e2fa895,819,TRUE,2217,1398,
931c6e62e7cb222c2fddb1977d6b9f72,120,TRUE,1000,880,Radiant
a730ef5cebcb72b1b6713c0c051b9ea6,32,FALSE,3388,3356,Dire
4a824ee7319f0049c3218b32724b4e78,1214,TRUE,2961,1747,Radiant
3ae74dbf601b56016b23cb522272fe3f,1731,FALSE,1984,253,Dire
ee0f6bfa998658636ce2f36a844159f7,1502,FALSE,2245,743,Dire
40d03a0032f11c9517ed70eb664153a8,218,FALSE,1214,996,
76b438d98f6b0aa6339668232934c640,1975,TRUE,2191,216,
5c4fc0a5801d4b0d46f3d6246e7833e8,728,TRUE,1682,954,
e1f4ab2d2612fa221b9b2d27c8256604,2853,FALSE,3261,408,Dire
3970fd09d9c2b056c9f9a62f18b3e979,1415,FALSE,1730,315,
6836492853ad4d366632dbeabd9ab019,1572,TRUE,2540,968,Radiant
ef4cd87923afa671ca76784710342f7d,501,TRUE,1577,1076,
e136e7a760dea6bdea88a7f8345d80a9,271,TRUE,2025,1754,Radiant
19551418c22ccf392e460c3623f28456,2240,TRUE,3324,1084,Radiant
d02f4d97ed8a0e21022ee139d19a9bd2,2093,TRUE,3119,1026,Dire
17af0e1d23de555000b160431c400530,812,FALSE,1931,1119,
6c126454d8022fe6bed9c820a8ee1f07,2563,FALSE,2757,194,
fce853af6df2f3f04d5b7a239e55fb72,2206,TRUE,2759,553,Radiant
66f1c521897b00e7fe6ffa8966774a6c,279,TRUE,2124,1845,Radiant
e20f7ef6cabd9d1183b3aeed1c84b673,915,FALSE,2811,1896,Radiant
37ba933d3bad6ac2b708171f04f0303b,1851,FALSE,1911,60,
2a1c24b5c3f486505d7ef5387c66d71e,700,TRUE,1797,1097,
094df9e747e38583125875fbdf6f0801,390,FALSE,2498,2108,Dire
d5f010b8bd990d1f36a48a4acbd9f05c,628,TRUE,1864,1236,Radiant
8338b2b58ef441ba4177c38f4068e572,2001,FALSE,2692,691,
f6abab14999979fee7b8c3aafe46c02a,341,TRUE,2339,1998,Radiant
95450ea1044b085b810a9fdd52752b89,270,TRUE,1394,1124,
ae8ca8635e77f1090f8a270762eb4925,851,TRUE,1693,842,Radiant
758bf3936e324061892056b82d0d5e8e,2476,FALSE,2754,278,
50c7a0255fecc2760630f7852ae4eb17,1197,FALSE,1673,476,
b4d0cfb27996ea985276777fc336beeb,1175,TRUE,2077,902,Radiant
58d168450401cc74c8c42a2965a54efd,1604,TRUE,1903,299,
28afab7148638cdc14429120c4a95d6e,81,FALSE,1064,983,
9d3cdfd088f2edfa435c6005011e819e,1814,TRUE,2114,300,
486662c1adce6cbb0ed32d146855e674,1867,TRUE,2764,897,
d40cc09d6d815f708fc5c628fab40a30,1438,TRUE,4154,2716,Radiant
8fc0a182900e07f1edeea0e4e3a36409,361,FALSE,2166,1805,
eda36fe91a007a81e67ea3b5bb46995d,1423,TRUE,2522,1099,Dire
5bf87fa37cd132005fb0bdecc056c2b2,203,FALSE,2268,2065,
f29e685bd0f6f57069684a0c8c7b1f05,492,FALSE,1733,1241,
76fdb7b3acfa659c33bf995cc9a5d632,2208,FALSE,2705,497,Dire
26e6b4aa17aab0d57664308972298412,179,TRUE,2311,2132,Radiant
368f80767a7c5e6c75ec6bf4bb2c22b4,814,FALSE,2868,2054,
3dfedaef25cf8e2e2ad22ca15a6539dd,80,FALSE,2158,2078,Dire
1876be6c6f59fd98e7bab01946c2c918,1701,FALSE,1744,43,
ea7631e6da7be881c0a84a0e9dba2905,605,FALSE,2520,1915,Dire
b7786d91aa84f8fa1e4e16c45bb0b022,2308,FALSE,2976,668,Dire
2615f6b4156d329f1f72671d07143e33,1000,FALSE,1950,950,Dire
188f1461fe28468457b350767ba38d25,941,FALSE,2816,1875,Dire
dbf29833145b9dd88273ac1beb2c67e2,2283,TRUE,2704,421,Radiant
c5c777b3457f151730c1f40f5d581a7a,18,FALSE,1691,1673,Dire
29dc67cc43d05e4cfde31dbe65521605,2779,FALSE,3465,686,Dire
a0ed2adffa2ed804c2a9e334272789d0,278,FALSE,1305,1027,
cff7e008ef297f516f670e81f07a8280,568,TRUE,1598,1030,
fa373b8484ac49322b38e5ba39865366,924,TRUE,1324,400,
5818c8c560a5b2f0d808fd9806b64f70,653,FALSE,1050,397,Dire
d884f8dab8a3fd2be27fe870ec8be2e3,1795,FALSE,2188,393,
f899b7a6b07bd35c613bb55f312f771b,1056,FALSE,1690,634,
ca6251eeb9e42a67726c47fd2581f92c,1261,TRUE,3917,2656,Radiant
81f627f73cf941830d702d16881781b1,189,FALSE,957,768,
cef97e547e82fce705fb634f57183e12,428,TRUE,2002,1574,Radiant
3ca5967158cf05f59a26bd8727ed33b4,1043,TRUE,1913,870,
37e3f11b3bd974f092e379dd4d9eb038,97,TRUE,2600,2503,Radiant
bb0751799f33a2d10214abc52438ee83,271,TRUE,1707,1436,Radiant
33e5ea30a63482abd3653a6722f85a5f,201,TRUE,2649,2448,Dire
48eb1746c882fc5ba2af8e009563e30d,2226,FALSE,2876,650,Dire
6377dc21f9b1c53092674d59fc9214d6,1759,TRUE,2491,732,
b04394526aa050c2be02ccff9fc99368,125,FALSE,2075,1950,Dire
4a122f28ec66aeb3e8c1bf563179e666,1737,FALSE,2400,663,Dire
797def8f48d1423136e4856ac46f0080,515,FALSE,3088,2573,Radiant
3d19aebd6dc011bb2deb71eb8c081e82,1202,TRUE,3686,2484,Radiant
c11ee8c4774cef76209c907065917686,960,FALSE,1856,896,Dire
79894cf788b881054e0c3955cae7d795,1242,FALSE,1913,671,Dire
edc2444bfe8b3d698340343b1cb8e0f9,1346,TRUE,1514,168,
843ca8035af1624542e7c808fb22630c,182,TRUE,2833,2651,Radiant
61da36e0752b493abf11cf627f6bb4c7,104,FALSE,2667,2563,Dire
07968110d7002384f4e3ab426988b133,309,TRUE,2995,2686,Radiant
220f97daa7e6e8a7a92252a99cac0c11,73,TRUE,2736,2663,Radiant
762d9b486d930d17112554e83143ca1f,401,TRUE,1609,1208,Radiant
feaa0697c4c94a043577f22ead8d2cb1,655,FALSE,1962,1307,
b41f28b1a4f562935c684a3ebaafde38,29,FALSE,1916,1887,Dire
9f548feac3e6b20be35e12cf7c809d3e,451,FALSE,2323,1872,Dire
872f81c7335a7b9aaf122ef5232e2365,593,TRUE,3588,2995,Radiant
501fd51e972236bdd85b1ba5ce975fbd,1962,FALSE,2991,1029,Radiant
00f7c3b5d6eb54e50dcbbefcea33f56c,1342,FALSE,2652,1310,Dire
29ff146220c66d0a72dde774ae58c5b6,723,FALSE,1911,1188,Dire
3b63b0a343ac7aca937118ee8df6a8ba,508,TRUE,2529,2021,
4326c37cd65d57cd21760b9641d0ec16,246,TRUE,2699,2453,Dire
0f30184333fdcfb925d0a7276b72031c,1559,FALSE,1976,417,Dire
88c19505000e5d6013c4143f1e92b759,404,TRUE,2278,1874,Radiant
068f13fba705d34d9287fcdff784f190,1304,FALSE,2334,1030,Radiant
f1c0d911aee359f92045695369b21704,1018,TRUE,2178,1160,Radiant
ee193c65b2f963bcffe16c136ec8dbe7,1838,FALSE,2701,863,Dire
940af3be8f576c4dea4b066094a04534,323,FALSE,1482,1159,
86e8feae2c254c32af37531bdc4ae048,1829,TRUE,2636,807,Radiant
322e35c7b4bbe3b876a8ea9285d5b0a7,1293,TRUE,1453,160,
aade6698aba7e090d190c50e132a9f77,2505,FALSE,2875,370,
ca19b5789d46748cd71e8b203cc5008d,502,TRUE,1290,788,Radiant
ca065775f46703702a97e7f92e90fe64,1543,TRUE,2642,1099,Radiant
5f2016d571ca3c7d56ad59251833d5f8,601,FALSE,1824,1223,Dire
0eb196ac066823beb2269f8f4d9b565a,1954,FALSE,2266,312,
8f5c2673b6da992c718a45bf29beb8cb,736,TRUE,1950,1214,
11c8c4cbbd6eb6cb41bdca49b70d8ffc,1064,FALSE,2669,1605,Dire
e300aa39a63509993548df3619bd57a6,845,TRUE,1973,1128,Radiant
2e76d06490ee048723159d40ca11553a,533,TRUE,2199,1666,
3efc43df9d489073d240e02d6b6faeee,266,TRUE,2172,1906,Radiant
08c292d54ba81bd3ec831bcb12549b38,2498,TRUE,2589,91,Radiant
7977ac5e7d8b5e9911bb1a1650ccd91c,1450,FALSE,1949,499,Dire
57c4379f440fc097b52e712f4139e7b1,248,TRUE,1059,811,Radiant
49eddcc19bf7c15aeb7a8d4934555b8e,44,FALSE,1307,1263,Radiant
8b523bdf8eb94b7bcbceda896b54fb34,579,TRUE,1549,970,
118146801578c7b6acc91a07f9464871,990,FALSE,2732,1742,Radiant
624f491a1e6ff4f16b59b5f70761b48d,1239,TRUE,2397,1158,Radiant
c19c6c1f07e11e9c64c7470cbb943328,3212,FALSE,3825,613,Radiant
207c5f6263e3b0261f3c005d3d99ab8f,1134,TRUE,1559,425,
aa1b7ad55096d8d1715574993bc809ba,1009,TRUE,1947,938,Radiant
f798ebc80cb9613953ffbc0d4ad05f23,166,FALSE,3496,3330,Dire
25af7024f7330b672d5cdde6978edad4,128,TRUE,2227,2099,Radiant
9fcd0b96141d38edc5e54ac0534415b7,800,TRUE,1514,714,Radiant
6432ec7b3c4afd7c97d59c6c8b6757ad,269,FALSE,2164,1895,Radiant
e0287ab92785e70c329a3b3beb58bca1,131,TRUE,1240,1109,Radiant
fdcec9ce577d957d049e009d1b3c0afb,691,TRUE,2237,1546,
1eefdddc6474e5c8a4feaccbcfee3c3d,1564,FALSE,2522,958,Dire
372c834b749de6eb676bf2643389a1a8,1289,TRUE,3281,1992,Radiant
bf18e629d898e29f2f706a39e81d5fd7,2229,TRUE,2363,134,
9bba3d360ed662cbad48fe49faa56205,1265,TRUE,1731,466,Radiant
258e85f95f297d244e05d3c2cd87a641,856,TRUE,1302,446,Radiant
0c7b6b08c77a0a56feab621ae9fe20d5,318,FALSE,976,658,
b92630d65d06dd9f3c6f9268469c0625,523,FALSE,2254,1731,Dire
b753c7a500e5601779fbcffed0124434,800,FALSE,1699,899,
dd29a542aebfd2f15898691495758772,753,TRUE,1751,998,
e45dd629919cab900bb0c984772d1cd1,3592,TRUE,4335,743,Dire
bad9d1751071589ccd7d587d980d5dc3,1034,FALSE,2002,968,Dire
f3fa6a6aa7ddf1ab003a3370706e91f0,386,FALSE,3052,2666,Dire
9bf555b3ee0a44f551bfe127f4745fc1,1644,FALSE,1899,255,
9f9a659a0233ea7384d9b85028798d4c,1132,TRUE,3785,2653,Radiant
710dd94d496b148b781d76b66085121e,1561,FALSE,3192,1631,Dire
b1988ab9b9d8b8c5b8ce57e434ebc459,858,TRUE,3809,2951,Radiant
e7568b21584911671bf8d552e8083d5d,333,FALSE,2448,2115,Dire
5928dcf0853d67c27213bf10bca99b67,1357,FALSE,2303,946,Dire
3e0bee242f7e020fe1455ae3da9f1883,1296,FALSE,1697,401,
50f6a1f05da51b8514585411aead9149,1567,FALSE,3924,2357,Dire
0a77fa8cda4767e0977c6db284b889d6,41,TRUE,1717,1676,Radiant
a5ff46024a3adbec688405ebdd084fd5,430,FALSE,2490,2060,
6d511a106220326085d2c862c30b0fae,950,TRUE,2312,1362,
2fbccf96d82fd747aec5ad628a34e59e,551,TRUE,3284,2733,Radiant
11ddbb7d41f16cd4e0aa5b54009e7bf6,1862,TRUE,2160,298,
93e648f9ba68d08dfd88837d63044881,591,TRUE,1907,1316,Radiant
8a98da41b9c24ee949694e4406b974c9,927,TRUE,1870,943,Radiant
1f70010180ac6f9d104dfdaf24012cf0,1897,TRUE,1982,85,
356576d30144d1a1556eeb97b70bcba0,1547,FALSE,2347,800,Dire
080a99553650bb8d87c518a3441803a4,1007,TRUE,2904,1897,Radiant
401b43ae3b1097e4eeab0f92298bf743,1911,TRUE,2399,488,
bf65d565b6b26521f6747769db47a691,2006,FALSE,2331,325,
e49440cf3c4179b9fc4c842a2b19e9c8,1243,TRUE,1862,619,Radiant
c44665d6d166a940df7db006120f9a9f,194,TRUE,1967,1773,
503e9a2f3fbb13171b79a7bbd1fcb50c,262,TRUE,2091,1829,Radiant
336e54582bda91317a161951bb5d6372,476,FALSE,2824,2348,Radiant
a210733262cf90e88573f2a700480cfc,939,FALSE,2134,1195,Radiant
04e73ae4449aa9d9a1de393a8f170290,1787,FALSE,2028,241,
922d1b47c1fc6a7ff88cb95a7c68fd1f,781,TRUE,2003,1222,
23d16555615266af5b51722923dd2a64,1893,TRUE,2668,775,Radiant
427df4b73bbe1a4ef167a48ccf015088,483,TRUE,3112,2629,Radiant
2c31ff3a48381ea898f1b2e590fa8c77,2523,TRUE,2648,125,
069ebd2078e56089a7708965fac8d3cb,2057,TRUE,2181,124,Radiant
45802e9ba3f932e0448a48f01093c21b,494,TRUE,2506,2012,Dire
15be45bcc099c2e951421bb436aaaaf1,1475,TRUE,2107,632,Dire
1667ebb82a1e5ed171136d2ac717de4d,1953,TRUE,2028,75,
133378f7b6654e37b19a57f0256b4daf,825,TRUE,1808,983,Radiant
f583d739aea419baef54420f51654c4d,986,TRUE,2482,1496,Radiant
7daa74a6160ae2d523f152f3bdaf2052,149,TRUE,2688,2539,Radiant
59f71157313d40b1e538e7602e14d5f9,1866,TRUE,2003,137,
f7415271d2235d5e8e82713134cc5f58,1337,TRUE,1508,171,
aaaa8ec483d21283f79acb70be27842e,775,TRUE,2100,1325,Radiant
cc991cc293c9a3a71467b74e42ef8510,132,FALSE,1749,1617,Dire
9f66aa3f3014be01f1681acc56967957,171,FALSE,1239,1068,Dire
2272d88d9d2beff55b5b4436e4be5e7a,57,TRUE,2180,2123,Radiant
5b8fa5c96d7eef0673b42beabc9df0ba,888,FALSE,2205,1317,Dire
d7a986b3fe49e913d2b1ea6c0d2af189,567,TRUE,1239,672,
865c9ab61fef35953ada6d7f502d832f,439,TRUE,1059,620,
44a8735524722e0d13d035f6ea04b9e0,190,TRUE,1659,1469,Dire
f42924d13ecd831df98814e676aeb942,782,TRUE,4922,4140,Dire
25ef28730b950eca4bac2b6124d74b45,1658,FALSE,3110,1452,Dire
4d3b8d4fa7fb7ef5949ca8568c8a07e2,45,TRUE,2234,2189,
69cb5b5d9bdfde5e44510792d2c61aee,2574,TRUE,3054,480,Radiant
7983a71e4fc1bb3a944c89667e362619,65,FALSE,1714,1649,Dire
d4e0687b894544435cf79d2b12fd9381,1557,FALSE,2528,971,Dire
ce339d42d056885c3a9271eaefb8488f,2464,FALSE,3146,682,Dire
3467a00f1628c5b08e2c114124d03bd2,2368,FALSE,2513,145,
9dfc89f5bcd3d030fa4b3039c5d27aa7,1571,FALSE,3210,1639,Dire
8693917ab3f158d5b47a51745872470a,725,TRUE,2491,1766,Radiant
ccd33e548600c398ee6e6920bc3bc725,488,TRUE,1894,1406,Radiant
9878b82c479f119964e49fafc1583993,3181,TRUE,4035,854,Radiant
0769e8eb34d7e6ee0c74c85e657b6594,101,TRUE,1898,1797,
8f27e545c4bd8974e7622a0f5a12f2b5,959,TRUE,2735,1776,Radiant
ca0174edf3fbbdad161043ef28737ca1,1317,FALSE,3330,2013,Radiant
5bbc14ab21a4ba30f76d0b1afd2607c4,2436,TRUE,2524,88,
5dd8589b570315486bf9c95551d5f9a9,1157,FALSE,2031,874,Dire
d1333d0c987f56f0b5d2ca97cbf4fa40,789,TRUE,2172,1383,Radiant
34a53880ab289b62fbdbc694b4eeb008,503,FALSE,1550,1047,Radiant
64f96d944f7f2799ecbad6458bc4816d,75,TRUE,3612,3537,Radiant
a2bbef515e7b99d983bc76cc2ed34dba,3032,FALSE,3736,704,Dire
d306faccace2afa255abe0b6ff729758,430,TRUE,1663,1233,Radiant
7439c47e1124ee403c251dbecc351a86,589,FALSE,2244,1655,Radiant
8f8d68b6a595a89ee8984ef5d4e8a079,1460,FALSE,1978,518,Dire
8730e55a64d525d7351d33c0693e0d73,1735,FALSE,3801,2066,Dire
50d821151c71fc303451c8d42692d8ea,517,TRUE,2494,1977,
2b7c89037cb8b9193a0f64b773e34649,1783,TRUE,1869,86,
dc042bd26c4a65737ae632dd49f22343,1033,FALSE,1836,803,
639f97e48bb2590c29bc4b648ae2a2fa,736,TRUE,1808,1072,Radiant
4d3da574b099bf68b84a14533d67f8af,1731,TRUE,2132,401,Radiant
65ed4b01cdc8194157c9ab976053561c,1559,TRUE,2890,1331,Dire
c4db124166abb4086c1e391cbcdc76fb,1671,TRUE,2019,348,
5a887d47b3749876dbc0f8115cb458a1,1107,TRUE,2847,1740,Radiant
bfdc9c6a0041dc2c7e93f721d12c4dbb,170,FALSE,2823,2653,Radiant
af458dd2e75e2b7b45d24669552a19cb,1156,TRUE,2648,1492,Radiant
5ba11b69d7e5334c50ab6e3514a6eadc,146,FALSE,3008,2862,Dire
e74a100e9a1cac5878e7f03bfd01c070,1088,FALSE,1405,317,
8687f01b7a018d09667f3516e9000bd7,872,TRUE,2352,1480,Dire
d5dc46d54e5045208e598f0b47689c97,2915,FALSE,3464,549,Dire
815db53f11d06b829185cca0e116c4d9,1692,TRUE,2237,545,
c5e1056482f3426ede3cf53898daf05a,1391,TRUE,3176,1785,Dire
f8a3d3a39539a0f57b33db73a43d5311,1422,TRUE,2838,1416,Radiant
8260273b28448127c397ac6ba7c37586,944,FALSE,3144,2200,Dire
3ceab29fc2d8e0ced363ca9088e03c9e,1173,FALSE,1931,758,Dire
348cbbd3550b5e5ebc6b7660ccdda181,528,TRUE,2127,1599,
d90e55773cc20943e27ae43ef166eae0,117,TRUE,2192,2075,Radiant
111caf261429a44cffa03b3266100bb4,752,FALSE,1555,803,Dire
9459f5b77e36c13dccd6efc05ee6a460,1167,FALSE,2784,1617,Dire
63aeb1577c6ed2cc47acb46127c02dd7,294,TRUE,1107,813,Radiant
18a8cb007ff7ae1b761a317017e462fd,2149,FALSE,2557,408,Radiant
b38638d7c475f6c49a6ce35a8bf789e1,437,TRUE,3141,2704,Dire
4d937ea1f9884338c57d3acc6ae167b7,2148,TRUE,2440,292,
fbf0df0e4f503ea6cc14343a7b56be29,1256,TRUE,2803,1547,Radiant
3141f190f0c511614bb74b4cfd386567,2606,FALSE,2842,236,Dire
58abb3903e08993aec3eaddb12273cf4,31,TRUE,2191,2160,
2c36bacc14fefc28ee549cee15255e4d,1510,FALSE,1691,181,
b951bf55710e0ba9b1560f2dffc79d91,1958,TRUE,3664,1706,Dire
71ca4bd45b73c3fa4c1d6c83add5ca9f,1632,FALSE,2372,740,Dire
df98499f3bd3ed8fb9b451fc84dabf75,1323,TRUE,1614,291,
140551ba76137872d61516da608f5c43,472,TRUE,1885,1413,Radiant
ef5e3123ac2d212a4816fc3e2c784f52,1000,FALSE,1841,841,Dire
8f676a31daef68ef584d714a20920642,1845,TRUE,2664,819,Radiant
c2ec3a05fd153df01a5e8ed0023da6c9,191,TRUE,2207,2016,Radiant
6b79e29f3059ca740b91505294b73b74,521,FALSE,1567,1046,
6c09cc216baeb4bc8ef809266546f4b6,252,TRUE,3940,3688,Radiant
4c27460b5c9ed9581f5595b796721f9a,2437,TRUE,3682,1245,Radiant
c69621a251248c0720904394a11ec2c1,97,FALSE,2242,2145,Dire
97930f3bf2bb67272d5a3a9f86dd1d42,2185,FALSE,3305,1120,Radiant
f564bac25760a7940a8f0c5298c7b0b7,221,TRUE,2175,1954,Radiant
eef94cbaad1583c87172e420f7dbea71,1022,FALSE,2583,1561,Dire
b9a2fbb308d217c52199eaa731506be1,1979,FALSE,2295,316,Dire
4cb40acdc9a753fc555c27304695eb5e,1616,FALSE,2434,818,Dire
f6c5cc646dea1d1616dc828009c7e914,2388,FALSE,2764,376,
0b37d167ab099bf8679a82aaa8d68805,1251,FALSE,2430,1179,Dire
0e9867b51d38116c507d8fb14142d4a1,730,TRUE,2446,1716,Radiant
3a36beb47dd4fde8111db5ec4382aa1b,201,TRUE,2183,1982,Radiant
f1bea3f6764b64074a92e556d35f462c,923,TRUE,2570,1647,Radiant
298544cb2c996fcd3044af0bd789f656,2926,FALSE,3045,119,
8531c8b9e03e7f08bfd1f52e3bf28899,2391,TRUE,2557,166,Dire
db5aef689d5c319cac97255071676a34,2665,TRUE,3501,836,Radiant
176a051588041fbbe1ab8d0767041af5,1195,FALSE,2433,1238,Dire
c1be74adcacd255eb87925f79df87633,426,FALSE,2449,2023,Dire
3401deb5425715eed96a2a8217d3a756,610,TRUE,1425,815,
9a88bf4a1887fb0065795806e9a5ff4d,1871,FALSE,2784,913,Dire
50ce9138e77acb39dc332b397338d1a0,1005,FALSE,2603,1598,Radiant
11f17797b8518b420750cc34e48ff88d,2024,TRUE,2947,923,Radiant
ca9ece7686aaf7bdcdecec15717b6f01,361,FALSE,1849,1488,
8e33799b1c2d6f7e7e2276851a18c1f7,229,TRUE,3355,3126,Radiant
e9c2c30eeee91ff01a31688c24435395,726,TRUE,3476,2750,Dire
d057b2beb381c74adbd696898778ea20,815,FALSE,3173,2358,Dire
95072b69c2a66bbf3ccbc269a0ca76e1,773,FALSE,2068,1295,Dire
c8261325a91c0ea7f8da4510bb65c9f9,1117,TRUE,3081,1964,Radiant
b0a1865342d914194fa125c3263f1988,1248,FALSE,2695,1447,Radiant
e8ff6d6712e2722b876978aceb1f2da0,1233,TRUE,2245,1012,Radiant
69478e9525dadd630ac62bc5e5abf9b3,746,FALSE,2106,1360,
d9f78fccb24b93425778ead76991d459,259,TRUE,2080,1821,
11e10cefa35dca9c91a59fff9ad8f0c9,604,TRUE,3443,2839,Radiant
7997895bd9c5dabd83bd0d71539b55c0,966,FALSE,1685,719,Dire
8d55e48e55584cbe9793c0cceab820b7,398,FALSE,1876,1478,
f8493474835252efcdb6dabca1d8e5fe,580,TRUE,1420,840,
282c50ac299b1575b64f988dd062329f,1061,TRUE,1532,471,Radiant
88a8d9560c18fa050b66146b42e82a98,1482,FALSE,3465,1983,Dire
02b21a1d2c42a1a039ea0cd4420a5df7,1460,FALSE,2693,1233,Radiant
f5f6ab503dd04e8ab2ff6ff7b739cab4,896,TRUE,2015,1119,
1ab004515f138d905a186719f236c3f6,2641,FALSE,3114,473,Dire
c56341543c88a6c331fbc7f25f545887,2202,TRUE,2381,179,
b2ed53674d92cd285d2d22fd50b30a54,566,FALSE,1929,1363,Dire
72ebd0215ca5026f48e23a077ad25306,716,FALSE,2427,1711,Dire
42a51fc15c124d4ac2aa604fbfbe8f37,718,FALSE,1324,606,
c5695f49c3866f5a7889751835a96eff,3658,FALSE,3889,231,
6a5b6d9f21c544b33589ec1c140e3a00,792,FALSE,1987,1195,Dire
ec1b26a0d3d434fa6ee6bd7a2670299e,1316,FALSE,1760,444,
76d92dfa9d3241251986e9622591be63,1841,TRUE,2316,475,
7cd0817bcd87e13bbb23265c82a0ae24,669,FALSE,2530,1861,Dire
41cc73e97cecaff4e3707bd745444344,293,FALSE,2071,1778,
da6d6e18cba27a9c13d3e1083cfc3481,963,FALSE,2748,1785,Radiant
94a4cf80e97a332983b94f8c26dec833,939,TRUE,2533,1594,Radiant
cd86f7f2e3de03463155df53524b7695,652,FALSE,2239,1587,Dire
d83276741de28e0c58b9837fc97137ea,805,FALSE,2052,1247,Dire
2849b9b77bf71c1cf764422656e224bd,781,FALSE,1129,348,Dire
5d6f70dfc4f12964a695c81e32ba6195,872,TRUE,2311,1439,Radiant
22de30648d37738704ee2ae6bb281e16,162,FALSE,2274,2112,Dire
911c4c7c4e88f3123cb0a7bb66fbfde9,269,FALSE,2532,2263,Radiant
e20f2c1d5cf3ad75fea4a6faf158c6f0,211,TRUE,1991,1780,Radiant
f749fe2016ee964754abda2d476dc114,859,FALSE,1766,907,Dire
4893241b6391039c2680b0bf8e20708c,2714,FALSE,3626,912,Dire
da5937027c5a926062d3cca8f8b1db3a,1602,TRUE,2246,644,Radiant
5d60b1996aea702a51e5885b319d1250,2009,TRUE,2579,570,
13643bd2da01a449c5d5003df7495dd1,109,TRUE,2249,2140,
264652ea64067be0f80c22c2511b0857,1716,TRUE,1946,230,
118539c821bbf0cc62cd729438f50959,135,FALSE,2172,2037,Radiant
d39a803d014a05654b9dbf3cdf914592,3105,FALSE,3416,311,Dire
fe655b083efb0027d7635ade906a7af3,1538,TRUE,1590,52,
57196941e13f8a2fe37d84eb220935a6,403,TRUE,920,517,
150704c1a1d676c75d17ed8d1dfe4ffd,871,FALSE,2831,1960,Dire
c3fc822f577ede94c37d768646f907ee,1334,FALSE,2675,1341,Dire
4bf7a84cc32d57ca9c4d30809a35e738,1428,TRUE,1891,463,
4a8dce80e28d0120c354dc5c3bb3043c,1767,TRUE,2471,704,
3f9198462a7fca56e9c3d9f9fd3f2e19,561,TRUE,2082,1521,Radiant
7364d66fde9569565b06154b2f18b4ea,97,FALSE,3304,3207,Dire
cc4c5046f6b3175aa0bd2f78c13c1587,1246,FALSE,3109,1863,Dire
3e82ef0e0e14624066aa444c71d47737,410,TRUE,1473,1063,
ae3e7e0be8d5e3049bde9f0a1add1b46,977,TRUE,2915,1938,Dire
3c1305d55a4f4bb11ecd092d2a2930c4,2024,TRUE,2850,826,Dire
5bf625dc1c354662e6e5a7c0a65e6345,1291,FALSE,1902,611,Dire
a985a6ef28a642b9cbdcf58aed95895a,1605,FALSE,3492,1887,Dire
712a9c3a07acdd5e51ee54d94612c312,614,TRUE,2014,1400,Radiant
e873f7bc17e719b409b8512857f6e854,1652,TRUE,2184,532,Radiant
7659e2b12142782e0a008f3e4d9006f1,479,TRUE,2373,1894,Radiant
188aa1a2474f75d82f7ef401ef3428ee,114,FALSE,2570,2456,Dire
acc8a15da767e29a3bb12fe1df240a00,2724,TRUE,3238,514,
34d8d900d5dd3146fe4577c9194044f3,734,FALSE,2438,1704,Dire
2071890a966afc0fee25cfd9a58a1530,1807,FALSE,2454,647,Dire
b775fd57f925bc3f6c348dfaf4c91c56,2586,TRUE,3799,1213,Dire
304a5be56666e0ccfa52b9e1026a10d5,1205,TRUE,2668,1463,
e25be02359d78b0219a6224e6fa4c6b1,399,FALSE,3164,2765,Dire
ace03c26340ca70142d1a49a8aff08b6,183,FALSE,1266,1083,Dire
dd351d171eff178cdcbf49ac3427b1b8,459,TRUE,3687,3228,Radiant
ab8e16f5f9de39bb7f21dc16465ba161,888,FALSE,2531,1643,Dire
fe3864b14f674ec028b669d97e7efec7,1942,FALSE,2297,355,
2d709c2fe97f208fee4135fbbf759b3a,1078,FALSE,1478,400,
d1df7a72823692f6607a09eb80d92db5,868,TRUE,3460,2592,Radiant
ff6770419442467b6e6fe20d4c1bd602,1363,FALSE,1781,418,
aab53bf53259d85b9a7f55fcea81099a,1128,TRUE,1330,202,
99b5563782d1ce2d6febe7cff836d4ec,2013,FALSE,3076,1063,Dire
02f08ba43585a3573f5af25ec35e9723,1596,TRUE,2845,1249,Radiant
baa2ebfda95e270bc220b791927d452b,302,FALSE,1943,1641,Dire
b52f65ec848079755f6a4d63103e2d0e,1977,FALSE,2548,571,
9d8ea8123021afebcdbb533501300194,294,TRUE,1872,1578,Radiant
3efec2452eda59d25c20f3d6d8a2a9cc,319,TRUE,1758,1439,
e07a0be3d8056c916ece52695603ac96,1215,TRUE,2125,910,
9b980d7abea497b1b31dd6d6cbe2dfa2,1069,TRUE,3163,2094,Radiant
c273b8d2836612f7ededbd933d63a328,1477,TRUE,1836,359,Radiant
97ee724809a589a5eae3852c48a15b9f,54,FALSE,2634,2580,
054c98e8db3ae0e6aac06f8b0432303f,934,FALSE,969,35,
72d71f578c9a7a1911808731614292d6,2684,FALSE,3735,1051,Dire
931848f83fab27fdd5a3296f3cece6f9,675,TRUE,3248,2573,Dire
cf9a3a42dbd9a046659089686e4daae0,1098,FALSE,1454,356,
f8d21b863b7a5cd3e101724f2f3cdcaa,2517,FALSE,4155,1638,Dire
723155754adf51a97128f34a227e98a1,591,FALSE,2820,2229,Radiant
38f50de4cd2b08321ba25eeaa222ea5c,301,TRUE,1950,1649,Radiant
cda2bba8aa472176dba16be773c404e9,1124,TRUE,1916,792,Radiant
b102d5d7cfd767f969dae46551fb8de8,1872,TRUE,2617,745,Radiant
ac66707317e7ad00668ec65e5cda5a9e,2667,TRUE,3761,1094,Dire
2f70a3d12d719a94bc3f20fc88f5a483,1424,TRUE,2590,1166,Radiant
b0b37d6805d206cf7cfc6640532e1c86,1280,TRUE,2097,817,Radiant
5c651fa05b855e2377e71a96cac2238f,1509,TRUE,2616,1107,Radiant
aeaaf0d96250bca7ea1ee321e49a3db0,2354,FALSE,2550,196,
4a56482c3f55affc00a965e23adc20f5,432,FALSE,2661,2229,Radiant
4894657715aa4b44690b1ede70883770,873,FALSE,2117,1244,Dire
3ac267bcb5bb0d20cda1a2924640766f,2289,TRUE,2471,182,
1804ab4dacb6f2360b81441b33558bf7,2226,TRUE,3052,826,Radiant
60bac687bc28c7ac26a3b9c39cd86250,2165,TRUE,2452,287,
3a9416a697db887f9bc1a5c7a04be7c4,1925,TRUE,4391,2466,Radiant
0d051570d1430c27a501192cd59dc28f,1918,TRUE,1963,45,
e819b22cc56c8a9a14306b89048a933c,1792,FALSE,2182,390,Dire
d73cf1bc65117d535ed3c13989c04d9d,1651,FALSE,2032,381,
20d92d6677227888d845fbdf13caf8f1,1616,TRUE,1994,378,Radiant
ee307660191b12a9d659675d09cbbfac,230,FALSE,1670,1440,
6025e649ea70cbb29dc5b2b09d3b005b,696,TRUE,1252,556,Radiant
d6b712b668e1e6a8894790a03b442417,486,TRUE,1277,791,
2c428e425d319d52182d23f213c2842b,244,TRUE,2933,2689,
19bf8bbe75c57625b6a460d9327d246c,613,FALSE,2623,2010,Dire
0db835f64319aae3122af7af21466688,512,TRUE,1233,721,
026c6da2b4c586d7e4461d054ed0cacc,297,TRUE,2048,1751,
602ed17f263149ff13c6f57bb8e40021,331,TRUE,3456,3125,Radiant
fe995f137782d324af4acb4e777d89d0,381,TRUE,2240,1859,Radiant
c525e46b7f9788ef286d17009bf9f966,1551,TRUE,1931,380,
581bc7e3b408206e5325727b45b3b131,1054,TRUE,1544,490,
5a42cb2353d65ac6a9b0b942cdf8c0c0,1153,TRUE,1964,811,Dire
a76a8f46ad98bc2252e7a0fca2751bc3,914,FALSE,2335,1421,Dire
0d8287fcc88b89349f93836087cc9ca0,370,FALSE,2140,1770,Dire
d90a7e2e84aac448e07db4831490b749,334,FALSE,2250,1916,
327363401175690bb2110dcbaeea32aa,1628,TRUE,2740,1112,Radiant
89a1092f28d458498372c4ca9a9ca2c5,1387,TRUE,2262,875,
93bbe9df4fe1077374a606ca950bae9b,6,TRUE,4129,4123,Radiant
8e09513a8500626b1403367fc9fa89a2,1898,FALSE,3666,1768,Radiant
8060e2f5ff6ab4ba15d9493e3f968a76,1312,TRUE,2257,945,Radiant
13ab2763e2d2eea2f9b7259aa1f708da,196,FALSE,3040,2844,Dire
429f697d9676f637eaa4f2678b43acaa,1560,FALSE,1949,389,Dire
9bae67d14d950856a9693b7efd9bce3f,1246,TRUE,1937,691,Dire
e0ef642b5175fdd36c62899229e1709a,1785,TRUE,1935,150,
6c5b0a6b01ab54c994a6cdd2173e3789,1730,TRUE,2264,534,Radiant
f4bad70f4268c4cfdb4b2390cb65e60a,1725,TRUE,2699,974,Radiant
396e9431a212d6bf704631987aa14b94,260,FALSE,2633,2373,
8c251cfe95cecea8e6472cf17c6f85cc,1325,FALSE,4275,2950,Radiant
ad500572c082d90c49bd48f7d3b633b6,10,FALSE,2144,2134,Dire
e10cd02eb0ad825fae76f7b97b134c2c,1381,FALSE,2275,894,Radiant
8504fe3eccb5721f16654180bdddd8de,1287,FALSE,2218,931,Dire
01cfc0c0d74b564c9677269f4095f1d3,69,FALSE,2315,2246,Dire
6b8445dda6e6993595bcda940c166489,1638,TRUE,2190,552,
73c15211ee974005fc6732fb32155b6a,62,FALSE,2452,2390,Dire
a3abd5cd37ecdd38e2cfc90ee50ebc74,806,TRUE,3117,2311,Dire
454e7e0755e312909b4438ff1cd20721,1481,TRUE,2392,911,Radiant
59f624326d86b1ebbb2451cef05f7d87,3039,FALSE,3183,144,
25d80f82af32c1ae3f03e6a7e193a26f,1841,FALSE,2415,574,Dire
e743d44593864b202c63a692cdf10efa,742,FALSE,3334,2592,Radiant
3305d89e51a73f1f177add116b63c1ec,1193,FALSE,1267,74,
6036683d6ad84cd38986191a32035d6d,579,FALSE,1942,1363,Dire
f885dfcd4869d03867c4942eded32334,50,TRUE,2136,2086,Radiant
da830bbc34e5aa16c5f0c8c71373e585,1297,FALSE,2804,1507,Radiant
3d04826eaf0297d0b4ae0705a50b97be,1695,FALSE,2520,825,Dire
3e3b84fffa9004622a9c33ea535fb7c6,1130,FALSE,2780,1650,Radiant
e51b71ac743daa00e57233967dfec9b3,756,TRUE,1851,1095,
25d1828d18ed2cc25428fbf0a5b2be44,1325,TRUE,1377,52,
e77641c963c5464affc55f97f5ca0513,1521,TRUE,1793,272,
15093a7676abfd2230c498e8c4ed0329,709,TRUE,1564,855,Radiant
08ae4a03694375fc935071e2e9311153,1325,TRUE,1569,244,Dire
a94e7a03f4ae7689fdf7563a88afdce0,105,FALSE,1680,1575,
75ed119033f68d01f009e664bb4b27f3,1693,FALSE,2726,1033,Dire
83f0b8b2e8f643b48ca8b840823f78b8,439,TRUE,1596,1157,
0d8e11b43766d135168a91a8d6ac7dc5,1615,TRUE,1742,127,
ef44d16cbdd2b465551c1a75c62ab897,2579,TRUE,2703,124,
52b69c75ef2be7424934a3373575b525,1970,TRUE,2390,420,Radiant
9342c07d2c324a84e002473ad43a7b48,994,TRUE,2771,1777,Dire
5b89d4455fa9ea5d8606c41700f6d74c,843,FALSE,1473,630,
96aeac01befada4af354f7c9cb50f007,230,TRUE,1144,914,
ec05182c7a9235833e8f8f134bd9f4c3,2147,TRUE,3750,1603,Dire
7bbb41e17065d1566edf90578a67098d,2325,FALSE,2709,384,
f22ff002b3b0d7edc7f843468394c99e,568,FALSE,2056,1488,Radiant
d7764867bbb8cb307e5b1e100956e7d4,2871,FALSE,3294,423,
d9c0c079a687e8cdfef1a34d8b9f4719,1941,FALSE,2379,438,
ddacb46699fb2144b6329a1a174bad08,1463,FALSE,1861,398,
5698a6ffd2f7487a826dbc49961bbf0d,721,FALSE,1568,847,
31a4f3cf1d6b264167774a9132e17327,1357,TRUE,2136,779,Radiant
fd962a519282770601770456668a258f,771,FALSE,986,215,
c734055a4c9e39b580659a4e41f7fcd8,1029,TRUE,1333,304,
00b7bf3908940d27dee77762723c8c4f,2390,TRUE,2947,557,Dire
0ffd34bc71b4b108be229c691c33b45e,2108,FALSE,2691,583,Dire
e0bd8efc4ce07fd7bb0e893f128138a1,1711,TRUE,2805,1094,Dire
483887c0a92bad5cc6d208496f8d6aba,2430,FALSE,3192,762,
a91372bf0022837d541f15b4e84c3706,532,TRUE,1743,1211,Radiant
302c141254d31eb32ec1870f29db40e0,2957,TRUE,3718,761,Dire
c558b3fbba1daf9354c0d632a04f8e13,1836,TRUE,3127,1291,Radiant
048a475f1326056424bbfdde35ef78b3,300,TRUE,1711,1411,Radiant
700e9e1a8a91cfd8de5663af518604ce,146,TRUE,1175,1029,
50ce8517db67b73f4db4a1903e55fe1f,1301,TRUE,1999,698,Radiant
ebbffba659a2f3699293b8ba5c675673,2309,TRUE,2401,92,
dbd94463ad1b42937382f7de6f008b48,3621,TRUE,3828,207,
45ecc01bdf4c13b74c5ffe53a6aff74e,1354,FALSE,1537,183,
921a896cfff8866289fd3cb5b67e9afa,445,FALSE,2483,2038,Dire
bc3bb75ea7efcc0b4181c676569532ca,440,FALSE,2654,2214,Dire
e62ee5fba2205f1d9747f9e50ef84da8,1798,TRUE,1880,82,
bbfd8a02541ca12bb1a48e1cf69c1a76,2566,FALSE,2625,59,
82225032e03176051dcf08959d97290e,1389,TRUE,3315,1926,Dire
6f7f78ca78beaab3e8605e681785b249,2594,TRUE,2978,384,
d31e51926364806c4d72bd248d750e6f,1463,FALSE,4016,2553,Dire
61efe2ea981b795875fab66688e80af3,2033,TRUE,2681,648,Dire
2c8b6ae6cde665647b20e2fc2fa60613,885,FALSE,977,92,
189c2360a8a069824757c10aac7992bc,2410,TRUE,3417,1007,Dire
2d1786c0cc1d32c672bd33fd8bc7b7d4,259,TRUE,1496,1237,
a5e2d4bb6db24919e76b82a55e3bf6ac,1191,TRUE,2000,809,Radiant
653c95a6e1e917911e470cb47975a05a,842,TRUE,1291,449,
28be43967862dd9abfbaaea155f364a1,293,TRUE,1994,1701,Radiant
28b2b43e49caea2ddb540c8a42c7290c,552,FALSE,1960,1408,Dire
b19b9b630fbc68a54cbe226d6a479f00,153,TRUE,2829,2676,Dire
e62212901d0351f861134446f7e2e2ef,906,TRUE,2103,1197,Radiant
86d6ce538b4ae2abf3aa03154d74ac86,574,TRUE,1948,1374,Radiant
d4173ea8f11af59936356ac6a1527afb,1173,TRUE,1852,679,Radiant
c24c66dbf2fa9b99682fc4932749609b,1049,TRUE,2018,969,Radiant
38b45ce8c95899c37f0fa8cae4a5c25e,316,FALSE,2189,1873,Dire
d48ab7b7aba529bdf37c6e828c12ef01,2178,FALSE,4500,2322,Radiant
9d27b3a7f4eefa0b63c96c82a4e97b4b,889,TRUE,3166,2277,Radiant
6e9db65f08e127753228445abede6807,1156,TRUE,3360,2204,Radiant
93bf5032b7ec82530467bba3d4c96a8a,1488,TRUE,2184,696,Radiant
f49e3aa27ebb18717798f4796b4a4b6f,1270,FALSE,1842,572,Dire
85be9d65fbd02b7f6af642b194f83c26,889,FALSE,1154,265,
882c4b41b19ee5c73eacc25eadc39e86,2156,FALSE,2612,456,Dire
bad8532db59f3b622f9b56724747f060,826,FALSE,2789,1963,
b2c7adbe539a341b5abe7222a78fe589,1810,TRUE,2791,981,
e3a6043d2ba1f47edb9afa7d2bfc07f2,2407,FALSE,2546,139,
9dc69ec366b00baad3c72eabe986b001,2843,FALSE,3172,329,Dire
3c80023eb89c9b8a43729a689f767999,1835,TRUE,1959,124,
683ad974b05b418c956cced7e438925b,1798,TRUE,2230,432,
9e688bfad68bc598260301488f6799b0,2125,TRUE,3553,1428,Radiant
add8c3786603dd84deb070cda6a6ccb5,810,FALSE,3380,2570,Radiant
1026cf727c840060bc318afb4ea844fc,1030,TRUE,3082,2052,Radiant
8b9d6eb59a5bdc5958c0c6d844e3ec18,1232,FALSE,1750,518,
7dd959a4fc907d1fb4db5ce5ed0df112,1655,TRUE,1949,294,
ae9e9abf0c262590592be0db6d9d59df,1368,TRUE,1825,457,Radiant
a39a6c8dadc58d1ff97a900a295e8f3d,1865,TRUE,2186,321,
b31e63bcf50541c2942ea6b2072922c4,1218,TRUE,1351,133,
088b648cd12ac604a58ce140043bf579,494,FALSE,2412,1918,Dire
5a76b67f17f7455c94f2ac62dec8ce35,2732,TRUE,3710,978,Radiant
58655980bdaf2ecd2043697fb05582ed,582,TRUE,1857,1275,Radiant
4804d41953cfc433b12254e497111d7d,760,TRUE,1893,1133,Radiant
fc77997aaabe63e94786ed9b2267c720,355,FALSE,1761,1406,Dire
e9e3ae6116919937f58083e5932dea77,1470,FALSE,1875,405,
55eaebfc160b29142953ab964558ce33,1675,TRUE,2867,1192,Radiant
a5e2a89510cef39a0781a83c89e5ece6,748,FALSE,1423,675,Dire
932c65d7901627ae1fe72357f0bbe59d,131,TRUE,4211,4080,Radiant
fd823c273f57835f44aceb8ab6bf5854,1239,TRUE,1924,685,Radiant
247fee0d8b59cfb3fe486f796a3f4a05,352,TRUE,2134,1782,Radiant
c022421f2142bb9be99f13724f52b57c,1122,TRUE,3120,1998,Radiant
acb62944716953f3ececf85f2955bcd1,965,FALSE,1856,891,Dire
f0fca69a2bcaf2927fe4e7170a213814,659,FALSE,1220,561,Radiant
23461a0521642e1946af43d5d1cb2b66,1215,FALSE,2349,1134,
44f933403852a6c49936cbeaae31cffc,1341,FALSE,2122,781,
ff21cb5da5d2bcd8b5b94216ba1d30ea,853,TRUE,2014,1161,
b75a4337b460cd4a195c78ea3a51ca5b,660,FALSE,2211,1551,Dire
2d8750161a50906174714a8eca5bd2a2,38,TRUE,3384,3346,Dire
e69c5d3549f1715a6d3050e1445f702e,414,FALSE,2397,1983,Dire
e732c48198d6215e180a104323447660,2676,FALSE,2802,126,
a1f96e3423f84f30af2ede3d9b314f8e,2263,TRUE,2821,558,Radiant
5b937d6fde482588ef4912fbc3712137,972,FALSE,2032,1060,Dire
40e6a3706ad78d11c33e2b9a2f6f07b5,2413,FALSE,2447,34,
c27cf3ad65aa26b213533120b9d0c4ed,2360,TRUE,2762,402,Radiant
a45f15faa1ef4d3f4ca3562f1cdbf13a,1092,TRUE,2824,1732,
32c59cba8f05e437f505879bb9884a38,1629,FALSE,2478,849,Dire
ee771d2213a3996ea8dcbb9b7fd0e44b,832,TRUE,1522,690,
b9f10ee30af0afe7db56bd766153ae93,692,TRUE,2372,1680,Dire
9a47198218fbb2da49d5ef6875ad4fe4,1086,TRUE,2794,1708,
e422b5927db54ab300498055ead5eb28,689,TRUE,1691,1002,Radiant
59345669ab2f555d2630fa975b716805,262,TRUE,1564,1302,
3b8207403c823c8a4875f7298e3bab16,1572,TRUE,2493,921,
a024f1de3ae443a336baddecfa4f0927,2167,TRUE,4066,1899,Dire
3ec72748578113e340700e839c584ae7,1028,TRUE,2323,1295,
59190fee267cbe09aa52047a57223219,777,TRUE,1486,709,
5fe2a02ff76146d7cb445d3fbd44ca3e,1149,TRUE,2335,1186,Dire
296ca5c0d27f26f48329913c4bf58f46,1015,FALSE,2073,1058,Dire
7506dc74846a6c339a76612c0a024588,668,TRUE,2537,1869,Radiant
c22966b8bcdcd55fc63382fa7bd9ccd1,813,FALSE,1663,850,
57795c0b25d12ca6c7c4e76f442512b4,368,TRUE,1886,1518,Radiant
9ee24cd5073ac4c971038b0e8a82cc1a,833,TRUE,1740,907,
52116489732d6295945fe45b7e74eb68,2163,FALSE,3148,985,Dire
1d4e3d778fe6fde1281d19c532888c40,2082,FALSE,2956,874,Radiant
cf0658e21bb333816544e98233906d61,11,TRUE,2554,2543,Radiant
d56d08181660d5c5738a350b2937ef14,2018,TRUE,2217,199,Radiant
7aad827bcccb3d69a8cb1504e6713f35,332,FALSE,2517,2185,Dire
53a0e8d752bd2283a06e2d743fe5b185,131,FALSE,3010,2879,Dire
85bedb56a83c07e8888497c7119abe09,415,TRUE,970,555,
a1ffc241e588c898679b3b651f8d059d,749,FALSE,2706,1957,Radiant
fe6ad370c9a6a51749db6a0fabf79d33,360,FALSE,3045,2685,Dire
403cd9ccd5eab3da1a103c1f1aea2179,347,FALSE,1900,1553,
b0d5fa530f852676e62f926c22f31f09,1047,TRUE,2406,1359,Radiant
921fe8144559f229ffa98909501394a0,212,TRUE,2291,2079,Radiant
4b769e8780d89c440eb4a7b2a3c07736,638,FALSE,1978,1340,Dire
f35256f68cd8ef0b7e9451c851f27e44,920,FALSE,2299,1379,Dire
1aef1c0123c4a4f50044ce967f1f4334,591,FALSE,3734,3143,Radiant
86c088dc12a2256f99a1ea8fad0ccb0b,1664,TRUE,2226,562,
4a0645e55833f969aeffc038812a7558,946,TRUE,1292,346,Radiant
7d0abc6bbc5ee50e2aa6928e61e99616,419,TRUE,2014,1595,
22d3d09281ed1cc60161383922aa9249,482,TRUE,1624,1142,Radiant
b21182bee60eeccbc7a3fe4cf468e96d,475,FALSE,2721,2246,Dire
5a6e29a80eee0d029a40652438d54354,2009,FALSE,2411,402,
b7628f26a25dfcf9008cfd87cbc430a5,2701,FALSE,2795,94,
d8b3798118be5137d12a45bc91689411,509,TRUE,3252,2743,Radiant
112efd9bb8c37e2038445cae0fe5edcf,2104,FALSE,3105,1001,Dire
98a4d83ba692f5a01cbf961b6bc84395,471,FALSE,2744,2273,
b856e907a0dcfa563973637f798fd170,410,TRUE,1831,1421,
4ace2ebc5944e1c832dc93a28ad964b8,199,FALSE,2094,1895,Dire
e3bdb07eb5010ebb99c600ad6c717408,1971,TRUE,2155,184,
0051fc32239a944fc961b28f52b74ac7,1328,FALSE,1577,249,
752ee5e3aaba2ef4a25fb28778b3bf26,684,FALSE,2623,1939,
aa22206586d8fc34c5175df6c6641f41,1956,TRUE,2031,75,
ea136c5395af203f7dc10401ced453a8,791,FALSE,1429,638,
b8f29cbad2b8f80becfa80633693542f,1965,FALSE,2657,692,Dire
799046496136791816724da7733ebdce,1656,FALSE,2824,1168,Dire
81e2a75c60b9051df621870940ec71e5,56,FALSE,2841,2785,Dire
d9b3e15de7aa127fa51ee171127025e8,82,TRUE,2753,2671,Radiant
5eefdc689126308b651341504bb5c1cb,707,TRUE,1737,1030,
6f08349702f09cd85231cc6adbd732a1,959,FALSE,3018,2059,Dire
327b5057b9d0fe6932de022a2f0d3294,43,TRUE,1737,1694,
aff95386610aaba8985e321f57edce7d,3072,TRUE,3364,292,
986e67079deaf0186b338105ad4e2c0c,2956,FALSE,4173,1217,Radiant
115d2d1663925c9b10af6849e332e52c,370,FALSE,1662,1292,
5e2528d9df06c23b531c313ef953ee13,1329,TRUE,2243,914,Radiant
821d100d29104f1268d7bddcf63af583,75,TRUE,1158,1083,Dire
68082347b8c38f668b5889839de0e34d,1922,TRUE,2407,485,Radiant
76f80b6236292ac011579d8cbad6b72a,1840,TRUE,2465,625,
e678763a1f5633a27145d23af984a3dc,1064,FALSE,1127,63,
bb7c5287f49368418d0e931b2c8704c1,445,FALSE,1272,827,Radiant
d2cabccf24587c9f18bac478bcd0b853,2942,TRUE,3297,355,
9b840a5c53bbff90144d58cf40137e5f,2446,TRUE,2809,363,Radiant
32ad9ede1508261c8e6b3723d5f6ad10,41,FALSE,1868,1827,
65c7e51e975ca73163ca2411fe62cb77,1528,FALSE,1671,143,Dire
bbeb6592749d7aeaded793a5cb100593,1641,TRUE,2268,627,Radiant
ce35a7efecec592ae82a3b715e86f034,1970,TRUE,2502,532,Radiant
b1c0376e90e04ea8c3ce5fdbd262c9df,411,FALSE,2494,2083,Dire
0041898b9c6d927ccfe6b3e3546bd18a,159,FALSE,1467,1308,
bd277829c44f44f558eb73bc48a335b2,998,FALSE,2910,1912,Dire
94f33ad7eab4de02f5bc87465ddacffa,1447,FALSE,2217,770,Dire
e0a1e0e4fc9655a5e7c2a0e2edc5abea,1329,TRUE,1502,173,
7f53e022dac46fbd8fab062db63eb63c,1224,FALSE,1697,473,Radiant
302e0d04c942f54aedff42cb0c887320,1157,FALSE,3103,1946,Radiant
311c7146c70d86e09027c07389b9ad35,123,TRUE,2226,2103,Dire
357e3421f48a9f47e8053cd4017ce4b2,1142,TRUE,3675,2533,Dire
35f012241fdb19644bad15a28d3bd14b,3708,TRUE,4035,327,Radiant
9ed2d64e9d4d1e2aa48098c6f42a487a,111,FALSE,1745,1634,Dire
f3effcc8600e9ff322087943c6179cfb,675,TRUE,2993,2318,Radiant
c308e21f74e8d84d164dc676cd3076d8,1326,TRUE,1802,476,
5dcf5990ca850fb48a289b879de618fd,1531,TRUE,4205,2674,Radiant
8d81c9354052bddea63450349b16e822,2407,FALSE,2499,92,
0bb5134d4a847cbf8476fd01dfd3ffaf,65,TRUE,1936,1871,Radiant
37b0cf8a074cfdec19f80d378e8c51f1,745,TRUE,1615,870,Radiant
dc953e220c07be980fdce90571067dbf,1939,TRUE,2248,309,Radiant
66a56eb9b95a8c1f89ca4b1d69364c07,534,FALSE,3166,2632,Dire
577d13b12d823d36223c5e24ecddb68f,3,TRUE,2756,2753,Radiant
839c81b8054b37e1dd562373a8820e52,2328,FALSE,2379,51,
be694d09cd0b152b48eda778ebf5677b,1977,TRUE,2175,198,Radiant
db4f9cce10bf39c3b6eb9276df6aece6,1922,TRUE,2445,523,
8d7e340c20a3587e8a475d2e994a373b,1419,TRUE,1943,524,Radiant
3440011d149ca67f273b1faf862a45e5,2073,FALSE,3178,1105,Radiant
320dc045295e48d6bef0f8ec01d86ab5,2596,FALSE,3046,450,Dire
a0da57c5bef781d8c8ac3930fb8e6e4a,1344,FALSE,2331,987,Dire
0af93c7a58d28238a9c50183962924a5,2537,FALSE,3011,474,
194aea8d4df35d48648089a79cebedc3,137,TRUE,1727,1590,Radiant
4b0d0386e26366cda850ed9331667355,2097,FALSE,2396,299,
3699c05ce641cf463907f4daef2bbffc,694,TRUE,1500,806,Radiant
00a9b6a4eedacfa1ef25a6686886487e,1140,FALSE,2787,1647,Dire
a9952a2df61bb9cb21dcc6f89786b456,461,FALSE,3284,2823,Radiant
2909acf1bb426938e6380e5242af51e9,150,FALSE,1404,1254,Dire
5899d48d821a67c4032db633a5f0d35c,3044,TRUE,3157,113,Radiant
3acdaa2b6d57b18966769ef23e195b67,1679,FALSE,2528,849,Dire
c5e2c0b63254c1d186cdba95ec322ef5,2422,TRUE,2549,127,Radiant
6ec005711eda9ec1f9b41de8635b53ce,875,TRUE,2481,1606,
5e123d1dd4aeb48ca9b8cea2d9a53462,1828,FALSE,2009,181,
df2c1c11108b7ab5d4ad25508370892f,3377,TRUE,4117,740,Radiant
5906ee73ccaeb8c5a34bfb96bc79d4f8,1294,FALSE,2464,1170,Dire
45f98f2153e8d38eb03c53f6477542c1,2530,TRUE,3125,595,Radiant
75e75df9a9940283ff9a62f251e4a27d,337,TRUE,1479,1142,Radiant
e8f92e7893606234a57dfa810e16ddcd,841,FALSE,2033,1192,Dire
46e3ccb6f69c181416d7d22b957db3ce,2062,FALSE,2237,175,
26c570ba1e1a498d6102aecf2d85aff1,761,TRUE,1968,1207,Radiant
f755373c75468ad2d0cd001c6df5fbd3,995,FALSE,1249,254,
9f47f0451044914f6fd8efdc7f8fe38a,786,TRUE,1459,673,
99d81693b7aa0ac818c6d8dadfc09c2b,1528,TRUE,1654,126,Radiant
1f728408eda8a28b7e4731b402fec6d2,1758,FALSE,2077,319,Dire
27a3aa5bae3b023356323fe99e26090c,612,TRUE,1920,1308,Radiant
2dab859eba4fbd05a9dc8573ecbbf929,1794,FALSE,2424,630,Dire
8dfc5da40c7421f3c0a8789a17dd5319,788,FALSE,2244,1456,Dire
fbba04531bd5adad202c09e37cb95e43,1671,TRUE,1894,223,
0f903138943d370bb786ab9c98d10142,556,FALSE,2310,1754,Dire
dca87171519f1b36c508fd6a9727e71a,1855,TRUE,3007,1152,Radiant
575533361a6e8015e4c977c1004fa1e4,1393,FALSE,1945,552,Dire
1c91a0228307f5dac77ae41879c3f215,3026,TRUE,3512,486,Radiant
032a78ffbc62d6ed76eaff8b2244ed29,1312,TRUE,2213,901,Radiant
44e19c25728a37d5f52a2e04f83b1a70,1364,FALSE,1837,473,Dire
a6360ff3ec2d231c11d40a63e71826a9,596,TRUE,1836,1240,Radiant
2ca546d2a5ed693e8879e1c8a51833ed,644,FALSE,2456,1812,
e629e7a1b444580d004e66a81a8f681b,1338,FALSE,2535,1197,Dire
b049268710a05bdb7204fc012235d831,578,FALSE,2055,1477,Dire
04094429488732ca44707bf717e9eabe,865,TRUE,2321,1456,
dd296ecfb8746e9bdd861914c247dcb4,883,TRUE,2674,1791,Radiant
a005e536ebf1a7b6d97fd430a62df164,859,TRUE,2803,1944,Radiant
cae377389d44f33bf382462277036ff3,225,TRUE,3210,2985,Radiant
558fa2ea5298d046653a61b2102a48cc,881,TRUE,2540,1659,Dire
84927b2101a2c43e9b3dd40ff566486d,351,TRUE,2341,1990,Radiant
baf15337220300aa3014d374581b7636,164,TRUE,2698,2534,Radiant
5c18a502eab98636f91007db456527ac,2597,TRUE,2726,129,
4c2869c90464ad8c50cde5f4c89d3c1b,415,FALSE,2510,2095,Dire
d217ab8f2c3435072cdaff1688cc5424,299,FALSE,2069,1770,Dire
e7a4fe3bd68dfd1004d2177fb086bc4a,1700,FALSE,2817,1117,Dire
3dabe5ecef14993e18c6225c510f159d,649,TRUE,2252,1603,Radiant
3a353b1bfd24aae757cffe972232cb84,1256,FALSE,3096,1840,Dire
b132b0f9072a8db0130166801e3132fd,286,FALSE,2602,2316,Dire
5943e84d3422a8985e6a5a22ad5c2db3,1599,FALSE,2545,946,Radiant
83aefa7a46eccffa34d330af9cd771cf,964,TRUE,2357,1393,Radiant
f271655300e47985c737fd71e4c691fc,2355,TRUE,2670,315,
bfc9cb81a02cc9b3db288000fe982119,422,TRUE,2010,1588,Radiant
b84418b2b81a282c2ba64875ee75322d,1503,TRUE,2609,1106,Radiant
b36ced328d54d035becd6fced6aa7fe9,1844,TRUE,3844,2000,Radiant
109139a8fdb4f3801ba3fb5acf89e43d,817,TRUE,2382,1565,Radiant
45f5675535c77690d7d6323624eeab41,106,TRUE,2008,1902,Radiant
c7a4e75d8e28d00ed0990ac0a37180a2,598,TRUE,2010,1412,Radiant
a4b82e87a9f00ef050fe8f773640865e,676,FALSE,2027,1351,Dire
71b5c83eb3a92e62bf823eada44d941c,990,FALSE,2780,1790,Dire
d4b40b08f912efc0053acd1bbffbdd96,992,TRUE,1582,590,
ce782c490fc58abace79a25f5308c2f6,1124,TRUE,2075,951,Radiant
7696819c4e23e06b24003dfb00de6430,1537,FALSE,1772,235,
ab701573253eca95c462238d865c8e3f,386,TRUE,1320,934,
7de2cb3545cb656c095ed9e435b0a079,2796,TRUE,2996,200,Radiant
4eb50a8c6dafb18bdb859910868a3cc0,3057,FALSE,3154,97,
615d8d296cee1838fead02ac1af3bd69,243,TRUE,3267,3024,Dire
7c6f8faa46ac85bc11e921c0f148896f,94,FALSE,2981,2887,Radiant
343007559c399cad2dc71d32ed53c0ce,627,TRUE,1653,1026,
e208ca552289667ac87fcacf046b0455,502,TRUE,1644,1142,
be069d3a9887d46fd4b476d1bc11b222,2079,TRUE,3042,963,Radiant
d381e5ba4f8f4f1065af6b0919a5d3cc,337,TRUE,1306,969,Radiant
9edeca38aaddd60d8704397ea5c54c1f,1530,FALSE,3402,1872,Dire
79982df56604ef71107d9bcc1bfe8f16,2579,FALSE,4340,1761,Dire
8f0b057a39584a1c0e0981a2341d5f22,2078,TRUE,2846,768,Dire
91a9538c3de68e3a77e98c78a1f2032f,970,FALSE,1628,658,Radiant
8532b6bf3da25f769ee6d0d3308fb07c,2152,FALSE,3122,970,Dire
934bce9c6e3baf02e4f9d74a1be13446,625,FALSE,1429,804,Dire
97641bb34dcb2eafc6e90665b538c83c,41,FALSE,1805,1764,Dire
c1963915846498c0fb03d0dcebd7860b,278,TRUE,2894,2616,Dire
2b9484e4e03473fc9e5bf283b750a2b4,1988,FALSE,2273,285,
7679ce382e1230199b0582f3a0ad3c2d,672,TRUE,2245,1573,Radiant
d4b368b5d6c3223ddf33353b169bf785,2074,FALSE,2546,472,Dire
98f469027bbedb450a729f10fc5ca315,2037,FALSE,2506,469,Dire
bfd92a4efcc5d094e1c28398b9f87195,1520,TRUE,2859,1339,Radiant
30d37c1348dc76b7c14d528a9a808044,1428,FALSE,2987,1559,Dire
806bb28a630c9cee4fb4515e25cc5c19,228,TRUE,2500,2272,Radiant
cea3780d8ce52e699223fcbc3b0d653d,179,FALSE,1890,1711,Dire
fc4c2bb9817a5c86d28c0106e00020a9,1620,TRUE,1671,51,
395e2cfa27da2e3b10f15493c5a2544a,862,TRUE,2093,1231,Dire
b9ff8f8685a4d35583d0618d1003b294,1035,FALSE,1197,162,
664be6a65653b7e6a2404433420787a0,2470,FALSE,3088,618,Dire
08ca453db6fc5d3098ed5ad20b3b5690,2447,TRUE,3111,664,
920284dca73c4ee9130d398b6065787e,2175,TRUE,2278,103,
532a322518713141e69a4867d885b72a,2726,TRUE,2844,118,
686d20e1a65274012dd9cd77716f6dac,61,TRUE,2917,2856,Radiant
8566a3ac2618ba90330d70d9bb4f9420,928,TRUE,2537,1609,Radiant
f0ef409345ef32625fe8e49885493dcd,380,TRUE,991,611,
57c415810974693344e8f462f6275ee5,678,TRUE,1673,995,
ee59f3215f9ce68316c9d1ee0a2c6b65,1299,FALSE,2724,1425,Radiant
740655b7eb302734079c6337593367ff,1021,FALSE,1605,584,Dire
7a2aa8648f3e68128da9f680fab9c22c,863,FALSE,2274,1411,Dire
08d6ea0fddb07d14c6352f98690de447,732,FALSE,2016,1284,Dire
1eb0c2ff119d3ca0f03a7337a4bd5ccf,330,FALSE,2216,1886,Dire
8914d9d4199045ee717689b676a35b60,1003,FALSE,2224,1221,Dire
40b980cf4c84cc9c3c3c880d6f16f001,1913,TRUE,2062,149,
221a502965aa55bc11c11daf1e8469c2,346,TRUE,1762,1416,
a6d265bcd626697e75f465a279f7ebda,625,TRUE,1646,1021,Radiant
4dc4a9c50c88406b00553ac75f87e47f,124,FALSE,2008,1884,Dire
ec73e287ec36be75e67271535dac5bb7,2439,TRUE,3484,1045,Dire
7e20c0ac7d2f4a6418fb92b1d0d8f7bc,1732,TRUE,2906,1174,Radiant
8e251f6b90172d13309638b0c56e8fee,554,TRUE,1902,1348,
cdec4aca01d8b5fbde666e6377a7e60c,1508,TRUE,3533,2025,Dire
e65455375e9ee44665fac472e29d29ec,1753,FALSE,3272,1519,Dire
305198c02a6fcf17bba295b20ce3d409,1537,TRUE,1595,58,
33471373c1c7054b356b2d3dd1000763,1036,TRUE,1470,434,Dire
fd7c80b6a3ad6597141d3e9b532c0acd,2245,TRUE,2339,94,
ed2d121f426ceb7ab13c9f8bfe4760a2,304,FALSE,2362,2058,Radiant
2e262d52a1fc27f036360b23a254a690,202,FALSE,2032,1830,Dire
3a36258fec9df118073b77d589145f86,842,TRUE,3705,2863,Dire
2beadc966f736b1da9b51ff7ee349b71,391,TRUE,1394,1003,
63e979dc79c32f73909986e64c68ade8,662,TRUE,1017,355,
4e0695407256897f89099f7abaaef93d,246,FALSE,1550,1304,Radiant
8ed46dd66a9f303e205b4d5dca22fd6b,758,TRUE,2171,1413,Radiant
80548749e0e308fe3cbac4ae08cb68fb,1848,FALSE,2115,267,
f01f344b4c5007d65906c4a2951bb397,121,TRUE,1932,1811,Radiant
e649a538f2ac5bd88170a1696b88d63c,277,FALSE,2118,1841,Dire
d8fb1be799d256236c7859b89bb2bba9,1109,FALSE,2327,1218,Dire
0d8469d772f74448c5e4b72751d6cac2,809,TRUE,1528,719,Radiant
a7bcb6a17df75a35a4c1d75f8c970fdc,1383,FALSE,2414,1031,Dire
5e57fa7b22d39183febc50023ac92bac,1122,TRUE,2892,1770,Dire
7a9e821e9a499f81e874f936a4933f88,1510,TRUE,2087,577,Radiant
aa779e2a99e4d1ae3a7551ed5ac91ebc,1001,FALSE,2202,1201,Dire
2d1c238f3294a733a8db34d085096203,1273,TRUE,2477,1204,Radiant
5776f694e8e4323817e2ba616e74b248,827,TRUE,1590,763,Radiant
4b321437e26f7c4eb2168d4041ed78ba,1560,FALSE,2152,592,Dire
7f22cc0c978bb9bbda4ce9953bf0383a,293,TRUE,2481,2188,Dire
5d624adadc780207b80635e6d8cb7bc3,1213,FALSE,2334,1121,Dire
7f837aa273c26842c2289f18696542a2,1157,TRUE,1680,523,Radiant
6bd6a2b3610b25d2c4032546c57ed373,439,TRUE,1796,1357,Radiant
e23caade529b09d0fe5ac22490388d2d,810,FALSE,2146,1336,Radiant
0e33d213326cc9dce9dcf19cf6c0d74b,2777,FALSE,2813,36,
1b909beb9e3cf5999487c249dbfffa4b,763,FALSE,2802,2039,
06bd448c0c7bddf88b03714e92048da8,1225,TRUE,2007,782,
7957a17b77b93b713834814a59a29541,182,FALSE,2822,2640,Dire
98d3b9427fadf8aff581bd19087ea592,976,TRUE,3221,2245,Dire
199bb639c328b131b4eebbab62294cb4,1060,FALSE,2837,1777,Dire
bb687b6859575dbe301ee34ecb16567a,1087,TRUE,1764,677,
b2961491c541789b62a97564f359de4c,860,FALSE,2334,1474,Radiant
ea4aaf6becee522b61b814200bef633b,738,TRUE,2247,1509,Radiant
6fbd1118b267cfb147a55201e1cc77e6,51,TRUE,2143,2092,Radiant
eada4fcbb905b3209b5a9888528a204f,2234,FALSE,2526,292,
1c9ed97842c22f6957114fd4ba2b0ab3,4,FALSE,1723,1719,
586ec41f44fc9bdbe3ef60f48c34fd95,269,FALSE,2913,2644,Dire
6181f99c7abe555daba99ca3dd2e8668,109,FALSE,2442,2333,Dire
20165d82c6d5889b6400e8e7f26b75da,738,FALSE,2788,2050,Dire
1c7da6c49638d9f18ad2aeadadff94a6,53,FALSE,2340,2287,
0bf0a3ada7b3d233d828fb14bca3a333,1729,TRUE,2965,1236,Radiant
6dc793098c6fdd53e657045d56cdbd81,1105,TRUE,2375,1270,Radiant
1a1e30b972e336973f83db28b0e9a148,270,TRUE,1626,1356,
dcf3a8423003736b48db8037f6ef70cc,1533,TRUE,2078,545,
47b5daa13f63678b0ec52e602597fd34,1228,TRUE,3258,2030,Radiant
d769a0c8e60fe99b31440c5db624285a,2140,TRUE,2309,169,
296432b3d5623d4166b0ae7fd2976b98,2290,FALSE,2763,473,
25d2174f3befd7c8013fa4a27ba4e911,549,FALSE,2202,1653,Dire
2d2cd8a0efe7836e1e40d22e6bf99bf3,462,FALSE,2693,2231,Dire
bc87e39a492b655588bea367286bdd5e,1855,FALSE,3164,1309,Dire
d2f778e6ce654b9e61b12b3e6642ef21,542,TRUE,1927,1385,Radiant
23511e8b51c37693f4b59006949bb282,2441,TRUE,2541,100,
c8ec3567f3a91945f76790ef60ef08da,1410,TRUE,2567,1157,Dire
f6f79536121b2af226611e13006a8267,2260,FALSE,3816,1556,Dire
79629858b12e9d2f0685a8dc6fe0efc9,541,TRUE,1004,463,Radiant
6bb26939ba9cc41a340c65fa13593897,1856,TRUE,2224,368,Radiant
b9595e413ba9e8520c3f46a0f05ee97c,1,TRUE,2784,2783,Radiant
3db8e32b9cf7fbf8e6e5bef835fe0a44,1020,FALSE,2665,1645,Dire
e9bb6f173f00c06f82dba60966cc6fb4,1029,FALSE,2624,1595,Radiant
1946ce1af1ed38981d2d19650979f930,2453,TRUE,2813,360,Radiant
8263e02ba436b93b6a3284fba1818f84,369,TRUE,1434,1065,
41474d8e2739938751bb4f92d0ee81bc,883,TRUE,1956,1073,
adcc2f34f1fa4de6e46b12b343a797a7,161,FALSE,2135,1974,
56ce26916f70a5d84719214ce1a5cd7b,353,TRUE,2705,2352,Radiant
2d178ea37a3ae20be921406223d7e5f7,1425,TRUE,2699,1274,Radiant
f65c909837d3e6683d7a5a9b40a33b2f,1899,TRUE,2959,1060,Dire
24698fe21c56172298e232642f296fc9,1641,TRUE,2475,834,Radiant
95e1aee7e799deae7445de3ec2f3bc5e,452,TRUE,1638,1186,Radiant
0b583d173f641fc268e54cf52255a890,783,FALSE,1738,955,Dire
15a2c347f54a772e53730265769216ed,318,TRUE,1599,1281,
55026cf040a8370a01a682c832b43785,38,TRUE,2355,2317,Radiant
24b1a413ff7f9075bcc65bb6d6b19548,2153,FALSE,3170,1017,Radiant
6c1bd5c3a79c9911106801e5ff30b684,1191,TRUE,3955,2764,Dire
ab771c4a4df5f589f35bd607572365ca,1751,TRUE,1882,131,
a380565aea041a75f0b8a73da13e287a,1075,FALSE,1871,796,
c0c7070fcfb197fa7399ce4669520f36,104,TRUE,3719,3615,Dire
519b2604eaecba4456e378d8900be044,715,FALSE,3628,2913,Dire
c5b66dc8fc8e9a5bc41a736c3d577a29,1596,FALSE,3106,1510,Dire
0a3f8b2dc808416f0ff605db7c37c550,927,TRUE,1807,880,Radiant
4dddb9cf04e85d938581a266b01299bb,538,TRUE,1709,1171,Radiant
6be83d80e8de6c357388c27de2d7944b,334,FALSE,3518,3184,Radiant
1cb7d95e73f53c1236faa356f8c703ec,1778,FALSE,1936,158,
76250cb88a57202841fecb9a247ff6f3,1955,TRUE,3117,1162,Radiant
0cb76810e2fc8fb297a4b7f3a868ce86,2818,FALSE,4087,1269,Radiant
18a15cedf126c8b14ce1b2f1f0cc67bd,54,FALSE,1741,1687,
8ff512731eba32f469a6933a2f85941f,1451,FALSE,3003,1552,Radiant
fa348a755a84613e651686061d00e622,1464,FALSE,2595,1131,Radiant
e47406fa1fd53679a6fc1ab0d4444c65,1017,TRUE,2700,1683,Dire
4abae72c42baef87b78c641b466301ca,496,TRUE,1016,520,Dire
73bc4ad4ddad26ddf7947436bd1a1421,1773,FALSE,2451,678,Dire
5029b07223746c25e81e0b92d21f15bb,819,FALSE,1006,187,
88e3eb360e61a3d36357b67b023bff25,1173,TRUE,2784,1611,
cc9098c9b07cdfe19640368fee0e3bf5,630,TRUE,2631,2001,Radiant
a2c1e08f3ac7bdedc0ce2d2385b757a0,857,TRUE,2130,1273,Radiant
099669c1497e4a3a2e5a4be9d9e0e22d,375,TRUE,1990,1615,Radiant
33af7f84868513de954ce60633fce8d8,1842,TRUE,3097,1255,
a6371c42206a5d22c3e58b08920584fe,417,TRUE,2639,2222,Radiant
bba65737b265e2c2e7ed02ee8106cd08,481,FALSE,2403,1922,Dire
d962e1684d6442dec714a2369e62a003,1113,TRUE,1537,424,
70ecde6683797248f8d1ed78397b0be6,1614,TRUE,2995,1381,Radiant
11b242e208205e31b45e87eecffe5ede,2224,TRUE,3469,1245,Radiant
c0db5800aa79bf3bc2c500ea9193d6f9,1909,TRUE,3114,1205,Radiant
b33cd949ff716867432ab7e7521fe4e2,1724,TRUE,1995,271,
78d9ad0bdae4da1e2cdcd7b783d5ac94,1092,FALSE,1729,637,
2a4ce1f0e38888eaefcafcf9ce82846b,920,TRUE,1259,339,Radiant
9841a20343ea8577913395790f27fe18,2139,FALSE,2645,506,
72a9a6c71f32479328d9f2e64f071656,1761,FALSE,2257,496,Dire
ebb70a905828a40233c09db0aec134b7,2930,FALSE,3462,532,
3b7a177f7b181b7c42a703f845d4d13f,1050,TRUE,4238,3188,Radiant
ad9a3a0e8050d448f63e8b2afa478b31,2371,TRUE,3048,677,Radiant
15dd4d5733f9c701d107498e3198be8d,2010,FALSE,2449,439,Dire
69f071dea353cb2df81353aea19dcf56,1596,TRUE,2219,623,Radiant
b3c715202b9e5abacd49a6d50eeee50f,1171,TRUE,1382,211,
7ebade70a82077788b007734db548b02,1733,FALSE,2400,667,Dire
a34a28d2639fae4572e305e226e9e6a9,1116,TRUE,1634,518,
314d165441286cffb40a2629cccd8d12,1532,TRUE,1999,467,
9a098cf4677efc4904cf60dab5f16550,1636,TRUE,2107,471,Radiant
ff4f12810723ee7b563461fc77433a7e,2092,FALSE,2763,671,
24c727d83a65060af7bdf957fc4bb093,2421,TRUE,3177,756,Radiant
3772bb6c2ea83f253f1c55d9772e7375,308,TRUE,1176,868,
3a60ae16f9cd77771f639233518c1c6f,989,TRUE,1245,256,Radiant
91a38cc8899a44946a02cbc980d0806d,841,TRUE,2289,1448,Radiant
6c8a8e16a36ed32ffd9304a5e47eac15,1098,FALSE,2453,1355,Radiant
1c92dc328f800590f2156923ed9cb06c,672,TRUE,1345,673,Radiant
b78b8438aa8ff724ee99bca77b3b40a4,1570,FALSE,3438,1868,Dire
e70dbccb8de4e87e663d1535554c6268,1288,FALSE,2488,1200,
7370965eb70fc9c6bcf78c036922d454,812,TRUE,3045,2233,Radiant
a3a7361d50e5f1c0d6e69317ec8b69cd,2015,TRUE,2787,772,
4e21847847cf9ab2834bf58b492a84f8,2208,FALSE,2399,191,
b7b8a8e6b6c8c99b945ae8ac2aea61e1,2039,TRUE,2899,860,Radiant
bda800c4eba840ed9a659fadcbce994a,1252,FALSE,2099,847,
f6dc14b6d2a01bf6f48d90664bc7d36b,819,FALSE,1557,738,
cc4c173705904966aff05ad28edb965c,1891,FALSE,3264,1373,Dire
728ea10cc01b81e972388ee1f0f614a5,1335,TRUE,1672,337,Dire
7e948f7c7c6ae4566c3d87b9778bc6df,741,TRUE,1726,985,
f19c371e158c545c619dec97d02c72f3,373,FALSE,1551,1178,Dire
41955e89a5d5a404a598f622a3a4f5a6,1372,FALSE,2374,1002,Radiant
3e991dae595bc86af6fd77050721d12d,1596,TRUE,3714,2118,Radiant
9301bccd1fe67fe35d881bf067f85ac7,1108,TRUE,1565,457,Radiant
dc94bd074b4387fb3b7fadb361cd1793,595,FALSE,2405,1810,Dire
2c944c2d0f1ebc610f0e5aeec7e9eb8b,1514,TRUE,2737,1223,Radiant
857536bcddee0a2d8d0d34b4d955f4f8,680,FALSE,3749,3069,Radiant
8cddac259c7942d88be1d229f394cef6,498,TRUE,1732,1234,
fc13d22a84555ada706e13bd2ac8d7d7,1621,TRUE,3559,1938,Radiant
69c4eb0a5e34fabc4c376fb2d4e83ee5,1919,TRUE,2251,332,
abb5699fb89cbd1b937aa008f8d222f9,1829,TRUE,2188,359,Radiant
dc9c7366cb01b0972f7fbdce9a997216,327,TRUE,2543,2216,Radiant
e1707ce1f8c1dce708b5db5ebd3f7b6c,2058,TRUE,2875,817,Dire
fd6652b4b64da49d177b960392c79de8,308,TRUE,3043,2735,Dire
69bf0c1b2fe0ebe262c788499a1f4582,3026,FALSE,3157,131,
70a9ef177150894b79d982ecc42c2992,568,TRUE,1334,766,Dire
63dbde2d809ed528ffe851a823f82284,931,FALSE,1656,725,Dire
65a59b781301577d07de260e6cd0a3b3,2032,TRUE,3003,971,Radiant
1ebb5b634381e028608f56fc32cc105d,644,FALSE,1597,953,
e71457212784f12a0f670b387cb46af7,363,TRUE,1227,864,
f36b8fefbf42d90d2e9fdd2ee39370a9,1622,TRUE,3383,1761,Radiant
f1df0a31ccba73c5ae18de199af25d20,2153,FALSE,3885,1732,Dire
8e31c505ea2eb470d2d96275d54bea02,1337,TRUE,2064,727,Radiant
5e01e7a796961f7d87086a435abf8892,593,FALSE,2941,2348,Radiant
0da86a2c6f683864d94c4d24499957eb,737,TRUE,2478,1741,Radiant
350521b21006200cf3ebb1a89f2fb208,37,FALSE,2478,2441,Radiant
95346b8ef0fb3797119e7ed1c2c93ae8,121,FALSE,2656,2535,
78f8075d88b5724555a33dd9fa2db5cc,494,FALSE,2758,2264,Dire
bf8e2b7589e966745972cc3c5e357f04,3069,FALSE,3392,323,
a6828d1ffb9414cc7233e03ac7386fe7,102,FALSE,4125,4023,
d68410d95a4e43aeef1a3a7910fcb71e,1990,TRUE,3124,1134,
7d68368c3f693aa45532b7fbfcfe97b6,2070,FALSE,2136,66,
af23334f14e35f2b16ffa3cd89292c1f,852,FALSE,2488,1636,Dire
1d59e35d207056fa7a4184ecf40142aa,485,FALSE,2585,2100,Radiant
d6c0d97a9080dd3dcf97de6a2b91cdf7,1226,FALSE,1584,358,
869bf7c456ff5acea977456932772894,525,TRUE,1206,681,
c78841a97bfe38f8e694d6192509f90b,2646,FALSE,3011,365,
ccb8eeaaa2909ae66997d83f912d33cd,2480,TRUE,2635,155,
1fdb9b37a0e93ecd55b818dda3555bfd,2209,FALSE,2711,502,
ca7804b7366f3a80d7798bb878aafd72,663,TRUE,1444,781,Radiant
28e80f898e9a3af6b24b049520b6d046,1897,FALSE,2000,103,
90ec21811d0c09c944f47f2c1c0db86b,13,FALSE,2583,2570,Radiant
fd473cf39dcd86a70ab8c03327106c87,1280,TRUE,2079,799,Radiant
24561c7c531d34eeb70613fc4cb904e7,1377,FALSE,2730,1353,Dire
7f1c2e208dc7f91dae1cecb47f016349,2954,TRUE,3942,988,Radiant
c5798dc6923eccede22df90fd4da918d,1100,FALSE,3211,2111,Radiant
8061badbdcd6ccdb5ef81eea2d02a6cd,1280,FALSE,2771,1491,
caa7d4a9eee30890acfc911811ff5e7c,804,TRUE,2699,1895,Radiant
537c1e3a63d58a13348a4e14e9113b32,86,FALSE,2848,2762,Dire
c257643c0da0f4e0345ac1a0fbcaec4a,1198,TRUE,1822,624,Radiant
9507216a01691398fa3313e615bd7a9a,57,TRUE,1733,1676,Radiant
9850ec23ddeadbe087ea36f1873e1c86,499,TRUE,1518,1019,
7549dd9779214420d429d6e16f49dc3a,1454,TRUE,1501,47,
10207d9125de11928c5428047314175a,2547,TRUE,2832,285,
11b9cacfa0d9d3ae40124daf11a30f59,406,TRUE,1234,828,Dire
106a511ceb087dfd573b34bde3dce181,2618,FALSE,2962,344,
629105d1c491d5d9cea4d0041144ede1,1061,FALSE,1190,129,
11e5c113473c268171534a8e08408cce,548,TRUE,1861,1313,Radiant
b2a146e8234694baad0b9230d4dacede,373,TRUE,2155,1782,
d91c6c8aba519b4983d092879b3f4fdb,653,FALSE,1550,897,
364d97e1670c0a8b0a19ffcb3e98aecd,1286,TRUE,2425,1139,Radiant
6f2aa7c57b901989e26c3ed7b261ca7f,1933,TRUE,2069,136,
06544be597e5c9ffce3e5a0d2ff6828d,613,FALSE,1063,450,
59b7602c92bc4f1b38af7ec09dfd2a8e,1409,FALSE,2461,1052,
54dc0be64664e776b93ec84b1829f141,413,TRUE,1970,1557,Dire
9211986b87ac7ec9fe0cc172970464bf,509,FALSE,1657,1148,
2c9ba37581ab1a16cf7ab9de3765ad43,507,TRUE,2327,1820,Radiant
ccf48a02191069e56fea96af8da8f2d9,2100,FALSE,3002,902,
a1d97a873906ec6a0e977463b3815790,539,FALSE,1464,925,Dire
8628b878f05586e6d197a98f00d7dcc6,1365,TRUE,1726,361,
acfc5fb14e239c9bf71ca43d3c7a042f,1677,TRUE,2793,1116,Dire
0664b0cd6760abd70feb3fbc561b0630,488,TRUE,1477,989,
b594e579c589bd1a3f224fd4fd3bc57a,276,TRUE,3397,3121,Radiant
51b860691efc8ad67bb6a3f6903590f2,2419,FALSE,2635,216,
8695cf7984ad67d4f72d2ce8ee861f05,1329,FALSE,2790,1461,Radiant
ab8c1ba6b15237c257aeeda0c1917f93,408,FALSE,1944,1536,Dire
072de5efd7fbff544d70830cc11711fa,889,TRUE,2474,1585,Radiant
9057d45c1ec26d44baa58839f1f3dc41,915,FALSE,2268,1353,Dire
270bfd3dc627c1911f31c4c871793cf5,2050,TRUE,2368,318,
772e5a7f2fca14f24b699db4003e8e63,39,FALSE,1586,1547,Dire
9328ddeedfc9bbde2be8a195ea276156,659,TRUE,1901,1242,
fc6e52dab1c53e66edc8cd27e71a23b1,1451,FALSE,2098,647,Radiant
2fe7b1bc1dcefc32285d27886bf847e8,804,TRUE,2044,1240,Radiant
b196885403b5c20bb4dce7c21a7aa51d,1478,TRUE,2148,670,Radiant
6e38f717a96cbcd49e19e743a2adfa41,626,FALSE,1535,909,Dire
f41c3913e4e3056bab35c760ff3fba15,880,TRUE,2617,1737,Dire
e5b522fde182be324cedea4614f4dc05,2891,FALSE,3187,296,
2409388231219f41e8b3f43ba3d51ad5,552,FALSE,2072,1520,Dire
f45a59b9733b633d4edbe2dd39e6f90e,1864,FALSE,2906,1042,Radiant
3b808f5704f46c813c2557724b5a52f4,702,TRUE,2153,1451,Radiant
6bfc5d8f57bd121d5c761c98723c61e6,1197,FALSE,2234,1037,Dire
45a7cdd5ffa4c986ebf7f165e3e25747,158,FALSE,2435,2277,Dire
498ad1c6a076147315addb60495471a3,137,TRUE,1241,1104,
6f3b56476eae5ea1243e371a9bb52134,240,FALSE,999,759,Dire
f811ec57f543f76735e92d0ea93ded6c,825,FALSE,1393,568,
3aec5935d15ecfdb4b0d662c89222bb6,557,TRUE,1669,1112,Radiant
0f779ea317d5d8e4d9986a1096ca5686,1373,FALSE,1906,533,
62d4b091ea23eada249068a43b2553f8,501,FALSE,1733,1232,Radiant
d6899b6a9c5828e8b2645191c386216a,807,TRUE,1358,551,Dire
a9573df10a0dc146d266193fb9c2a7d8,704,TRUE,2686,1982,Dire
3cd2909ed6e1a8c9fb0b2d76966b0312,1854,TRUE,3016,1162,Radiant
8f8d5b6d23f438a500043862b5df319c,922,TRUE,2506,1584,Radiant
32609946f2e5118b351fab547967f576,220,FALSE,3399,3179,Radiant
fd6791ea1a1d8855b56c101799d79254,492,TRUE,1524,1032,
6bdf6011a85c3d8b9b5ad72fb7300f36,2332,TRUE,3686,1354,Dire
199920846d25028fd8ff60195d79928b,1346,TRUE,2942,1596,Radiant
7d362a004c9669d3180c6ef713512889,193,TRUE,1936,1743,
f65157bd56a027e04965c17c2c5f83de,599,FALSE,1814,1215,Dire
75415dc63a0f81f6c8a25c71e2d70312,85,FALSE,1922,1837,
90112e498e10cd89d404ccd256b2c6e9,3249,TRUE,3983,734,Radiant
56ba7cf89d838b9db9037b465f7d2cd1,2640,TRUE,2775,135,
013ce5f01ac208ce8e74e0f3ec1a33b4,1201,TRUE,3250,2049,Radiant
9cf6cf904691598b08a44690e358b57a,1735,TRUE,3174,1439,Radiant
794a80b29fcaefa69f75b3f249c20388,1564,TRUE,3599,2035,Dire
d7c4148ab558aaad463c03a17f562aee,1298,TRUE,1744,446,
0859eb456e1a363da93c13f4aa9a8058,2086,FALSE,2791,705,
d27e9529a0f9e1983887ecb7b560c931,1697,TRUE,2216,519,
d8f6415d66ddb215f8936b5c86677d48,1687,TRUE,2492,805,Radiant
6992354477c4bb404f8f54a99fe71b15,2027,TRUE,2179,152,
5120a649acc27135874866d7aaa80720,1235,TRUE,2214,979,
f9da8204df733998375b143a4ce2f1bd,1697,FALSE,3418,1721,Dire
a3b5dde3dfc5719f931f564ada63100d,538,TRUE,1580,1042,Radiant
846bab614148ad84a2c96859e8d3ade4,2041,FALSE,2663,622,Dire
3695122f50c8869037227b787722435c,1020,TRUE,1882,862,Radiant
caa52d5ddd2001178c478e85e878233f,2049,FALSE,2946,897,Radiant
285ce20e6e5ca8f2cd4d8baac9abd648,3276,FALSE,4085,809,Dire
ad55c56c4a1879f00c2349173a889a06,404,TRUE,1663,1259,Radiant
b5e67211b493cf2489ad5cde266f9bf0,85,FALSE,2231,2146,Dire
e33decb6154c5b5b73f0e85744c39d71,913,TRUE,1888,975,
f97e570336a17ebdcc08576f9f7086c0,1557,TRUE,2039,482,
9e82768b81d168aeb6399e6802adbe97,19,FALSE,1714,1695,Dire
8a0f64946778a4f1e24fe8e46e1b94c5,677,TRUE,2439,1762,Radiant
42de1cb158720e389806971c0ded22e4,181,FALSE,1913,1732,Dire
965a4d8d29145c5a13d276878c766a90,310,TRUE,3234,2924,Radiant
ff5b09e3b2cd70edfcdb213d7d351ab0,982,FALSE,2134,1152,Dire
c1ef9399165efb7e30dda598b3e3d2be,1254,TRUE,2146,892,Radiant
98124462f7b646743714fba3f0417fc8,466,TRUE,1404,938,Radiant
3f0648ef8e15ee48697c05dfc3dc550d,1709,TRUE,2024,315,
dff7ac9bfcb22ccce5f8ce957ab9d41a,1043,FALSE,1418,375,
f57c168752808d1546b1f2765e23c05b,2398,FALSE,3825,1427,Radiant
2f26832e00e12f686d723bfb616327a1,8,FALSE,3099,3091,Dire
dde4937343bd309607f893563d556177,778,FALSE,1910,1132,Dire
3fa1653d5f8069175f1d86c339e09025,143,FALSE,1570,1427,Radiant
f0898eb5d264561039fd71f1b76aa320,2325,TRUE,3671,1346,Radiant
c49bf3e5b57c77fb4580bf83013fbf9b,408,FALSE,2458,2050,Dire
eaad693bdd1acc878ebde64c9db1c0fa,2412,TRUE,2765,353,
d858e0b09387286e507172108bc17143,114,FALSE,2876,2762,Dire
e72a20aeb03867fff32ffc351fc497e2,1788,TRUE,2781,993,Radiant
97bdeababf76bf44420c5fb9523f59be,2342,FALSE,2833,491,Dire
dde1a975a9bdbae10a744a54ffad8006,275,TRUE,1318,1043,Radiant
7fdf9470b3c635aafeb618789d0062cf,2006,FALSE,2119,113,
9be80b0812a9f852e9d29db9519c5a89,572,TRUE,1076,504,Radiant
3de1853f5b7e147327dd16d97c381676,946,TRUE,2242,1296,Radiant
7f4978a5f0f9d93c1cc7daf85076d470,1586,TRUE,2243,657,
2c7c217b096c6ab32044c689c7f48f93,1290,TRUE,1349,59,Radiant
7cfa9e8a3bca2dd60156ed2287f5ae88,94,FALSE,1713,1619,Dire
deb44d6344fa99a98f3f75639c7ce30f,40,TRUE,1949,1909,
527177dbc3c5299fef706fcbb4990096,1757,FALSE,3050,1293,Radiant
c79412e704f13009e79bbe62a847b19e,1138,TRUE,1830,692,Radiant
dc4d195ca9880c55e2b01d07059236ae,1502,TRUE,2160,658,Dire
bbcbd2fc4c0aa9f8fee819d7b937283e,161,TRUE,1552,1391,
c3a8f5e0d4c8830f3aa4795b0683be4c,3283,TRUE,3597,314,
f6e1abcae3390e266d26159c85265619,2438,TRUE,2755,317,
fd8e2b14a88bab7a989cb04c348e0bb1,2157,TRUE,2749,592,Dire
f161a980396b12f421590644ba50a72d,691,FALSE,1633,942,Dire
ec487374ca6809aee2f7f29f3c3d3edb,396,FALSE,2078,1682,
5f80b4f327e123b896054f1f3aed6eee,377,FALSE,1645,1268,Dire
6ce8da874a4c204a738805169ea3f22d,1384,TRUE,2181,797,Radiant
8465af34e87b3bf3e5b172680ea39f0b,724,TRUE,3043,2319,Radiant
083a386a90f6303d6a2f57f04abe22d1,168,TRUE,1974,1806,
5e8aa2d8aef3b924bb3bb4ffed0a8e12,68,TRUE,2437,2369,Radiant
b6ad802f732e700107c081ee3f1c2e2e,1119,FALSE,2302,1183,Dire
13201bdf5526ff1b1fea3126d963fdd4,2638,TRUE,2698,60,
ec1a1cbda2deac2e05603dc6c35cee71,1773,FALSE,2641,868,Dire
fce05477c7f8f31fc8ddaf661ae2c5dd,409,FALSE,2278,1869,Dire
f78748408d82225a6933b024243c4992,1321,TRUE,1426,105,
78989be5d4d9df4800355597efcf012d,1326,FALSE,1951,625,Radiant
88d6c6a2fc80daabb589dc8fe81aaf11,993,FALSE,1569,576,Dire
79252b5711114aebd455db49ba01b9cb,345,FALSE,2219,1874,
de4870d86b943a31c8b9cccf145c4c22,251,TRUE,2290,2039,Dire
29e7e0fecc006398c610442235761b84,3385,FALSE,3430,45,
8b3c7d27e599357c49b291426c5c9e50,698,TRUE,2504,1806,Dire
c2bcfcc09feef3472f3140c7dcca4337,307,TRUE,1985,1678,
0139a4a1ece069d306998de880374bbd,275,FALSE,2164,1889,Dire
57e29145f7163fb5d985fad387f05213,1053,TRUE,2593,1540,Radiant
85b10e85ca0087e501f12f310305feb4,198,TRUE,3083,2885,Radiant
088e7ef8e6343a67986740a9febd90e4,1071,FALSE,1180,109,
37efade1bc38860d769822319c7cfa3b,1106,TRUE,2358,1252,Dire
0d89a71e417df51819dbc274afbceded,78,TRUE,989,911,
478ffbc0a7dc5fa477eadfda45d27cb1,1895,FALSE,2030,135,
faef11f152df21bc92ff7959f3591622,1360,TRUE,1538,178,
565e194a3e2ba9e0fe0f670da4f71e71,199,TRUE,1898,1699,Dire
fd5c9de2e179fe1d037edc2b4ab55d00,604,TRUE,1148,544,
6b022f1d295884bc6247e19232522bbd,1179,FALSE,1824,645,Dire
e3820c679ab7dfeafef3895cd4508185,241,TRUE,2210,1969,Radiant
8ebe29deb45ec4ef1328e8870450eacf,1695,TRUE,2235,540,
9940ebad8802d08cfbb96b6126676043,688,FALSE,2489,1801,Dire
509887d3f078dd38363f86b4a9252987,1016,TRUE,1923,907,Radiant
a8cbfd353ed7ab72ef1887fa15006ea0,687,FALSE,2002,1315,
398d6a19682891c3a1ac887539349720,3380,TRUE,3473,93,
c8eba019f085ac27a714c2131102baee,1378,TRUE,3384,2006,Dire
5278eadaaeee821625553037141a1a16,106,TRUE,1728,1622,
92213828fab90b539b70eb433ff00e04,1203,TRUE,1791,588,Radiant
4efe11e440eb1826c611032ace9aec8a,2473,FALSE,2544,71,
77a16863b58f80c3e9137a34c1c2d2a9,2398,FALSE,2685,287,
179190e660f813a8cbb231fbbbdedc9c,1783,FALSE,2240,457,
23bd1fe1e1d0ca0416adabf452b46b56,123,FALSE,1626,1503,Dire
67d974e3e7cc61a6113d474186edfba3,742,TRUE,2173,1431,
aaf953786824881ca8db768729cba980,2143,TRUE,2389,246,
949c2ad01aa0a80a1e969697903b6671,1171,FALSE,3176,2005,Dire
0f08c77320a83870fe4f4fff556d60fe,2488,FALSE,3303,815,Dire
fe5ad96e02492f0ef7754b57cf99e60c,1959,FALSE,2840,881,Radiant
2de938ff7973849cc57adaffad873869,627,FALSE,1753,1126,Dire
91bfb617d731d15fd9c2514f425dc202,385,TRUE,3573,3188,Radiant
25469305816411d900c571466bd4b0d7,637,TRUE,947,310,
32bca37b251f31079e94902c115cc1c9,2832,FALSE,3425,593,Dire
501fe7668a6869764eba5a73a985f04b,1513,FALSE,3028,1515,Dire
d750f3ea1ead21e3f67929c968c9e8ae,572,TRUE,1309,737,Dire
d571277b8bb27662fd3e575e6abfb418,1978,FALSE,2994,1016,Dire
53bc52248371c344bf32ae7e48e1e206,1155,TRUE,3105,1950,Radiant
e1a4d31e0500f474260d5b228e3f48b7,1696,TRUE,2700,1004,Radiant
e210d4fbd0263867ff28bacdba6133e7,603,TRUE,1742,1139,Radiant
872cb005574c3f6f6d521b007062080b,25,FALSE,1940,1915,
88fa3d86895da498b729828fe6254935,2116,FALSE,2187,71,
7230ea36ea2603516274d38fee0c28c3,2224,FALSE,2478,254,
6ee0a20658e80c4f8c0c059181e3e6f0,775,TRUE,2632,1857,Radiant
4e180f6b9b56a958a56afb3bbf4f7e1b,1215,FALSE,2576,1361,Radiant
329bcacefea82da8b22dc4907e7833d5,1297,TRUE,2294,997,Radiant
482c671e5b18192e5ddf28bc1b5a3ebe,15,TRUE,1686,1671,
00c9fedb8e6d6c15fb3e1d982c569681,1435,FALSE,1957,522,Dire
f5cefdb7f8851f4f6e52d9e830e48659,62,TRUE,1393,1331,
0776a58b64178dcba80b827cf3bcda2b,2922,FALSE,3153,231,
e3e5f66eac080d5684474e2d6030e72d,2529,TRUE,3399,870,Radiant
fd1aac4baf88455c8e7ceab33c8e4908,2448,TRUE,2808,360,
53898d4773c8828b37e41ef5f41a7be9,1271,TRUE,1684,413,Radiant
3e9809bd522fe2b9c3d6132ba092f88a,123,FALSE,2865,2742,Radiant
2b657bf5131d8efe4e3eab27ff96a0f4,716,TRUE,3572,2856,Radiant
9465733ef1ade24dcc7e817afeab8e56,731,TRUE,1259,528,
ddcb2fe419b0cd237187b3d806b24733,804,TRUE,2766,1962,Radiant
42bdd0eb926cee4ffdbb7cf6c7a0b4d1,1193,FALSE,2328,1135,Dire
551c6f9d67b7be8c1b5adefd6b170637,1417,TRUE,1984,567,Radiant
f11c322e7b50fc5efb9eddec1b71a470,676,FALSE,2913,2237,Radiant
b3bd42a7dddd923b566e565187d244c9,751,TRUE,3142,2391,Radiant
c120c9b31321df2e0a4d1335966b4c5e,467,TRUE,1564,1097,Dire
d35b67e054f91188beeab5beca867f10,2298,TRUE,2357,59,
99b55485cf6c0975996b60b7206b558d,103,FALSE,947,844,
3c387d9b66ad1e051f3a38bc0d0e834f,936,TRUE,2310,1374,Radiant
703f8f357b2bc57f1e7c93352590fd67,1584,TRUE,1725,141,
5e3bf3609a35913558eb9bede813bb5b,705,TRUE,1348,643,
07f04ac652dc5d00c74344a9f4bd5082,148,TRUE,1681,1533,
6e096fe5cb33bb1cfab9f7045d22a904,55,TRUE,2180,2125,
5e6955c2b7fa49e2ed6b76c1b18df1b7,1221,TRUE,1632,411,
4ec7b667bd2e9f3b971081d8302b5aa1,2590,FALSE,3514,924,Dire
b291ccefdc1768a36dd5bc3589656f06,1837,TRUE,2420,583,Radiant
bfc9d24b204ded799603e65728bedea9,1377,TRUE,2294,917,Radiant
d32fd3ee93beef0f720b69def7432554,66,TRUE,1633,1567,Radiant
e9c28c7a1f5c968038b3b9a7cc361a0f,3,FALSE,1710,1707,Dire
a2d51e529aa020b5a1febf7eaaffcb7d,2959,TRUE,4791,1832,Radiant
b675f2a007406df090071d90383eb745,1681,FALSE,2512,831,Dire
24a2ba54d759eaf471cb136201253a7b,1490,TRUE,1589,99,
7a91cba9d4fa2d9830a54e5ee315e32f,1783,FALSE,2488,705,Dire
032abf6317c8f0ee376ca366236638c5,187,FALSE,2750,2563,Radiant
1b8929164712d8f6de87dcbc36ea4fc4,2198,TRUE,2513,315,
b55d8c8002ff8ae1519a9649ca964c28,848,TRUE,3177,2329,Dire
18693213f577bccc4e9ac2ea9b8a9417,422,FALSE,1842,1420,Dire
3c5aa003845b57bfeaad04cd1a7b37f2,334,FALSE,3950,3616,Radiant
338c6d5cfc2a171c86ce1d9646ff7bbd,365,FALSE,1667,1302,
2a1082e191b669c8d0264912693e2b68,825,TRUE,2255,1430,Radiant
d7052f5e47f162e8758e36724aef561e,1224,FALSE,1944,720,
1f682c76004953e049089818c90cd120,1628,TRUE,2201,573,Radiant
f8120e2781d04acb4c63b4bf233cb824,443,FALSE,1404,961,Dire
05378da99ffd19db4620ca41505a39d7,1650,TRUE,2355,705,Radiant
91d9cedda25bd16c5b529cc1c29c1f0c,2067,FALSE,3036,969,Radiant
3be3f5648c328115d8e599c29553fa71,1693,FALSE,2183,490,Dire
43883e6d18e805d4e8d97cdb4c359827,210,TRUE,1729,1519,
d0115823dae73030539a2af71281be87,732,TRUE,2693,1961,Dire
5eb5591e11ece9fbff3956e7431faf96,766,TRUE,1194,428,
faa67953c506f334899943b0ea6b13ad,1019,FALSE,1677,658,
1e443000cb5b750c8894edba75cbcaa8,1962,TRUE,2201,239,
4a6e40ca0b4238184a6bfd95f1f5112e,1380,FALSE,1613,233,
b6bb26e925e25af94e48f094fdd7b744,194,FALSE,3103,2909,Dire
5f0917375a461d9fdf31f6a113fcc3f6,1145,TRUE,3133,1988,Radiant
236d39ba81368a12c7601ee1d82e49e9,1650,FALSE,2027,377,
9ce42d2715ca1ab3d07bb84d9986421b,983,TRUE,2378,1395,Dire
8a4993c003939ce553ae23951dfad0a6,306,FALSE,1889,1583,Radiant
86879b6df7f1644cbd521febbefc33e7,1150,FALSE,2973,1823,Radiant
ba8e47653a4bf66848d250a78b9ed103,1125,FALSE,2269,1144,Radiant
1fa81554f5f1194441c3dcd9e436b848,315,FALSE,2196,1881,Radiant
84686174477347c8db2583174fa5f5bb,221,FALSE,3920,3699,Radiant
d9dcb38c6d1db2580595f159b306448d,565,TRUE,2517,1952,Dire
ba6cb466644e6471e1e823961cfe2b70,1552,FALSE,2128,576,
03161ed118f774b8507c5a6ee136c0b2,1927,FALSE,2519,592,
95f2ce720f7363e032b800818268a0fb,456,TRUE,1454,998,Radiant
064b42157362976123b8c1ec065679cc,1256,FALSE,1983,727,Dire
5fa3b1f6813a8c76e1515b51f95de564,1783,TRUE,2603,820,Radiant
5c34f6d7fa469af126c9ed3cabb973e7,20,TRUE,2848,2828,Radiant
7139d856a42f7e7f60c02c5b03c0e41c,2783,TRUE,2918,135,Radiant
eb74f46dcca0786ff95c59e66acb2f42,907,FALSE,1735,828,
dc597713bd6a0980dff27d85f4b92286,607,TRUE,3795,3188,Dire
d26c67666df13418b2c9fea4e9656736,364,FALSE,2058,1694,
b7cdc2ed67eb2516de9d13fba60a27f5,391,TRUE,2134,1743,Radiant
41fbbe56f2f0b317fbe70a5a2076e68b,600,TRUE,2377,1777,Radiant
afde17f77c7f71855935fad87ee22780,1027,TRUE,1786,759,Radiant
6b65f5fe34120bd5dd47c6b5fdca04d5,2546,TRUE,2940,394,Radiant
d7f80c374886f3b1113156c4e31e8631,575,FALSE,1320,745,
3a1e6f15c4558207ef175db9f09ab0e1,2014,FALSE,3382,1368,Dire
6d8ce1606975f90e3a8629af701df60b,2967,TRUE,3144,177,
9fe85a963ab1f05d5e1e8a46f0a1f54e,350,TRUE,1900,1550,Radiant
8cd24bfc261e6bf1888cf73bec84d204,1305,TRUE,2540,1235,Dire
3213c9982705395221fa9fa3ac05b31f,68,FALSE,2539,2471,Radiant
2af9e31bd4eec479c7a916b7b5058846,2309,FALSE,3178,869,
0ecfbcabf8349c8def4bf4b0a0fe1409,14,FALSE,2144,2130,
4b0148ad1c6a2b6c5def4fbef86a60fc,2139,TRUE,2180,41,
4d3c9a3599b09c05d8ca40be3e1cfd62,849,FALSE,1803,954,Dire
b4be39bbcbc2fbe2e8fb17965c3c645d,410,TRUE,2581,2171,Radiant
82a0b9b031c2a834bc959fb0da7e3b69,378,FALSE,3539,3161,Dire
365889fb28ca967777a20f0843218e73,287,TRUE,1905,1618,Radiant
15d9beebd8c7e5aca3bd9d09d63b8a8c,692,TRUE,1657,965,
eca0fdb0fa7d9f98611907b510e01e99,1998,FALSE,3960,1962,Radiant
2526c7418c7d0e79b0e5af8bf0cd9876,516,TRUE,2836,2320,Dire
d0eb1240dbb455482e58ed257f421ffc,541,TRUE,1248,707,
24b99e7b588a1d248e0e462654489148,995,FALSE,2791,1796,Dire
0d37de23e74f74c81a2b11caf6765cd6,820,FALSE,1520,700,
7a075f0490a11b2d511b8a1d03789ff3,969,FALSE,2460,1491,Radiant
b9be90cc8631dfb51f6497d12bbfcc8e,43,FALSE,1210,1167,Dire
4dad844a0a72362b6497488ed05668bf,1393,FALSE,3181,1788,Dire
69f5a6052aa0624c9c7403da8d1f9d34,118,FALSE,2522,2404,Dire
207253668dd9789ad902fc485fd839a9,1703,TRUE,2023,320,
37e28f360fb8edac23b5bf3b13831de7,1236,TRUE,2275,1039,Radiant
0eecd7e80e6ce3d165f3315e0e57002e,1054,TRUE,1539,485,Radiant
a771f5276df0585d95482245d1bdc62c,494,FALSE,2198,1704,Dire
672bfa04a7d0643f269fa661912b2710,295,FALSE,1945,1650,Dire
9c5588afd5d62ad783703951fa0536e6,953,TRUE,1016,63,Radiant
6cf355822ee0e1239b61c38571c4ddb3,2246,FALSE,2599,353,Radiant
f8d93c92f10f74f0dfe7ed7a80054775,1560,TRUE,1805,245,Radiant
9f7ab59e79bc8912056bbf528467a5be,751,TRUE,3022,2271,Radiant
ac045aafff3eae94b5b1167bf8207f28,950,FALSE,2061,1111,
99f117fe5923568c645c5c1f2e6bd264,397,TRUE,1347,950,
590850a3e5ab6e333a82bf63d7c029d1,478,TRUE,2582,2104,
f5a20a2527aedf88afa92da89923d09b,2877,TRUE,4219,1342,Dire
e13039457c36e46ff2d373a488e2b6cb,1084,FALSE,2294,1210,Dire
3ac0ea48981e7db7aef9779e1b0d40cf,1135,TRUE,1758,623,Radiant
c1ad9b6517d8746e267db6fd9bc6648b,1535,FALSE,1888,353,
5376c6c0e26ad2425cfbbffbe0e1af67,489,FALSE,2555,2066,Radiant
4028288ac084dc9ab7ff64ceaf19ba74,917,FALSE,1912,995,Dire
a25379b182a248cf7dc888e8a304be09,648,TRUE,1425,777,Radiant
abdcee05be72854ac7ca6c0128c9f5eb,277,FALSE,1453,1176,
5e859a56c709195f1e50185432fb3d12,1130,TRUE,2191,1061,Radiant
ac9c4eedf64a15c95eee54e57126a53e,541,FALSE,2441,1900,Radiant
423f0d33e57f3180c3468b9b332243bd,1767,TRUE,2482,715,Radiant
9d867aa5e51626fd6922d7fd93bcc28b,472,TRUE,2250,1778,Radiant
dfb76a048cb45b16d1c3c9ea4bb3fcf7,2141,TRUE,2975,834,Dire
e8239b50b2f082a89c3f0f9e9d24e3ae,630,FALSE,1126,496,
d6e7f24e7c012e3af595860ce03c1aae,1959,TRUE,2898,939,Radiant
d7c973d54d23ee4c465d4c88e33f0e74,1959,FALSE,2787,828,Dire
e2e0a34c1fbb31d2b6aa0953ef810494,736,TRUE,1449,713,Dire
a3d8c71e2dd4ce838fe42ec48045bc69,1590,TRUE,1991,401,Radiant
7e5ebdc8090ec8ca56ff7d9912648142,756,TRUE,3364,2608,Dire
93943112ab63de344e7c5e77d07d1a17,1690,FALSE,2380,690,Dire
f04b3dd72e98dc1c7f42bcd723f3aef1,1662,TRUE,1741,79,
608de4de30c3b24ec6deae1aa251ca8c,358,FALSE,1760,1402,Dire
2e56b9cab287027e0b48cab1104eb9ee,1930,FALSE,2199,269,
61bab8b00d3fd4e2f7099de0af3cbec0,1466,TRUE,2576,1110,Radiant
2c030d79cef43e766df7cda4c9551d2d,2048,TRUE,2541,493,Radiant
2030a44b0da4529e538bd8d6bf72b217,811,TRUE,2850,2039,Radiant
f6f690d4296788a42008c8e274264e9e,1642,TRUE,1853,211,
2167e6c835729443e22d1bd9d3d76d48,2118,TRUE,2855,737,Dire
c13a16cbf6bc76e24c6a59f017916bf5,1162,FALSE,1851,689,
6f746bd23147341980e0a32fad461366,1528,FALSE,1687,159,Dire
09da676b9d7c5c685fd34fb2725f0648,62,TRUE,1528,1466,
7a40ff012df675df416c839f864fbc8b,344,FALSE,2491,2147,Dire
c2e0ac353f27eee21d250d964770edbd,1471,FALSE,2816,1345,Dire
e975c5927ee68815651d8d39885c0d88,958,TRUE,2001,1043,Radiant
7afe9da276568fdbe73742eb56320175,1091,TRUE,1902,811,Radiant
35cddb1f6e98b169fbcf6ba332871832,905,TRUE,2386,1481,Radiant
2159274fce9b8228a04b2f5ca38540d2,184,TRUE,1416,1232,
b4516a1c243122781a506f4bfa5b1c32,976,TRUE,2290,1314,Radiant
f4e50a020b8d2c7335c1dc4911b0f988,525,FALSE,1412,887,Dire
e44c2b7ae191f1ed858d127cc31382f2,1907,FALSE,2200,293,
87c381def9a9263575aab0604c96b857,1978,TRUE,2245,267,Radiant
7950dafdbe61aac0177440026ae77124,1835,FALSE,2040,205,
7acacafd2a22319e18e807fbbb64dd42,808,FALSE,1433,625,Radiant
f69d657ed2ed938bed4d9dd956989a8b,111,FALSE,2013,1902,Dire
ea051fee25ff00bee93af92e10b9750b,1049,TRUE,2573,1524,Dire
4ff67473edd12733cfa08d3cbb624482,570,TRUE,2507,1937,Radiant
54427aed7507d94b035a0383f343d927,700,TRUE,2692,1992,Radiant
d9cd483f71c46cbb5685c291bdf26bfb,2057,FALSE,2318,261,
e89f60fdd07111d293ab5127fb9b8360,2359,FALSE,2507,148,
84db7162665c5636115040bfbdaa536b,1135,FALSE,2277,1142,Radiant
444b34a2bbecb21b5cdf411fc26d9176,545,FALSE,1138,593,
b5d1dea5d3592bb6baf94321319aae25,931,TRUE,3015,2084,Radiant
234c27da646d80d191779b92a4c17343,1467,FALSE,2665,1198,Dire
77ccc44f5631144820f1d40ecc452e3d,1665,FALSE,2616,951,Dire
a4760ba5fdade42111b94b87648368d1,2014,FALSE,3307,1293,Dire
1f22ffe89a07b628e25760d32d525efc,1708,FALSE,2545,837,Dire
c7da353f9995a92f627bbaf56100b5b4,1154,TRUE,2506,1352,Radiant
fec60fa6147d37a5234a7fd1d0188c1c,1043,TRUE,2095,1052,Radiant
98ac3ec26c68262e0632158d45ac43aa,129,TRUE,2912,2783,Dire
62134edb26cf60c42965a355b8a423d0,1094,FALSE,1526,432,Dire
170b89c33f879f7695940eda5c5506e2,2878,TRUE,3678,800,Radiant
1e5673b003adcce0fd83dceca7218d99,156,TRUE,3335,3179,Dire
9f902c25095c6ea2a6b97667a5349217,2061,TRUE,2460,399,
38d65d1be5cab84553ea0081c515ecef,1820,TRUE,2494,674,
741044b9232a5d69bea7dd1e44d83e87,1022,TRUE,1900,878,
c1d5271f499b76d44f71c4ab6fbf674d,149,TRUE,2385,2236,Radiant
580f9df6de8352073d495ed47acc2a34,751,TRUE,2107,1356,Radiant
4d421b2aaba98d465ef8ea60789e4def,467,FALSE,2449,1982,Dire
90d7fa621ebe609a65fa9897dc822518,1138,TRUE,1286,148,
397360363a07bf91e3f27b8a72274140,1272,TRUE,2634,1362,Radiant
4468fcc8c84a18ce02a6cb7d392f3230,2770,TRUE,3369,599,Radiant
c1f252dc4cb967905d0317dbf027a482,582,TRUE,2456,1874,Dire
21428b15279a0e269e6b4aa2f714ec43,1968,FALSE,3411,1443,Radiant
a304fce9bbf48d0f293b5e9129eab5c0,706,FALSE,2493,1787,Dire
2942ab220948ec1091ada7645e33cefb,991,TRUE,2947,1956,Radiant
071e55ed94a5f2b3338564114318b10c,1761,FALSE,2259,498,Dire
d673aeee53a2c71f563a1c6f15312656,2592,TRUE,2685,93,
94f5b76351e33c536b698722ecd41e1a,3497,TRUE,4140,643,
542d4e3113e62c271c4bd9f652d84229,2168,TRUE,3144,976,Radiant
4f131e63f4761fc821a0897bcc0a9cc8,2252,FALSE,2623,371,
819663f409fbce9c7a916c6bef7bd39c,1079,TRUE,1132,53,
3cb982592cb0a07606276408c70d40b1,1357,TRUE,1695,338,
bb52b00adb78938b7452639b7ea89932,909,FALSE,2137,1228,Dire
5f76e7691b0e55a460a8722fb7a0c561,58,TRUE,2954,2896,
f0051027e9f40db57b7529d503c11cf0,1296,FALSE,1728,432,Dire
f0e63e669a8aa7418286ccb646150946,1002,TRUE,2776,1774,Radiant
063a1076ed0ad5f48bbe89b6c0d12488,588,TRUE,1523,935,
53ecd02e0b2d1aa2609a6687d1c35571,451,FALSE,1210,759,
403ae813eb2d4d686c1243bfe00b4efd,83,TRUE,1954,1871,Radiant
679258964b9ec58d373defbce63c42a1,843,TRUE,1909,1066,Radiant
03a65656b81ed82ec74aaa0192d3435e,1567,TRUE,1792,225,
fa69baacbb2a776fbc4844a753faf9ac,818,FALSE,2015,1197,Dire
f394571204d380fee35a0b7c44abcfe2,581,TRUE,2586,2005,
4cca8dee59d4069ebc65b0f2334c86dd,904,TRUE,1198,294,
74854a36e339f1e7c120fcdeac911557,428,TRUE,2199,1771,Radiant
a4df8c235f6d77a874655da18ec2a73b,1218,FALSE,2322,1104,Dire
9dac387613ac5658c96804ca49189ffb,23,FALSE,2482,2459,Dire
e06662010ff767d180e164c390af709f,1105,FALSE,2305,1200,
8d2c1f635984a51e017523cf5de912a1,1734,FALSE,1864,130,Dire
740a32be0e8399ccd0201b9d7131a14d,1110,TRUE,2292,1182,
be405098001fb2382926bf8f0e1381de,828,TRUE,1683,855,Radiant
43be2f8fcec7a6f0c163b6f4e81e5c19,1222,TRUE,1615,393,Radiant
163e67f209acc81802a322431ae233f6,1365,TRUE,2123,758,Radiant
27de901a6aeda06c0d6533f5d5419a34,362,TRUE,2595,2233,Radiant
0fee1afe0fce366887b9965d0161779f,403,TRUE,3535,3132,Radiant
b863690343e6c3bfd370611341287160,169,FALSE,1485,1316,
2a47f03114a211ecbcc3b8b52c279f12,2569,TRUE,2712,143,Radiant
db427aa0afb4d884b35c56b6d5f45617,2640,FALSE,2753,113,
b3be8e42997221c027e452bfce2336ad,72,FALSE,1992,1920,
16bf0141245691f8aa1c7702c7a62a59,0,TRUE,2016,2016,Radiant
1499ef2d35a22d2c0619ba82574cf95e,1144,TRUE,1554,410,
562aaa6d4a5d39e3358d1cd0e3109459,756,TRUE,1728,972,Dire
b8db4c332759b8fa523c487dcc7f9535,735,TRUE,1936,1201,
6c0bb2ae0fab1c643a902a3967901ae5,1568,TRUE,2640,1072,Radiant
87919e8f3b335f7a7acb477f00c72e10,1965,FALSE,2490,525,Dire
21fdffd708f99ea4d6f05fc8b5fafe38,2079,TRUE,2173,94,
d71337360492eeb3c68046eac301e589,1401,TRUE,2473,1072,Radiant
d738f04ab0bde95cd8867f3a84c17acb,808,TRUE,1791,983,Radiant
1368afb675d09e40b7fd9ecd35fbe0f2,4062,TRUE,4177,115,
c709868e6e525372b77bb31d1054c2a3,2030,FALSE,2556,526,Dire
7225f5a1832b93520b0f9e8a1e20c9dd,35,FALSE,1893,1858,Dire
5be1adacebfd7698513c3b63e8148a90,1554,TRUE,3089,1535,Dire
f34f327e8517bc11fa6299487dd643cd,389,TRUE,2784,2395,Dire
6f51d344486d5c77f970917d6d5485c7,2849,FALSE,3408,559,
62efaa3362d9a1b8c3837728dffdb04f,490,FALSE,1497,1007,
8fb86af3cdb86f4f1a8d76de89447145,981,FALSE,2234,1253,Dire
e2d669c3703e287feebfe9b187247bfc,2024,FALSE,2517,493,Dire
7fc5956d6c7a333f49701e1217eb08f3,1145,FALSE,2115,970,Dire
61c419b0b16a952e8f3f68b1dfc997a6,1125,FALSE,3049,1924,Dire
1f6044de6305f9a1f33c7ec7df72072c,864,FALSE,1697,833,
d84683272e4f8adee7f7ee3979a844e7,1561,TRUE,2776,1215,Dire
58147be0c30b2fb5b6a36ff60397f9cc,801,TRUE,2009,1208,Radiant
feca8c04d63619a95d3419057563fa5e,529,TRUE,1556,1027,
29a8c74d35fe328d4b18c0a77984339d,969,TRUE,1939,970,Radiant
093f5729f2f45391895781c71771f8da,582,TRUE,1318,736,
f28a7fc235c41815c521d14ea0e8c353,1269,TRUE,1701,432,
c11e4bd819a78a9b35486070764e6429,485,FALSE,1055,570,Dire
6398e778beb5947170e893e6f084ac41,1803,TRUE,1835,32,
a04fff9ff55bd586582082e1ea22eb47,1973,FALSE,2057,84,
1e7a6d78e99a9e979951e675aab24170,1574,FALSE,1908,334,Dire
602822b51ffc8d2e4451cad3fa5952ec,436,TRUE,2403,1967,Dire
d0dc4e34bc72aa599d8f99d9474246bc,1971,TRUE,3053,1082,Radiant
50c2e6fd581bf8c2aeba768bf01f3df4,1532,TRUE,2849,1317,Radiant
3c4328a529109c8245fcf034ed458f93,1742,TRUE,2796,1054,Dire
844eadb2f068b01d7258ba1f877794d9,2020,TRUE,2502,482,
20c0d7476d9dae977d45b33836be45ab,559,TRUE,1567,1008,
f66f7dab349e5f54933ed122ced95240,1169,TRUE,1771,602,Radiant
fa8f127e8813a21449c26cc6b90f7c6f,3352,FALSE,3599,247,
7bdde3d48cacaa5911497a293d2ecba4,1293,FALSE,1805,512,
a834f364adfdf1507efea8db4903a2f6,748,TRUE,2269,1521,
bcbd456dcf9a9660a900e95a1d589963,876,FALSE,1392,516,
14619c0f9a27d6c42286be1dedc1d16b,1405,FALSE,1763,358,Dire
611ed52e4722e1425221d7f0a9378c43,1413,TRUE,2105,692,Dire
6a293b31a2b1094d523eb1919232319f,466,FALSE,1723,1257,Dire
80fe765dab054f9ef7467efb88c209ab,1008,FALSE,3140,2132,Radiant
03c1566e41eedd51a33057be2eb0044d,400,FALSE,2919,2519,Dire
d606c205bc604effb2604717655994f8,1049,TRUE,2096,1047,Radiant
0e1273ce85e3f380c5c84c1c3291d32c,1048,FALSE,1920,872,
3c5a97a2f1b4daaac110a47f9647062e,1672,TRUE,2516,844,Radiant
f7a3bc7bb8fda2a0671d922df6fb97df,1004,FALSE,1694,690,Dire
82c5e53d1108d17e4c4a92997c554bed,1175,FALSE,2010,835,Dire
223a32debe62c8be4e49c84d4f6d5a84,586,FALSE,2576,1990,Dire
d98e79f87b4a70b35ec7b1f2a8bd6728,884,FALSE,1482,598,Radiant
16ec904dbc36a060e6b5af2fad646d7d,223,TRUE,2223,2000,Radiant
8ab23125a2b5a3531628ab419a53a6a7,573,TRUE,905,332,
52d0419838c81d7ba1fe10c0711eb529,201,TRUE,2701,2500,Dire
0a914de64e58589835bc4dbe4e05a121,759,FALSE,2389,1630,Dire
10abec0ea2958b0e08744bec5c2c7e5e,2343,TRUE,2905,562,
96ffeec10228070fba7428e750527094,1343,FALSE,2383,1040,Dire
d543739c1b329df86e94faf1ed6e16ea,1607,FALSE,3068,1461,Dire
4dbc4146e2ea14f44170ac2a48e7faa5,2474,FALSE,3074,600,Dire
7ff879dd37f205224a96bb641aba52af,1397,TRUE,1693,296,
33717642703888ec13a567cf13f1c779,963,FALSE,2175,1212,Dire
39df7c2cf5293fc2468ac6e1ddd41412,2411,FALSE,3529,1118,Dire
c154dcee207fdec9cd70d8ae14c921cb,328,TRUE,1748,1420,Radiant
2c6db34191e56816a518ec59b225b87a,686,FALSE,1973,1287,Dire
27e3c365b54898c345712138ce1053a9,651,TRUE,1092,441,Dire
8a83614e785e1b48ba7ab4a30955c8b9,449,TRUE,3074,2625,Dire
33b462de9c89f92eac14f15c9a3baf01,151,FALSE,1561,1410,Dire
944f8a7b58566ee6028cc82791272fbc,115,TRUE,1509,1394,
dfe5fadd1d09499ec0d626311ed76ace,615,FALSE,2363,1748,Radiant
0d041a3440b478ac9bc9d5073b0f4909,273,TRUE,1964,1691,
bf17fc4fcf55cb0f9e12e8d9e99b4c43,419,TRUE,1111,692,
62687d961fdea73af1c7ecce9f474d52,1035,TRUE,2604,1569,Dire
49ec99fd4ecbb9df48ae28b516535abb,1290,TRUE,2223,933,Radiant
05a2973999bb4f5845cabd5c8735e359,2567,TRUE,2612,45,Radiant
f0e7fdb6a14a94a0113352943f378275,1025,FALSE,1649,624,
e7305ec5c472eb41aa2298b37fe231e2,1819,TRUE,2749,930,Dire
b3ae496bf86d9b6d9a5074ef286e9d17,925,FALSE,1809,884,Dire
044602f7c3b7b962ec08055519674ac6,1341,FALSE,2113,772,Dire
01b8885f249d690766a61a46d54a52fe,1199,FALSE,2569,1370,
fc74071729634590bd8aee044931768a,1354,TRUE,1954,600,Radiant
80e7ca05c28ce8611786eca5b37dc0b0,263,TRUE,2327,2064,Radiant
2aba7e916d9360daafa4f5908aff26ee,182,FALSE,3593,3411,Dire
887fd54490a9cd084b4a40942d82841f,779,TRUE,3624,2845,Radiant
3a4be4dd8809305a288064b1f7cc1805,464,FALSE,1269,805,Dire
90038209b641ad7f26e12f5eea8a254f,1923,TRUE,2307,384,Dire
f65f247daaae1c5b7a217f97e7593d0e,2497,TRUE,3176,679,Radiant
03b9738f2eca98037f20d09d6417693a,479,TRUE,2188,1709,Dire
8ce495c397ca6e02ea0d84e57113de2c,324,TRUE,2992,2668,Radiant
253d4debc5308585afd249478a190f40,193,TRUE,1144,951,Radiant
53d4ef339b0f4cb69d0d4cea39b98f15,610,FALSE,2952,2342,Dire
12e3bb40b204c81386f5c32151c4d205,1064,TRUE,3678,2614,Radiant
d84596cb43654f288ae23ce71f0d473e,1629,FALSE,2296,667,
3fbc7c60cce5d9ca645d7991c120d2e6,5,FALSE,1944,1939,Dire
ba0910185d3fc2912bdc5089086ba6fe,185,TRUE,3107,2922,Radiant
90f862bb279c8a69e6dfdd9a5e36f371,1879,TRUE,2267,388,Radiant
0246ba476101a9c166e9418c2b37ae97,1047,FALSE,1697,650,
2294f8064d09c7e74b52e7f5caa09cc9,249,FALSE,2421,2172,
130f4fdc0700d9f5022187c7a3ae1a13,392,FALSE,2186,1794,Dire
ad9fbe695ef9b19f37ee8ebf48742c13,443,TRUE,1440,997,Dire
2c9aeb3cbb59ac3e3a0d17b4575134f4,1107,FALSE,1862,755,Dire
da63c692b46b01cfe7a77417787ae714,973,TRUE,2122,1149,Radiant
07ccb2cce818163dce6703b2dc8e4092,2269,TRUE,2384,115,
48db6832f69bddffaf6d9c1243ea0f27,1384,TRUE,2114,730,
e0b2fd446c46819cb6e8affe42c64c22,11,FALSE,1975,1964,Dire
94a157219d4ea4db7cc84eaff82e6605,1217,FALSE,2665,1448,Radiant
141982c0023230aa88ce03eac3fa0479,966,FALSE,4403,3437,Dire
d9c26cd19633e2035e7bd3a070f09c08,2066,TRUE,2482,416,
d4ea20a7f801a25a0681f31cd1e926a6,1590,TRUE,2401,811,Radiant
907efc31d988c201147d296f4129c522,2609,TRUE,3631,1022,Radiant
afc44f25a6d9a95edbb64af975f5879c,1466,TRUE,1590,124,
658f6bf387c0a8614dd86423231716c2,238,FALSE,1978,1740,Dire
a952c9619988e8afc1446815d581e239,1807,FALSE,2034,227,
6d9b0f6986a50e25fbcde0752d06f0ed,772,TRUE,2475,1703,Radiant
4cb8266bf798a86e6528e67daa8008cc,1358,FALSE,2954,1596,Radiant
b842b6c20d539e59582047e91d888df7,146,FALSE,1450,1304,Dire
9402ee42bb1be2a2ff6a7298a9594ede,144,TRUE,1951,1807,
0f06950382450acab80be5c6d0a45f7a,1434,FALSE,2206,772,Dire
372b00ba2cf3abe8229c54925b5cc728,900,TRUE,1719,819,
41564cf9e56af6b575d8168f85237b65,817,TRUE,2278,1461,
61e3c6108b27df4101792af18027af68,953,FALSE,1642,689,Dire
f5b9121c00c5d792e2feab0847210317,741,TRUE,2380,1639,Radiant
30f218d9a37cff69b935e46dc03190e2,392,TRUE,1977,1585,Radiant
e47a9af1adb5bd1e2b2ab8bca793ad8e,765,FALSE,2188,1423,Dire
2e0864e9b55aff31a03908bdc1eeb173,382,TRUE,1895,1513,Radiant
76d7cf577044a22201fa94c9c26091dd,1081,TRUE,1632,551,Radiant
956ead13eec1bc4d21615a2433ee51bd,623,FALSE,1778,1155,Dire
0c92e4ccd4f664e214f4a846a96d20c6,1277,FALSE,1948,671,
8ef2c42fe241a57dc3685dd14a8389bb,1934,FALSE,2115,181,
8f2d3590d46f682c4d565031fde450c2,1186,TRUE,2135,949,
dd5d38ef3516563b3a9db82591f4c26b,2730,TRUE,2837,107,
4b53d21b22c62f288d18fa9d1a059e02,2995,TRUE,3955,960,Dire
c1fc3882aabceabe51cd6784c8acf6a2,374,FALSE,941,567,
19b6626a9d746603ef2dc6a292ad099a,1646,TRUE,1800,154,
c3261b11474aaa56f7090a57f8e9e3f9,1177,TRUE,1696,519,
9382ce7964b382d8e33d1c88b57b1c3b,935,TRUE,1761,826,
9cd88d6fef76bf805f6485038ca330d1,1895,TRUE,3000,1105,Radiant
0fe3269f0707acd2f797cf7e66970790,183,TRUE,3454,3271,Dire
658af77d12e805697e1e14972bad29d4,123,TRUE,2351,2228,Radiant
0e4e7e3ffb4c2c8e57e88d4672b71e25,3052,TRUE,3463,411,
ddb82fee3cce9f3f07a0618fde36a7cc,1134,FALSE,1973,839,Dire
3460201a1f8a3cea69acf34dce0b2971,514,FALSE,1918,1404,
401e06ec107089a9016adb0c7f97ead5,320,TRUE,1948,1628,Radiant
5f455bddf52dffb0db500b4fe3b47a87,1228,FALSE,2715,1487,Radiant
fd6b8082f61c961b17e459f322e4984b,354,TRUE,1373,1019,
f35555334f9ca279c2231cdf512ebdf3,1632,TRUE,1714,82,
5e2869aac16fbd1c47f7fa9fb52da2c1,1083,TRUE,2134,1051,
b2ef45e9393414f3553e382d99f47000,1930,FALSE,2679,749,Dire
ad79b3ead3e4f169895c27b9c574c086,2470,FALSE,3011,541,Dire
20453fc90b3ce1a1676065be2e1da0ec,868,TRUE,2951,2083,Dire
2e0f639c5bcc07103421afce0c54b62f,569,FALSE,1199,630,Dire
4d9485a81531255c5142141759a82c6e,673,FALSE,1168,495,Dire
06da13694961e50b6271ded535082739,1550,FALSE,2682,1132,Dire
130fbb34bf133ea9e8aadf2dd6055ce6,517,FALSE,1592,1075,
3973bf71d500954870be1527b96e0b48,1388,FALSE,1580,192,
5286522bb11a5c114ce0d028c839de3b,783,TRUE,3104,2321,Dire
d0acbd842c55c5c009f2c3f39c3a02a4,1597,TRUE,1980,383,
381f1d3f2d8b218e16551ffa27c67d7e,814,FALSE,2184,1370,Dire
09273f40480b9b06ca464253af66efa5,1041,TRUE,2422,1381,Dire
972937a14072a57bf317eda8a91e6971,733,TRUE,2410,1677,Radiant
5ea2fe64804b366be53941c8f0405eb5,293,FALSE,1070,777,Dire
e987a1cd7b6fc46fac18f4550d53a6aa,1297,TRUE,2634,1337,Radiant
51aab212ba2e766d34f9567898082745,1173,FALSE,1616,443,
7ef6887c4a7cad567fa5e8124ae62c1a,227,TRUE,2215,1988,Radiant
090121ea4db6334b2a0a046b2faaf78f,951,FALSE,3047,2096,Radiant
65f2c3158e2952b809f2e5837328107b,1784,FALSE,2196,412,
49624842cab1fbe61292bac8f1aafbf4,105,FALSE,3119,3014,Dire
59a4f9a53e2910cf33e58c18cd06583a,48,FALSE,2009,1961,Radiant
b18477d401da135bad5b302677baa862,1597,TRUE,2037,440,
09af7b5e9118a5f2af40b7fa0ee54705,526,FALSE,2155,1629,Dire
8d53fc2a3caa2541da47539cbae070c8,2615,FALSE,3256,641,Dire
f8437817a65c370587e858497030e245,1681,FALSE,2146,465,
589742cafdd2ffd31c97c1933ddc93b4,928,TRUE,1783,855,Radiant
878cfe39f021f1623289f9b190ef561d,1861,FALSE,3202,1341,
7c5402df26c648c015920b07eec41bed,2292,FALSE,2351,59,
50311e201c398458b82149d4e45bf313,119,TRUE,1506,1387,
356b19f724486f7c631ab4ea96b8b73d,1150,TRUE,2186,1036,Radiant
6b941203c165f82accb711dd28ad3278,591,TRUE,2287,1696,Dire
bf8c7d9371969ccd470065a8860aaa56,836,FALSE,1086,250,
c581abd70b5a6f1ab3f8b0fa50524138,257,FALSE,1871,1614,Dire
5edca245f0bdb9a1e3a1b536a80941b0,173,FALSE,2674,2501,Dire
95e3dbb7b905efa4e226c345afef0ce7,1118,FALSE,1698,580,Dire
73617180a436196848e588537c2231ca,650,TRUE,2610,1960,Radiant
58c8948c4cdaf26c1f5efbbbf6fc9907,1414,FALSE,2772,1358,Radiant
0afee84e3ea8b06b4de36c4a66135190,1857,FALSE,3257,1400,Dire
21e30657b72ad20a50a000660d1525ab,1426,TRUE,1640,214,
6f67206fc846c6745ff3a80b6dae1b14,1213,TRUE,2711,1498,Radiant
be572748a83a6573a1c341ad66cebce2,1683,TRUE,2340,657,
d918518f346aa277d0b7e0c9fb6571f5,622,FALSE,1941,1319,
e60b5eb5156cc7e51a03813dddbcbf53,543,FALSE,3060,2517,Radiant
a4fb4ce2ac986cbff095724a42e2b1a1,132,FALSE,2146,2014,Dire
7a216ba396645b86f68e4b210c7295fb,150,FALSE,1662,1512,Dire
535bf03d73e05e8be8182007512bc9b2,2699,TRUE,3398,699,Dire
cd38b55bd5119e1f76012a2cffee209a,2007,FALSE,2186,179,Dire
ee3214bf7a66beef122c4f640638f1bf,64,TRUE,2721,2657,Radiant
357bc8c9a516017b38e9fb9dcd19116e,342,TRUE,1481,1139,
e13c2ef2c30fcfaa6f65c252449d6ad8,662,FALSE,2910,2248,Radiant
fe3cf529211320703205f47fe8b37ad7,563,FALSE,2139,1576,Dire
2e8ffdcfe2b919fb373882cf03594088,573,TRUE,3001,2428,Radiant
576e0be31c1bc7d6b0003016e8278d99,1116,TRUE,2921,1805,Radiant
5ba67b11e225d5267063b9a7ecb2272a,1075,TRUE,1786,711,Radiant
caa715c5a2f7121fb586e729ef1b7ec1,1355,TRUE,2252,897,Radiant
fc38e79e1ac642f37fccbbb8da959081,1000,FALSE,2233,1233,Radiant
8576633815943f91fb8432c786deb1eb,1064,FALSE,3279,2215,Dire
6999ed50c0f8c42757da399ae2b18adb,1823,TRUE,2600,777,Radiant
4039022de94831e121c235b3b0e3270d,147,FALSE,1602,1455,Dire
adc90acea6977f39562e2b8886057da9,1828,TRUE,3311,1483,Radiant
4e29d255c314fe9944bcfe91aa386943,1524,TRUE,2274,750,Radiant
437ce27257f6d4046239c0178b184502,1670,FALSE,1954,284,
3cc5181b75fb81d93a1ad54f77ae24c7,1756,TRUE,2137,381,
e839089955e57dbdfbdc46e277cb835e,809,FALSE,2030,1221,
bc15c67a96f1194427060d5e0f2a924c,3042,FALSE,3845,803,Radiant
007055d2c08c0143ff0b3e92b74e7791,957,FALSE,2864,1907,Radiant
f432abf8ad8e6ea20b21d9222114d11a,460,TRUE,2654,2194,Radiant
e57bb1f1c14cbcbbfd5965b5799b3db5,699,FALSE,2868,2169,Dire
c9304358851b3fd59fe44f35d6fe8c30,1374,TRUE,1807,433,
a99370b99b4083906d9a9ae561f65545,2075,FALSE,2413,338,Dire
f271f171fd9a18737be3290f63875ea1,1250,TRUE,1742,492,
e984aec3edd77aea1b537ec07e591a23,2462,FALSE,2621,159,
56173b73607711b7578023b6d2dc771a,905,FALSE,2976,2071,
3d367287e9e720c18eb7b2593f940046,697,FALSE,1696,999,Dire
38224744f5ae38fda617ae6915f30c14,3491,TRUE,3741,250,
bd5ca76a857545263518cbd505537f02,693,TRUE,2584,1891,Radiant
330be498136a0017d5309c12906b74cd,1467,TRUE,1901,434,Radiant
0f05c1ebcf7ee9adc6e9b09383a96f5b,1878,TRUE,2339,461,
4645b51c57210b22257278829636314b,505,FALSE,1230,725,
fd87e9f5087c2015980df73afc3a0f00,687,TRUE,1154,467,
d8227fdd7ae5ae59424353d531034d9b,1237,TRUE,1717,480,
ed687ccc728d991253ef4c50da14d868,236,TRUE,1495,1259,
aef1abfb1aa81d48e649bad22e2d137a,1017,TRUE,1092,75,
5f075cd8328985e50f184e4cba07c4e0,1051,FALSE,1753,702,
9e01aa4f5289f2068c98ef9fe4f3757c,1735,FALSE,1899,164,
a0252fc8404501f6cf57421f6dc4d776,2081,FALSE,3711,1630,Dire
24f5e42cb44d4cd5fe7d663ab540729e,414,TRUE,2585,2171,Dire
a77a50f24f53a4a399ab135a111e7c95,1996,TRUE,2582,586,Radiant
5533102edf20b1bbb78f5274f30e5922,922,TRUE,1896,974,
4c564a19d83ea4e06293f81fba36aee7,927,TRUE,1103,176,
b9d0d5ae7c438fa3e499fee3264e7f02,2268,FALSE,2865,597,
8d1ab9136231e11cd2d0f5708941917c,2057,FALSE,2854,797,Dire
587981cf0ed4c00b262fa595f52023a8,1208,FALSE,2191,983,Dire
ff6b7f4b745c5c13d6d5140231ef9ae3,2222,TRUE,4693,2471,Radiant
1f84623bed8bd4799d117ec4ccb5f1c2,1376,FALSE,3516,2140,Radiant
63b50ab192934624ad72272b11b964a1,448,TRUE,2206,1758,Radiant
ea6ae8f036f41d9797610f4f5f34ddf7,1065,FALSE,1610,545,Dire
5aeb7d4f09566ef6661178687760b580,1339,FALSE,1911,572,
b322aab52f1a74845f69d87ba3a49663,2021,TRUE,2931,910,Radiant
17d63a802365624402b51a28fdcfeb46,2004,TRUE,2090,86,
77d7ddc1bdcbe98f017c5a4e6ad122fe,139,FALSE,2611,2472,
91484c21f8a8a769bdf32c2f456f52aa,1527,TRUE,2161,634,Radiant
d38ec236551ba602c88a84673cfe20f8,723,FALSE,1933,1210,Radiant
b57855b7f73d93adbb2bb8272e5d6f28,1328,TRUE,1899,571,
000a9891b8b7712e9a19e032b583023e,1142,FALSE,1728,586,
f9a0bbfbf2a8738633a75b06d782fc74,1555,TRUE,3181,1626,Radiant
bc9dbeb16093ee05cc39cac4714f243d,406,FALSE,3544,3138,Radiant
7b2c8742325c75f8f69792033bd76ecd,2615,TRUE,2779,164,Radiant
1fb47fb6d5d6f7f0fb9a3e93eeafe37a,1827,TRUE,1918,91,
ca1828571f6bb979e07ad4f2ae8878f2,1876,FALSE,2324,448,Dire
bc92493ca816bed18c7b701cfecfc527,1377,TRUE,1751,374,Dire
88972d6096b8418e27c6247c83f09f69,2311,FALSE,2391,80,
0793ab032e357453faf17dd3af247513,1959,TRUE,2323,364,
677318988b3e468084fbd85fc3eef9c7,1229,TRUE,3011,1782,Radiant
6e53c1b047f140743fdee398a09ec3d0,1925,FALSE,2964,1039,Dire
b3830ecd4fba83e3f5353a925b91a00c,1695,TRUE,2293,598,
e3b9c8d4ffa8363b2bbe7ec31ea7516d,728,TRUE,1912,1184,Radiant
3c3110becb390953044a52ec2b3c740e,403,FALSE,2386,1983,Dire
80a1f410f5a1e3b6dbc5be8151254a94,177,FALSE,1388,1211,Radiant
2d7f2197a86d634ca7da51e366db1922,647,TRUE,2617,1970,Radiant
17399a5bb99a5f163b33730235c4c203,910,TRUE,2902,1992,Radiant
eb1fa12675d99e099204a015442245eb,1516,TRUE,1566,50,
d77d5ff3770dfa09a1d9f63d53dbb541,648,TRUE,3687,3039,Radiant
4dd007b8191fdde81ccc136b4e13f101,166,TRUE,1631,1465,Radiant
ffc23a5fbdb8b109ab4eb5dfc19bea08,1248,TRUE,2042,794,Dire
ead67e9f9b100885f2ffbaa9d4e584e1,303,TRUE,2570,2267,Dire
f144199bf7e032e8784ee1b68320663c,1735,FALSE,2638,903,Radiant
d039c51c146ceed99fa2b744b526909c,106,TRUE,3057,2951,Radiant
548bfcc80a57f9025155554ab890a2d4,809,TRUE,2069,1260,
091fe0ac6056b167a645eff06dd3b07c,2154,FALSE,2333,179,
ab539aaa41ffdcb66c26433b0c5916bd,1936,TRUE,2631,695,Radiant
ab3cce4b0d7e35110676361bd0dccb92,1531,TRUE,2834,1303,Radiant
81d8b3665dd96572789f3fe10e38039d,667,FALSE,2128,1461,Dire
09901cee3556a7e1a41fe6757d7c4c47,402,FALSE,1910,1508,
c20143e165b0841073587d151a709ed5,1892,TRUE,2163,271,
3c582842afc7b05ca67d119cd5507a3b,1417,TRUE,1598,181,Radiant
9d36ac76dad34d88d2f99af97184e8de,705,TRUE,2316,1611,
054c69d0e4347909f0c903189de3c07a,593,FALSE,1407,814,Dire
d5f58b3f801e5e852223ab947b2b16da,1563,FALSE,1597,34,
f0344b3c943110723691ce7fe569683e,545,TRUE,1905,1360,Dire
b41a0da683cf9788a8f8e26a3ea62b6c,1605,TRUE,2505,900,
b32113dfba0e7eb8bc1254bd5c095e47,180,FALSE,2154,1974,Radiant
1a48eed1bba3486d51df37d8b45b7322,77,TRUE,2524,2447,Radiant
7b45b0dad93d26ad89121f4f1a1f34f3,1131,FALSE,2362,1231,Dire
ba61809b94b01130d75c18f97ecbcf87,2603,FALSE,2989,386,Dire
e4ba5dd5966042b02e22c893f240939e,1445,FALSE,2328,883,Dire
f0ab119e6e8234108c6d15dd7f4ab49c,571,TRUE,1709,1138,
9dc85ce29e7ce7f5937779031b872cb8,235,TRUE,2080,1845,Radiant
31d159e03a03dec9b4500a442c162ea5,746,FALSE,2144,1398,Dire
4b2e3c9d05427130183e1d48aed6bcb1,1429,FALSE,1814,385,Dire
7f73093f3c213fa8238e2c5d7d3ba022,2048,FALSE,2994,946,Radiant
66b2aa8be62b99f7ef2a6ba399ce680f,2839,FALSE,2942,103,
94d306098094fdbe1a2facf5f50082f7,117,FALSE,3153,3036,Dire
006a0d50bb65c0a04aa8e65b5890f977,523,FALSE,1552,1029,Dire
a8f82a4213ddcb84422e124e5cf6371f,644,TRUE,1887,1243,
b108975679fb5bdf3a9c7290bc99f168,1748,TRUE,1968,220,Radiant
8c5f81a3728a99b3af6b8ee6c998cf23,1894,TRUE,3042,1148,Radiant
d50d17d3e0b0502db68710eaa946d343,1765,TRUE,2361,596,
65ebaa9c65e86e03126f1f1e58600679,619,TRUE,1682,1063,Radiant
099cf5067dc18de66953e8f588f4ecd0,274,TRUE,1535,1261,Dire
c719d40d23c5823b3831d1528ca4aade,613,TRUE,1741,1128,
dc1283b481295a7198f6c02aeea78c51,1451,TRUE,2036,585,Radiant
a1c9b3c6596dd0328239867669903c04,1590,TRUE,2959,1369,Radiant
7fde597cc7268ab35cad13ab4bd71fd5,257,TRUE,1975,1718,Dire
35fc2ddf07b4b947ed03d2bab0b5f372,2480,FALSE,4295,1815,Dire
316c106f0eaa60c5b8379973f8a63b9f,344,FALSE,1471,1127,Dire
26aeca21c942e8747c4ce9108d404add,3249,TRUE,4044,795,Radiant
625cffd7dfc63d5e55ca74b16a6dee7c,278,TRUE,1734,1456,Radiant
e1ad19660cc653d981a75b3554ab0758,1041,FALSE,2198,1157,Radiant
cde1dbacfc22200ceff2633b00678e20,1788,FALSE,2370,582,
09dab87553e6c6cd1c2a3332ba588a58,715,FALSE,2057,1342,Dire
438eb7cc907f5cfc12cecbf0992ebb35,88,TRUE,2180,2092,
6269e41db84c74a5a56087ef737c024f,366,TRUE,2472,2106,
5ec2bc79a2eabb1b5e6e8c0dc9c143d0,116,TRUE,1847,1731,Dire
38539d6d5c97faaa16369ad83b347418,753,TRUE,2823,2070,Dire
2f4ecd90377acbc602d6289bb9966130,1929,FALSE,2153,224,
9ef13968b9bda186082c703dc9883fff,1209,FALSE,2205,996,Dire
de2572d5c0c5cf97bfbbd9bdfbfcfc03,371,TRUE,3458,3087,Dire
365604d5986c24f8db03bdd2ab9608e6,2957,FALSE,3057,100,
0564df8b843a229823d94f090516de2b,2202,TRUE,3021,819,Radiant
b53210675c4dd845d7929ed1813d2321,1000,FALSE,1832,832,Dire
4d20b016fa120848259bb6a895642336,506,FALSE,1314,808,
3826b54a831aa05d1dbeb8b15dc18aca,1748,FALSE,2178,430,Dire
8a0465fbcaa3fddb878c8238bd54c273,572,FALSE,986,414,
3e284ffd625d66b46fa47a101c058449,1511,TRUE,1784,273,
32583735fd043923041db2152c079162,75,TRUE,1767,1692,Radiant
7ac09ae19cdddc3384b3ede6549a8f3c,501,FALSE,2007,1506,Dire
06f0fcb75ec6c96d1e4930987d776603,1461,TRUE,2484,1023,Radiant
229ce857e0d05d50b6caceb0e28a1e8a,891,FALSE,2351,1460,Dire
e3bc1d701279b9671216afa4318c14ce,1116,TRUE,1544,428,Radiant
edb26dea381aeb949790caea4f94f424,501,FALSE,3211,2710,
a31f226a64cfc6e13b201e67e21fcef2,1644,TRUE,2046,402,Dire
31ee103fbb556cb7e526068e140edce6,1257,FALSE,2302,1045,Dire
6ecaf2529c82b074e0ff5e48cfd0b165,843,TRUE,1655,812,
d946f7ded6467f41de3c3a6a277d243d,6,TRUE,2414,2408,Radiant
c392fea555ac0c96762d4a1fc9635bf7,1642,FALSE,2759,1117,Radiant
d57209ae5d06fe4aea8b7729c90e68d7,2274,TRUE,3455,1181,Dire
06bcf6047b3eaa806502fe09853eb53e,618,TRUE,2335,1717,Radiant
e00773de22db2af58a4b44bf2a319632,297,TRUE,1588,1291,Dire
8e463bfdca05fb7a2fbfde93b0febe8f,2476,FALSE,2513,37,
e9d61ac6ab52b83db08249cadf45ec05,1542,FALSE,2770,1228,Radiant
6b0ae3b396098c9694d981e38828fa02,1659,FALSE,3395,1736,Radiant
08cb1f943a9077663d26250b624fd367,189,FALSE,1667,1478,Dire
5a3c72aaf6ecb244fe0428278cad158b,1069,FALSE,1944,875,Dire
46f0f56aeccfab1ac8891e5fbbdfb6b9,1026,FALSE,2754,1728,Radiant
67a28d98f639ce35e6efab24533216d7,1955,TRUE,2732,777,Radiant
07e8c5ab5b11f41e3789df8d8f6f7de0,573,FALSE,2983,2410,Dire
12913ff374c007716d71830552030bc1,1159,FALSE,1206,47,
8b4f499e388c9048e7577a440a4c30c3,370,FALSE,1947,1577,Dire
c00bd9dd81d5a1e79475a69d67e6626d,452,FALSE,3073,2621,Dire
c32992ba947218ebb8701d4a33b2514f,8,FALSE,2685,2677,Dire
ee700bc3763d896665e18486f0a32f62,1720,TRUE,2305,585,
a042b1a620bef4de16686cd47d88924a,2275,FALSE,2333,58,
420542cc78655a1b5e65b5ab71354a29,1494,FALSE,1995,501,
2c2a962b912aed8eb0ee6e9dbdfd9707,702,TRUE,1133,431,
d2e100f8afbf59e38bf8344c0908faf2,2170,TRUE,2394,224,
6f75b6a8c78ae7d2da5ea893e8b6f96c,801,TRUE,1020,219,
a7a48f6234eacf0e7235f8bac2d96c1b,2012,TRUE,2388,376,Dire
6b116fb1562ba0173020d93fa07ecebe,1159,TRUE,1610,451,
c9d328639222ca7808b2d4cc578dc306,1472,FALSE,1824,352,
2d9288be4defea88d628585bd5f994f8,421,FALSE,2857,2436,Dire
fc85a97bb6acd0abb8fda46c2e1db61e,1395,FALSE,2517,1122,Dire
af81f66f265db9f6122cec57fba0dd1b,1205,TRUE,2209,1004,Radiant
9b82382368c50aff5b947916de5aa17e,2630,TRUE,3389,759,Radiant
87129d3bbc61d0e338be8b3f0ffb678f,893,TRUE,1919,1026,Radiant
b16e3f08a7fcae82def31eff0470e076,932,TRUE,2373,1441,Radiant
0e93d38b06506150e94a46c9a193dffc,177,TRUE,932,755,Radiant
6c5c80018eb7830d0e115e5e28362af0,1309,FALSE,2763,1454,Dire
c06eaa2fe988e2fd04d56ab173f8fb49,1773,FALSE,2083,310,
7c374191e12426c4448cde770dbddb9f,1344,TRUE,2185,841,Radiant
3763fd2c5d2f680057800403f3533752,1853,FALSE,3508,1655,Dire
27a72138f9d2d01441894f2db4966e77,1644,FALSE,1911,267,
6678a7350edc313d8d1c1fa664e26594,293,FALSE,2914,2621,Dire
60d95c4239d767bd67e180b4125067fd,1972,TRUE,2536,564,
6cc3f7e5f63dc26659b287a391e0a981,1554,FALSE,1707,153,
e44d87bb75624bd46e86d1de616ccc9a,137,TRUE,2229,2092,Dire
9f84133ed66c913e309d77550d3a6a9f,1989,TRUE,2047,58,
db6d5795ee48312d85f5d8bad46d0e8a,109,FALSE,1710,1601,Dire
0485013bc8263c76958317bc2faf1e06,1414,FALSE,2057,643,Dire
e77e451bb457000d53ccb93bd0baa34f,1875,TRUE,2394,519,Radiant
57507c15ebd87aeec0d16866e9734488,2631,FALSE,2865,234,
6041f27a689ae35f8da77424c6d49713,1157,FALSE,1194,37,
5b661e28ada2b85d8391561246399a1d,652,TRUE,1504,852,
7ef7affb5f0de2c79f6b4d3214b1841f,1340,TRUE,1955,615,Radiant
efa7ca3062575b9b0c50f66f481824dd,1269,FALSE,1541,272,
5217d3b5aba1324f82f16bdc54914e48,125,FALSE,1959,1834,Dire
b3cccbaf56494af9692bd63189194aff,28,TRUE,3169,3141,Dire
d373903a2ae70a8a0ba16d2308a30839,1053,TRUE,1143,90,
7fdf49bb9a993fef00075f1ddec2193a,1468,FALSE,1908,440,Dire
47245ff047b22049208dfb3b641f25a6,624,TRUE,3161,2537,Dire
1dd5fb3f3a9ac0c9411f9a64736cc429,1411,TRUE,2503,1092,Radiant
3b5ad18fe95a233a7ef1d32fb31aa1b3,21,TRUE,2042,2021,Radiant
41161dd590c261154be6121d709c9f17,1100,FALSE,1286,186,
a52e456f4ae992fc204e11c12781240f,143,TRUE,1440,1297,Radiant
a403115f3347c7ae5bbfd13d5730f4bb,736,TRUE,2606,1870,Radiant
32affb045f4e5e40bc272502c1ad2c62,1598,TRUE,1909,311,
1741e23d5f2eec8fbfc61d515b7f3dec,1248,FALSE,3309,2061,Radiant
6a49b2b9d90fef1af3be9bb6259c2ffa,842,TRUE,2770,1928,Radiant
e2859a9581e2cc43f45b0e44e01cbc46,823,FALSE,2568,1745,Dire
b28c78405c9e9652444781805cad5b50,775,TRUE,2072,1297,Radiant
f5329966f7bbe58309fa9ce089389409,432,FALSE,1588,1156,
736fbc6db97a05945feafc128df1b48b,516,FALSE,1960,1444,Dire
45cb4b4f6e2be3ec2f1f22fbc59840b8,69,FALSE,2173,2104,Dire
ecc18eb4f1135c4c600eae92b1854692,957,FALSE,2118,1161,Dire
b5db1ad04984ac7d9b802055e547ba10,1041,TRUE,2892,1851,Radiant
206f55f78eee664c61664f1d78896082,8,FALSE,3318,3310,Radiant
0065ac0f5631ddfe3f02c30ff09d47aa,1056,FALSE,2516,1460,Radiant
97963f2a215ce5be07379667796d0717,1677,TRUE,2855,1178,
b633bce00a9c848ba85f75ad0bdde948,1902,FALSE,2050,148,Dire
6b8a3aa399ab170a9256c5504e2bc108,1031,TRUE,1878,847,Radiant
0fb15d37ab5cc2658c9ce564d668e84b,1444,TRUE,1945,501,Radiant
a199682f14f65e934c5694e96be1b627,2103,TRUE,2483,380,Radiant
1a3ec41aace0e70a23877479063eaea4,1455,FALSE,4661,3206,Radiant
7264dcba8de9a896c6b5834d446316af,930,FALSE,2824,1894,Dire
40c7e490313187f5e76dd11933171117,1087,TRUE,1194,107,Dire
f78f045d7b9f6be220915809c700c934,1045,TRUE,1834,789,
d15b8db1a0f3c58283e57a0921749ff7,262,TRUE,3476,3214,Dire
11d03dad9289f7708d3437e18d4586bb,1933,TRUE,2369,436,Dire
06e0918889d0fa0016145cfbd53af1fd,812,TRUE,901,89,
1a43a6050fbce614bccfe9d346e7ab60,624,FALSE,1663,1039,
43df3aada5d4d2973074beeb70bdaaa8,1876,TRUE,1967,91,
3d837961badba4322d00255eae65423c,1751,TRUE,2233,482,Radiant
1dd3dfab02a2931b68e68acb03a90ce8,1172,FALSE,2084,912,Dire
e3dfb1730fb7cd59072a2bdf85ef1cd1,253,TRUE,1978,1725,Radiant
b516b951406a35dd5d0c8b867a4412cb,368,TRUE,2182,1814,Radiant
f14298498943b9fadca33a1f96de1110,146,FALSE,1563,1417,
57234bcd0e6e10773035afcd381e822f,1364,FALSE,1626,262,Dire
828d4549c9fe24644e2c983aaef36d1e,391,FALSE,3409,3018,Radiant
ab8825328e2715cc4466b5c9775908d6,974,TRUE,1401,427,
fc0160d7cb10cce817c011380847c163,640,FALSE,1820,1180,
af78fdb240f069ebe52148320defa665,801,TRUE,1917,1116,
aa21a28f116049bec19610630df5ff94,2137,FALSE,2618,481,Dire
57d3784f811def9646e0e5c5afea7eb2,1538,TRUE,1838,300,
de05547822c656d0da3a0c4e1aa3ef1d,506,TRUE,2067,1561,Radiant
077916b0f7b4dfcf767f77efa9063b47,1582,TRUE,2286,704,Radiant
e2b173f48eb4b69d035d01d7e7d4d003,1433,FALSE,3204,1771,Radiant
dc557cb35112b2f047c3ec76db7f71e2,717,FALSE,3764,3047,Dire
bec50ff27548398a7e83e621b4624a1b,717,FALSE,2788,2071,Radiant
ec4e7619f8aa835d02d073d4689a2909,1449,FALSE,3426,1977,Dire
9cb5a60f94cbba5f9919dd9fd914a1c2,1484,TRUE,2055,571,
7e1255c274c9c7b826d48b5ad037ea62,639,TRUE,1982,1343,Radiant
89d6069e8195c0fc0d0d38ba823ed7ce,65,TRUE,2154,2089,Radiant
48ca8c7a7d48b00db1d4ac0db72d5e19,1065,TRUE,3267,2202,Dire
d781e11a9746380b688d2468e099131d,1434,TRUE,2059,625,Radiant
ff81cdec92bea358b7dfdd07782b3d39,1290,TRUE,2456,1166,Radiant
30e84b634b6ab5ce52ff884ff9436c0d,1991,TRUE,2038,47,
04bcfedfa051463c861acd7a94a43278,1364,TRUE,4223,2859,Radiant
cae9bb31f8792940fbe3111bb4eb01ee,1214,TRUE,2144,930,
bf20763222153c478a860c84d695e2bd,1126,TRUE,1333,207,
161d50292e48e78ff659187a78a05503,1132,FALSE,2177,1045,Dire
477bb9c3b8f810774150a85d91b5772d,3030,TRUE,3575,545,
71ef38c9c4e071579031c9ba27247379,84,FALSE,1763,1679,
059327b737eca7b5bd42ff4d13b148bc,1043,TRUE,2317,1274,Radiant
3f2de362c45f1ab04620b5b77b4daf1f,649,TRUE,1953,1304,Radiant
8da52a917acdf5a88e2680074fcfdcfc,1428,FALSE,3133,1705,Radiant
a46db64eacc57d75fbc081b8610f175f,1235,TRUE,2303,1068,
f07136b170dd1467360f03a7fb1f6cb4,1750,TRUE,3061,1311,Radiant
20442ed608610e580802bb7b3ca98633,2686,TRUE,3433,747,Radiant
73e40ba4e78ef104808fe2693f2d2aef,28,FALSE,1301,1273,
73f7e782cf24c4fac0e831771472813f,60,TRUE,2912,2852,Radiant
b4e36e1cab7dc8aff702df187f17754b,1595,TRUE,1903,308,
d1a7dc5b2d844272b86dcb3e7a792d91,412,FALSE,2075,1663,Dire
2cddbe772b38b5e9a06339f02159214c,235,FALSE,2792,2557,Dire
03de46b2e86a5988fe70ee6592dcfccb,685,FALSE,2328,1643,Dire
fdc0b0d56d3d1d8b295c2d92a0eb137b,2282,TRUE,4398,2116,Radiant
1136219e98a61236a46edb00227202dc,784,FALSE,1921,1137,Dire
1f21b183516f48be761347d752164bc9,3350,TRUE,3408,58,
6cbdf2289fa01fe1362b9aa8747ed913,1431,FALSE,2316,885,Dire
e432d7c6c0f08dd36e72015e13ad8593,1294,FALSE,2317,1023,
e613cd32d09f51558a4ffa50da69ee31,1392,FALSE,1710,318,Dire
63dbb58c83efa0d68369171867a5eb0a,1515,TRUE,3715,2200,Dire
e84774caf36f0f9c18f6c6ca05c9a371,957,TRUE,2490,1533,Radiant
28ba8d67c04eabb1eb1747bb7a8ad230,943,TRUE,1151,208,
2e8dab962a6e2f12e35314381256f261,685,TRUE,2840,2155,Radiant
a67d4094ec6dee58d20f14e890e0130d,3493,FALSE,3598,105,
16eb0d282e29cb9a847b5fd69efd8b03,273,FALSE,1890,1617,
55587db4418319b6319674651cd5e67c,2135,FALSE,2873,738,Dire
91d7769fef22a85f227285535edf5567,475,FALSE,2169,1694,Dire
74599adfbd4a46ba7f5dd4cf165370f5,1426,TRUE,1519,93,
ef9d92baa9de6d7ac20713d7573b348d,1603,FALSE,2313,710,Dire
21dd82a2d53183d8648b24c104abe4f5,467,TRUE,2087,1620,Radiant
5728c5a01d9820d43efbdfcf49f05291,673,FALSE,2228,1555,Dire
47ff25be71db70baca0b572c46e283a3,617,FALSE,2823,2206,
0f68cb51b8935dd4ad1608ba5a90edfb,605,TRUE,909,304,Radiant
192ef8c258a8acc80bc3e8a7138ca2d9,1701,FALSE,1771,70,
919c6b262d23eeca7e6a1deed135989d,1007,FALSE,1307,300,
24d7931a89ff4ee4a9dda2318ae01680,1351,TRUE,1768,417,
0ba716c5971b579d712827c668c16f50,623,FALSE,1877,1254,Dire
aa79001619ad08a3c1ad5da234e03a8b,1070,FALSE,1877,807,Dire
c5fb82136e3028af6d9c6d2b3a007d1d,686,FALSE,3533,2847,Radiant
319207b6ac23a2020d574fbdb4f70e67,3646,TRUE,3983,337,
94e962b9d31c85210d5d4c6a357c326c,436,TRUE,1003,567,
060160894919d0d7930b03779794d856,264,FALSE,2367,2103,Dire
e81501bc801b58919187f9fbcaa4547b,127,FALSE,2396,2269,Dire
25c7e8ba4e14bb49f4bf8979027c3069,1295,FALSE,1919,624,
7b6a78173f5fc8e456289effa2261a23,1828,TRUE,2310,482,
5892b2cc79af9bb1a62b2934f1989092,1582,TRUE,2543,961,Dire
fd6ab1098fd0ae0a2f9ef1e0e99dd8bf,1074,FALSE,2539,1465,Dire
eff10449bc728b1011c7df775060c1eb,957,TRUE,1745,788,Radiant
a0a97ca7d55fc8fb16567d8af1365d96,185,FALSE,1907,1722,Dire
fd16b9e597ee4d09453a53ff543d93d0,517,TRUE,3545,3028,Dire
79e9a23518fe340b5644e29028ba8d4d,480,TRUE,1824,1344,
c07b5de78fe707509982323e5a73af34,1312,FALSE,2769,1457,Dire
cdf3b0128241acb315a9c6f52dabe681,1211,FALSE,2159,948,Radiant
118245f68e0c304cf52697e6c5b3bf2f,116,TRUE,2451,2335,Radiant
4414e8585f6346cfa86f478e1d93cf77,1268,TRUE,2205,937,
0c646de968f418b4e4ca3b99f4f07ce0,166,TRUE,2907,2741,Radiant
48a321db74cf679308378ca67d2b893d,230,FALSE,2834,2604,Radiant
18179fa007c6cb0cfe91f288d575d056,878,FALSE,1475,597,Dire
af435bc48ccbafe05f34ef3895d483b5,313,FALSE,1070,757,
97d92542b3923e0f4c3f665fa517e417,335,FALSE,1693,1358,
3bb5127206d31d4d213ec1f6b0ac9899,933,TRUE,1529,596,
bf2bc137ebb4046e3a69970bab6a47fb,954,FALSE,2612,1658,Radiant
c79b624f32996eef70b11aee6a04d1f5,1594,TRUE,1957,363,
101b719aa2446bf8e124c69c04b0817e,146,TRUE,3147,3001,Dire
8113915f663b511d84935cb9716b5054,856,TRUE,1845,989,
ed2247549bac35944043f0a01125536e,1733,FALSE,2249,516,Dire
9567184dbd2e13d6c558eee7dc7262a3,521,TRUE,2079,1558,Radiant
2c4e3f751158dd7cf91667e479e2d176,6,TRUE,2924,2918,Radiant
449973cfd043e614ce71342eade8239d,480,FALSE,1466,986,
eb1e52de6a7379a121455737d8b5a2e4,385,FALSE,2425,2040,Dire
45dbc831d2fba3f9d34b0e6c67569d46,1458,TRUE,2104,646,
864a9e3f1703bb41b1f6029756073d89,406,FALSE,2479,2073,Dire
60b6450d56f321b06cd62456c89b94b7,1492,FALSE,1906,414,
7e82beee2abd4f7185fc3426176d7374,387,FALSE,2325,1938,
02ee48d1516e092858aea7840387cf8e,2373,TRUE,3017,644,
b605449a642f0b27e76debbcda6a2c0a,50,FALSE,2887,2837,Dire
114a9a597ae9ec162b41e3889f7d5df4,2267,FALSE,2328,61,Dire
e31be38f2f0ec5378b1e3690b10dc4d1,1735,FALSE,2238,503,
6214801e9dbc3d5b5a0aeb3d1f1ce1f6,1788,TRUE,2249,461,Radiant
eb2c19da640119a91e51ae131d7f56e7,461,TRUE,1686,1225,Radiant
4f9860738171cc9dbb0fd7082b8e4816,1931,TRUE,2350,419,Radiant
323e38ea67c3c185f11f7071872a9fc5,1264,TRUE,1563,299,
73dc48763634027a8d20f3522d01ce81,1239,FALSE,2250,1011,Dire
fc2ca5b262a1a379c39ab74e73bcd4a9,1769,FALSE,2987,1218,Dire
101494efc2919cf1822d51ea70ae06d5,1217,TRUE,3219,2002,Radiant
e1d2bbb17677e192f7022fd793f689ba,783,FALSE,1778,995,
5b7c8d613c438e6c26a6687c9d89f34b,1484,TRUE,1561,77,
f2c88f98a000be9b6cc1f5c29b6fcc04,763,FALSE,2150,1387,Radiant
f852532f15018365d81332587df89f39,2408,TRUE,3293,885,Dire
31e61743992f9b31eca8da1311b86edd,1760,TRUE,2549,789,Radiant
3d8a0338f6164dca8a7404b93f9be63c,2235,FALSE,2517,282,Radiant
84b5c7f4deed302f486d2dbcf6466c29,2567,TRUE,3419,852,Radiant
9a83a25b230bd56a115953a885bcd4b3,1931,TRUE,2493,562,Radiant
fadd262d37daff30e5106001c625e49a,1263,TRUE,2559,1296,Dire
55d00fed5bb93cf62dbce3979e388982,1226,TRUE,3028,1802,Dire
5cd81c83995c85f11458dfaa1b4bc8c4,1316,TRUE,1927,611,Radiant
28ae4224aab83d0c5e7aa4b29ee68b23,1727,TRUE,4041,2314,Radiant
bee1b231047858a923176f75a3cecfa4,1015,TRUE,2354,1339,Dire
d5a4ded9a41217f691a6f1452b120e86,512,TRUE,2200,1688,Radiant
2e0c7f898619846e1c0839aea28c51d9,758,TRUE,2331,1573,Radiant
8c1fa3e5ebb3226bcca565f36dc5974e,1203,FALSE,4001,2798,Dire
3f2c6a8ec7eca3196706574bd4683abe,1429,TRUE,2716,1287,Dire
dabb09ca49a2d9fa30d6d3b7742e9c64,749,TRUE,1972,1223,Radiant
3c5e3a2a3a9314268a2cd8783ba4fa1b,2190,FALSE,2356,166,
742ed894ca2245645024fb0f6c40f036,271,TRUE,1888,1617,Radiant
5933f25349f6f8dea1f6cfbaedb1bc0d,332,TRUE,2093,1761,Radiant
9f7d04d0f44f4c83c3ab55366b4f7fec,1706,TRUE,2152,446,Radiant
c145424e74a55e7871e4c6f28b01c20f,1324,TRUE,1582,258,
730a966537d99c4316ae9197d1d39a32,1073,FALSE,2186,1113,Dire
3ff57e87f961440db4100e628a00d6fc,77,FALSE,1487,1410,Dire
7944ddee310c77f5639ec2e2b8089aaf,394,FALSE,1865,1471,
7aca2575d67d12e88c91585b53087373,962,TRUE,1363,401,
d9c053fbaf329796195605e6fd88aa66,75,FALSE,2639,2564,Radiant
684d85229de65bc3d3b8db7c0f152c5e,767,FALSE,2689,1922,Dire
dcf4aac7a918b07c39ddc79ebdb66125,282,TRUE,1227,945,
84e83646183353fcfa1c93d79f1995f2,1456,TRUE,3258,1802,Dire
529b1ef0a3d1feed474e3bf0d3e2fbd6,936,FALSE,1623,687,
4ee5ccccd99aba8dc571c4956dece65c,2165,TRUE,2572,407,Radiant
0ca2402881939fd99db40bd1413c1a90,1992,TRUE,2577,585,Radiant
c0940f653fc6f628995284713b3536dc,102,FALSE,2045,1943,Dire
516c7b0ff7cdf4f356c32b1cb0b8eacb,1806,FALSE,2723,917,Dire
9d872cc15934150aa4e3b44fcba00af1,1474,FALSE,1540,66,
e957ae90c6713913b49a738b6e797639,864,FALSE,2023,1159,Dire
bec6d066bd7e7a749940829994409393,926,TRUE,1390,464,Radiant
a8029a452f83a5998ae234da64c2632e,1886,FALSE,2979,1093,Dire
a34d04ffb5f8fa3d81d61843c302caa7,107,FALSE,2744,2637,Dire
0c724e9e6a4b61402a539f1e7a6810f6,2705,TRUE,2755,50,
cea5d5dca506c3bb5ac74b0124db759e,884,FALSE,2699,1815,Radiant
5511553db1a4ebc7bea0392ae2a22ffc,474,FALSE,2564,2090,
472eaeb301c2c65cc4a89a9b34fa69d7,1719,TRUE,2267,548,Radiant
dc50f6ae04d57ad821e8d63b3ac67644,2143,FALSE,2603,460,Dire
a37bc09ac134528b3baaeafec2a3ca02,1027,TRUE,3126,2099,Dire
d8cb28567730ad663765ba19e7e74d45,807,FALSE,1899,1092,
44b89c243a9af934867e719ad2fbc214,1709,TRUE,3375,1666,Dire
546b33398961dabdadc56427bf26f747,670,TRUE,1730,1060,
4eff8862e47be2d3d14d598c94797a9d,2520,TRUE,2945,425,
83657118ed7beec7313d3bba9c60d8cb,1912,TRUE,2665,753,Radiant
e2b75f6df57ce4435e9a81f825177ad2,1649,TRUE,1747,98,
620ba9b4c93de17ac7cc7d951cc8c702,1343,FALSE,2496,1153,Dire
31316c7553857148223670fd434a4abe,918,TRUE,2514,1596,Dire
bc39eccb23cda98d9acc724a1a83e217,355,TRUE,1444,1089,
0066ed551734daf0441853b9052dd4d9,1954,TRUE,2334,380,
2dbe776246bf46f6ce33fca20954e38a,245,TRUE,2758,2513,Radiant
d13ccb5959e62c1b0e534077c4667b6d,476,TRUE,1045,569,
555f78105f23a5419818bc8c09cd7c1f,1800,TRUE,1856,56,
0d92795487b4e93bd427d9c0d6333a9a,1960,FALSE,2611,651,Radiant
1e5f104950308bb9e768d312e9ac82d8,2011,TRUE,2641,630,Radiant
41c96989de601a6b4d7756301effcc98,3192,FALSE,3954,762,Radiant
0496e7d99f76790041bd2b498ef7509f,685,FALSE,1551,866,
c53f9d75e31d4e592c6e6185f6dfa2b2,1310,FALSE,1468,158,
004e4782f016a60100d63ab57fbe7ab4,1549,FALSE,3680,2131,Radiant
5ed9964470a2939a3e468d678cd874d2,460,FALSE,1635,1175,
21f71aff874d9e11e0f9d979603b166a,697,FALSE,2113,1416,
0a67629166697c909a6558e221e4c595,28,TRUE,2338,2310,Dire
15adaf6566692e85e7e67fcc7540e4da,1429,TRUE,1665,236,Radiant
a5b39d3f5053df4cc60b4273e009989b,2016,FALSE,2148,132,
06f14d4aced25dafaacbb87c68c10099,229,TRUE,2298,2069,
144deb50784c03aa319c8499fa6ec5c0,1451,TRUE,2352,901,Radiant
2c2f0f9524a12d65d09b30b9101f3da3,449,FALSE,3463,3014,Dire
4b6f4798b1f7c06cbaad372d3a578c79,1117,TRUE,2169,1052,Radiant
1d11488068f6978d69d8b74c9e56095e,1990,FALSE,2513,523,
05c4f7cbc7c6d0647ed1984cee748d5e,634,FALSE,1664,1030,Dire
54f373e70dae0dbfb52bf84c71cc3834,1969,TRUE,2322,353,
9280d2ef234566130ee7941a5a3b7a3e,856,TRUE,1730,874,Radiant
57a20e7d9ec571ece84d8c65dc500923,3300,TRUE,3382,82,
68ecb5ef07885cf9e1a7ae80eefaf7a1,911,TRUE,1499,588,Radiant
31896cac384f2de62c804240747f0ede,245,FALSE,2519,2274,Radiant
cd5cd5b7c4f488e3ab683f0fefffd851,1248,FALSE,1542,294,
a0f06129b454b5ae088014cdc00d0877,1719,FALSE,3364,1645,Dire
8d315edaa8143e59c84ccb6ba95d946d,560,TRUE,2998,2438,Dire
eb0762139916385759c105f0ed86247b,1767,TRUE,2102,335,
6d396c544838524c919c58cddbabf674,366,TRUE,1650,1284,Dire
c6ae34c2c4dd0d8ef473a7c027ceb9b2,1283,FALSE,1957,674,Dire
f409c1100a191e9fff96656b8f61f400,574,FALSE,1345,771,
5c7ebceebffd4b310e674cc3d6ee3e0f,977,FALSE,2593,1616,Dire
6b932633bb415f9d1b28594578bac978,1969,TRUE,2152,183,
d652fd61b74ef4804e22f944c2d507bb,223,FALSE,1675,1452,Dire
7068962a3313666a9586798a886e4660,2328,FALSE,2431,103,Dire
738bb09124ae18cb6494407742f2d7d5,79,FALSE,1398,1319,
65896d07b7b30161710cc4c385a2686f,1860,TRUE,3266,1406,Radiant
e773dc3f774ad1331e0e903ac5154c8a,88,FALSE,1709,1621,
206e441cb17b2b8de227cb7bd27a6fbe,499,FALSE,1232,733,
308c0a85a75d54f7d1a9a27a73b62562,1983,FALSE,2782,799,
e4711625c1c1f6618250ad60477dde71,680,FALSE,1956,1276,
fc4d5b6f9e596de10bd32b3e86877b86,942,FALSE,1160,218,Dire
dd61439e765eececad73e75883a110b6,1266,FALSE,2393,1127,Dire
c4ddaf8c2743ae54f0c2e364b5e921ca,78,FALSE,2644,2566,
ac6a7c7233c15f3aa7eb3e2734fc7e8e,1029,FALSE,2178,1149,Dire
2ce22834469edf9bd42bab1e74aa8a63,666,TRUE,2217,1551,Radiant
e3221406e85899780d10ef351c769ca8,2914,FALSE,3835,921,
9997c4ed72fdbd8dc2cf1571d9c5ed27,86,TRUE,1879,1793,
7db282fbdb84047c5defc2b3421ee188,372,FALSE,1801,1429,Dire
f7cab72f8bf1bee4123b224bed971c76,96,TRUE,3364,3268,Radiant
73dcfaaa1fcb79fc21a6cb711037944a,8,TRUE,1217,1209,
2899f3eb6ec851bed94a7a18a39c3ea0,2345,TRUE,2757,412,Dire
94fd7ad27cef6fa04445ff1679a89ac3,2428,FALSE,2575,147,
3c94182c4949f008934c762e2dbc07e9,980,TRUE,2073,1093,
5d768eeb9ccdafaa2170ea57231c54c0,2921,FALSE,3301,380,Dire
b9f5bade1a3ab977a10406a888891a06,1679,TRUE,1921,242,
ebbd7440f138f052576033d8b215e282,429,TRUE,2376,1947,Radiant
b641fb20c7e22cd0b4544beac0fe5838,886,FALSE,979,93,
0ffec12793670a7833d306b982e2cdf5,703,TRUE,2277,1574,Radiant
391dc66e93d070f3953f28ad6f652d7a,333,FALSE,2786,2453,Radiant
ffdde0bb497096e0aecb7eb27fda6198,947,TRUE,1417,470,
1fed1f516b11ef7ab41902b967175e30,1640,FALSE,2072,432,Dire
d5c1566996f72843b80f12c4cda4b067,1643,FALSE,3689,2046,Radiant
586b8ca78d670b88860b59ae395ef4e9,299,TRUE,3081,2782,Dire
2cb06a29fc3996019de9bf33af4e736e,155,TRUE,1412,1257,
52695608b038f88e5cb5a8a3435ecb10,2870,FALSE,3734,864,Dire
887c89946523fb79e616e94125e50c9d,913,TRUE,2664,1751,Radiant
10b9d4406cb84af5a0a9fc8c813655f3,51,FALSE,2300,2249,Dire
35f0f54be17349c13348e9a3a7a4298e,2395,FALSE,2509,114,Dire
a75b1585979b5e32e57939cf8c36d589,1372,FALSE,2210,838,Dire
95e3604e3c79b3297477e779b78dfba0,1282,TRUE,2646,1364,
22c5e6369402ec3109b5c44814bb8d68,282,TRUE,1809,1527,
bccbcd375bf545adec39d9b843e779cf,1109,TRUE,2876,1767,Radiant
c7ade3c054e4c5b3ec65fc58fb817513,316,TRUE,2077,1761,
03c365414383c4a323d3ec3accfddd2b,1893,TRUE,2790,897,Radiant
13431e756f45cc1c9dc908dca3aabe00,1681,TRUE,3661,1980,Radiant
cfd11ae79c4f3c025171af6fdf55e7fe,1047,TRUE,3299,2252,Dire
46f9b1f85a06a25d64c0906885ff21de,365,FALSE,1861,1496,Dire
e9b93a7dd94d1286c87bc55b70fc83a1,792,TRUE,2824,2032,Radiant
284d4d65732628df07e5dc673bc9624d,2492,TRUE,2595,103,
b1ad1e70acd94cd6ebac3d83c6acbdf8,460,FALSE,2087,1627,
b4c7a8226de8bc1e1d77863865b025c8,1617,TRUE,1762,145,
b9601713b890098051eae3b4a6a20edb,2564,TRUE,3508,944,Dire
9e17ab1f8e07f6a909821dc6635a2e6e,2024,TRUE,2661,637,Radiant
9ad562d22577fd7197a39bfef7ea7395,463,TRUE,3550,3087,Dire
2ca227ce2d0e35ba8df5b68ead6826da,505,FALSE,2555,2050,Radiant
5bf284646a5aec0c0ea3a41ea47cc419,1421,TRUE,2496,1075,Radiant
dd09e99699da69245becc66da4d35f30,343,FALSE,2951,2608,Dire
49e06c6b91dc7c51e6525bf616244246,327,FALSE,2627,2300,Dire
6517cddb6243d37e46d55854649e694f,763,FALSE,3529,2766,Dire
d2897e49fce47223b7e251f22cc2319e,2376,TRUE,3307,931,Radiant
f966059e71909e64b7c04641bf743509,391,TRUE,1481,1090,
5674b6fc85433a9d2051e422f8dfc8ae,175,TRUE,2676,2501,Radiant
d5bd7287a291193c4c244bd03cf2f4e7,440,TRUE,2525,2085,Dire
f8f190c63e1a7737b29cbfba442b40f2,311,TRUE,2185,1874,
7987b946a42b8de159d6c961aa99c242,579,FALSE,2083,1504,Dire
d216b0e78c5cb510c9f713c133db7729,1063,TRUE,3826,2763,Dire
93b4af699866db553221260e6cf748b7,1225,FALSE,1794,569,
88632bd67951c327d6b439011c6e7e3d,1241,FALSE,2057,816,Dire
0a91f4237aa385edbf8630e71ab45b74,221,FALSE,2035,1814,
0e5e4c85a89b1bb9b3a251715cbf06b5,99,FALSE,2739,2640,Radiant
cee0f01e49b5dae732a4a5388c8442bc,1449,FALSE,2361,912,Dire
8d3211edf9040129110d9b4ae43c26ee,1335,FALSE,1910,575,
ee462a16a8cf36056c76d9aee12fda6b,2449,TRUE,2777,328,
c6ce75760472777cc0c4297465687968,1370,TRUE,2135,765,
a48c5bb7fb42857b682e09eeeb693684,1979,FALSE,3016,1037,Radiant
7cd5b2080e78e1ce9bca6e2433c8868f,1221,FALSE,1411,190,Dire
0fdb23aa3af1de2efce5fadd0a16ab61,1623,TRUE,2314,691,
f92514f84257d27d74e8f5e423ba1417,491,TRUE,1640,1149,
7084831a968cc9dc1fc1e613f3382172,1421,TRUE,1703,282,Radiant
757022446c635ae6d247bbe871c591bc,1481,FALSE,2485,1004,Radiant
08fbd1beb6d63c2f1dec404baa20152e,4211,TRUE,4335,124,
d21686222512701a234b654d9dc2becf,732,FALSE,2145,1413,Radiant
c5d46cd5a35f4fc5dbe7fe4215fc676c,1592,TRUE,2185,593,Radiant
4928d8841e657a07e328583099123441,881,FALSE,2304,1423,Dire
11943fb5b808823d51e4b9871d2658bd,2286,FALSE,2826,540,Dire
872af0eeb7f7883aab401b7022b435f7,485,FALSE,4195,3710,Dire
d645db6f8168e6f557eb8e232a41f403,62,TRUE,2556,2494,Radiant
fd870ee23823018ead7ed2f06c4b3f8a,60,TRUE,2489,2429,Radiant
fd589983513db98c4dbdef39627f028a,459,TRUE,2261,1802,Dire
9cbb2cc825cf90809eb280efb04efcc7,836,FALSE,2508,1672,Dire
57814d4e132a49c5c334a7513c5aa40f,1195,TRUE,1252,57,
16bd53ba9b29e2e8fefcf372044ec19f,1011,FALSE,1149,138,
794d28b5ff355068121acd911d3f3af0,1545,TRUE,2337,792,Radiant
3ac43b07eced5980d0958a415c6bb8c1,2167,FALSE,2216,49,
4d80cb0f0973024506dd7598259c2af2,1274,TRUE,2194,920,
fffd366d46e7b0b22f4d5ba1e8957f32,672,TRUE,2331,1659,Radiant
db835049fc4ad350608c5be09cccb59e,2470,FALSE,3886,1416,Radiant
c32a8e0c612f425a4faaa38cc9758959,816,FALSE,3110,2294,Radiant
071d8653824e990125ed22c1e3575455,1437,TRUE,2129,692,
c9345c087d3fd25c20aa5997ede3a0b0,1943,FALSE,2666,723,Radiant
e027c6e71017747cfa22166824e975a0,338,TRUE,2004,1666,
48983eb0a1f6f308f35e4e015e9a7bb2,1704,FALSE,2239,535,Dire
e299cf22ed97429936f730af421406db,41,FALSE,2955,2914,Radiant
15c64ff6c6fefdf2dcd12dfabbc58c08,692,FALSE,1931,1239,Dire
d90618752405c1eaccb8fe7044947206,808,TRUE,2498,1690,Radiant
e6ef3f76286c8ed8ff7d1e9f91bb7d4a,329,TRUE,1417,1088,Radiant
3d4857ec3f338aafd35a4415f1fe5687,684,FALSE,1936,1252,Dire
0482329b5802872d5da1462870748c9d,1344,FALSE,2565,1221,Radiant
67dce1fd180805960bef280e6aa9a890,127,FALSE,3428,3301,Dire
0f882ac344c761cd39f4b9b2c4d73959,372,TRUE,2623,2251,Radiant
9f9fe51066dccd3ca200b96d4cb0dc1c,769,TRUE,1617,848,
9d20349c684979586a40cf4d91612a04,984,FALSE,1973,989,
4351a6ffb09beaf377a21a82e2d2b75c,556,TRUE,1690,1134,Radiant
8d48eb67241f706cc18371c88fa1e2b7,1601,FALSE,1977,376,Dire
376ffa8b4309c4407e7f3bf5300e5939,347,TRUE,3705,3358,Radiant
c2740994e0e6ab89721a958eb0fc35a2,993,FALSE,1491,498,Radiant
6aa22327933a8d821161e1162ce0928c,238,TRUE,2137,1899,Radiant
588154d647f6b073b2af25fae689a213,2004,FALSE,2148,144,
9fb0fc1b423afca9ab0aeceeca9c9768,548,TRUE,1044,496,
6ef0e49e7e635f2f25e9fa94a4a622c8,204,FALSE,2729,2525,Radiant
5cf6cc8b93905e55e8956b1a4652a8c9,773,TRUE,1963,1190,Radiant
35a8f79773a0cc9a8a3292dab8eeaacf,164,FALSE,2997,2833,Dire
c30fc3720f9a66ebbc8d4edd73d1fdd3,1968,TRUE,2194,226,
66ea5e7ef440c57d08510cbd107edb39,1375,FALSE,2482,1107,Dire
9d7ce9819d6204edd7fd7aab576e9b27,0,FALSE,2101,2101,
5585496284e0ac859c4f315ba4e5dab8,1314,TRUE,2274,960,Radiant
32bcd2d6b236565c14519a4c8ca70861,1602,FALSE,2365,763,Radiant
b910a596a48ef661afa283610c7c5aa5,78,FALSE,1245,1167,
6d872857209e44dc9baa47dbb50785c4,1561,TRUE,1663,102,
781fa1bb0a3c5dd0d397faefe970b752,284,FALSE,1093,809,Dire
809de815b44e5ba4d5664881a9fe4504,255,TRUE,1441,1186,Radiant
c07934a43b3579b7ead622943426bcff,2382,TRUE,2883,501,
745f1955d17fed8f0e2c588b2d9e5d8c,338,TRUE,1033,695,
551d26120439dd85782b93db3afc0895,1585,FALSE,2444,859,Dire
2f4e73fea969359fa07fddef0b4b4ae4,52,FALSE,3042,2990,Dire
097f1134172b9f893f8e7c10ca853192,329,FALSE,3090,2761,Dire
895082c913f312da6d390e625008bbef,136,FALSE,1027,891,
2a232907a2faa5ffaac9488f58d55784,1371,TRUE,1535,164,
fd165c86b867900f479ff8cca6fb2628,2411,TRUE,2699,288,
e1524a859015593efc14f867565b3f39,2024,TRUE,2542,518,
0cd0c5f31ffb8c5d2f5e1930d84bd5fb,1890,TRUE,2339,449,Radiant
96b4e42a8af05eaf7136f9db222ef9cf,1405,TRUE,1475,70,
d02b649f2e5d3572c428f17276ee36a8,1572,FALSE,2695,1123,Dire
dcfefef506aa21a732d961cea16eae3d,1388,TRUE,1703,315,Radiant
316620bf979153050b153e5cf81916eb,1429,FALSE,3420,1991,Radiant
022c120c13a847068ab6c638326d3ed2,1013,TRUE,3095,2082,Radiant
06cebf73e6835297d25036fb19504a78,1880,TRUE,3482,1602,Radiant
1c0f503d2fb1437845c21e432f83cfaa,1217,FALSE,3519,2302,Radiant
626fb3723b6dba776f5dfc3ebcd16fd4,1989,FALSE,2092,103,
2772b33ebce44b3ebd32fef1903aa666,907,FALSE,2832,1925,Dire
a53671cfee68580ad617a5552067f498,1561,TRUE,1877,316,
c06f846e9ed105e361a98bd77c2b891d,1123,TRUE,1914,791,
45842f6ad4ea8b02197440cd09027a4b,783,TRUE,2155,1372,
3c86704e55fa2985d8c36b3bfe14928e,475,TRUE,1831,1356,Radiant
376ba94287e2abdfe31651fa8d57c057,3061,TRUE,4060,999,Dire
580ee34f61caa2c78891a145f6016668,2458,FALSE,2658,200,
efe9d81270f83e91c96657736b552dbf,773,TRUE,1828,1055,Radiant
12b4638ecfc44970d25c7d10ba351332,2092,FALSE,2191,99,
962183cfd9f0a05fad06b381b8218dfc,412,TRUE,1587,1175,Radiant
93086e526a1e6d7da812f769348b1111,1223,TRUE,1768,545,Radiant
9b32e19943e1d6c21d1d1149f12109bc,1242,FALSE,2786,1544,Dire
cd8e049ecc834c804a49f22591e1ce9c,2386,TRUE,2620,234,Dire
551fd137f83b36be13cbe1ae3a3171cb,378,TRUE,1205,827,Radiant
be49fa90e69d448843c1f20e88a0ebd3,734,FALSE,1720,986,Dire
91a75ce774e5a2e9d30e272014d9ffc7,276,TRUE,3072,2796,Dire
9219a074214f559cbfc1fc68230a970c,1292,FALSE,1859,567,Dire
ba7c0acf5f41a71c616a87f349ac5083,2461,TRUE,2496,35,
9d8a3c2c2ca4479de61c72d47f07e66f,1394,TRUE,1816,422,Radiant
d87e8efe488288615646eade89493e7e,2024,TRUE,2313,289,
89e3f11ff3b8d3d2f3b210cca25d7678,245,FALSE,1949,1704,Dire
9cf3f33e80121338f3569201a81db8df,123,TRUE,3078,2955,Radiant
fa9afe88c0f231dfe80f40923d6e27a8,1391,FALSE,1568,177,
022d59dc748a9231e510016c4738eb6d,1943,FALSE,2109,166,Dire
f7005393fa0ba8436ba1d524eedb19bf,1042,TRUE,1839,797,Radiant
2cfb97b97c583161b197cef1db2c8b13,2910,TRUE,3087,177,
1e7540417e4e981a28883f29472ebcc6,800,TRUE,1607,807,Radiant
586ced56f6412435f6146db1d233c9ea,1790,FALSE,2150,360,
4c343d381ce2b7c930caaa5f5b4650ca,909,TRUE,3154,2245,Radiant
d43fc341a84fd0069c1614a227f4e20a,180,TRUE,4289,4109,Radiant
3fd7d6fd0330c2fabf9afa7c708778e0,29,FALSE,1972,1943,Radiant
835065f10a8acd3cdeb2e69fb5f6e4df,401,TRUE,2060,1659,
611ef3111da48fed5b0310e1f0434072,1629,FALSE,2870,1241,Radiant
51576ae56a08c2637165dab536682539,2165,FALSE,2450,285,
7e79aed93575987e85f98693b73f7181,1063,TRUE,3091,2028,Radiant
c316d6046b7231539a3981a5cae0b933,479,FALSE,2454,1975,Dire
07f85dd5eeedfe3501d6013da92fbc94,512,FALSE,1499,987,
b2bc6fa471d702457aa4e55ee19c2318,102,TRUE,2829,2727,Radiant
c8bcf35ad9a804a82b1ede80cb32fe81,1399,TRUE,2539,1140,Radiant
3704e23d73f7ea3a0a70f76d5e1b5025,600,FALSE,3003,2403,Dire
597b8f5fbd37e5099acfc5fa3e088d8c,1999,FALSE,3374,1375,Dire
048da20975e7c5129bdf1044286f575b,406,TRUE,1426,1020,Radiant
dd1facbd692c8a92907ba96fd4d72bc6,1563,FALSE,2074,511,Dire
16c9c60679a193e51d7980466dc52b10,1163,FALSE,3522,2359,Dire
d201f4867207d7d349811faf4dd2e3a5,339,FALSE,3620,3281,Dire
368b74f0b826e66c60fb83c0e0e22f21,1212,FALSE,2572,1360,Dire
6e26392a8695fd8748086d0f74db8455,1870,TRUE,3156,1286,Radiant
d3d700f14c753b31c214a20cf8e9840b,969,FALSE,1978,1009,
b50de9eb52ed3853436e8aad98be287e,1849,TRUE,2683,834,Radiant
d2822b7a33c5ee5f5e99024fa3a40175,1273,TRUE,2468,1195,
5fa65df1a92a8562e58c7c13b58e6197,1713,TRUE,2982,1269,Dire
1aedbf47e01d23d63f45c160bf48d6fe,1108,FALSE,2851,1743,Radiant
a935bf61088ef67809bc93b829d79d85,2150,TRUE,2537,387,Radiant
c97f8e8027dd2e966e3099d572d5a7a2,2427,TRUE,3364,937,Dire
f6d601f029411713292448b9b37be078,1129,TRUE,2102,973,
5bb64bb2d9ab2e44a1bc0e1d9ec676b6,690,FALSE,1247,557,
244cec9c6885b7b7e21cbd6cc1a9964c,830,FALSE,1576,746,Dire
6d4aad656699d17297f2a76a973aa073,2744,FALSE,2924,180,
4f329b4f366d4e5a0f6cdd5a3cebd5aa,1714,TRUE,2846,1132,Radiant
99af71c27508885edbb7bde66bd9928f,2000,FALSE,2864,864,Dire
fc8f2e46e5a33e1ca401bdce1884d0cc,1473,FALSE,1907,434,
d90389220b24d0e004e1a4e2d563792a,1142,FALSE,1981,839,Dire
430d17c17837dd7df702335d001bec7f,1985,FALSE,3214,1229,Dire
5536cddcbac95a77478839b46e3323fa,771,TRUE,3302,2531,Radiant
a8ae3a611dc308ca83e09c6ce7914654,829,FALSE,1832,1003,Dire
06eb2bad7b9ff5adffe2be891286cd19,118,TRUE,2812,2694,Radiant
a2de12a2c0f27160f8b1175092d7a939,2297,TRUE,2535,238,
54ba0fab124859633c14c3f52cc13404,1206,TRUE,2499,1293,Dire
6b1e343c2af04eeddb701532bdf58ccb,854,FALSE,1783,929,
493638c39701d424d3bdc30201bc40ab,896,TRUE,2554,1658,Dire
16255ae2b822325ce3ae560ff1dca3f0,1300,TRUE,1379,79,Radiant
4fd22abe11b2b507a9e9c2a9bc2fcbbb,1093,TRUE,1742,649,Radiant
8a92beffef68e83289d26b523613f074,1615,TRUE,2195,580,Radiant
23a92c42bc2ebe5e66548cefca86f1ae,1104,TRUE,3297,2193,Dire
b00f14301cac82bc692b8b1f401e1c58,536,TRUE,1115,579,Radiant
41a72f8442b2c6bbf2f0752c0e9626f3,802,FALSE,2002,1200,Dire
f24be53c7cee64eb5b5c41d13a306e61,1306,TRUE,1441,135,
e2e3de8f6139b5766d70d8f8c6c93106,146,FALSE,2301,2155,Dire
302e1d218d16df0fe6a2b539e6ec47be,1130,TRUE,1643,513,
3a12aa33f13155da9fa1af63418d76a1,1297,FALSE,1586,289,
5e5d04a7c0b60f3fbc472a9a5664ce7a,448,TRUE,922,474,
33a5737db8e378aec87a8ddfee3718b2,2792,TRUE,3419,627,Radiant
5fdb5e5b55a714fe83676f719744c2d4,1650,FALSE,2508,858,Dire
0db17f0a36f631b99b707a0055d3ca23,160,TRUE,2252,2092,Radiant
93cf6dfd95bfacdce0f04280a0638980,1973,FALSE,2424,451,Dire
b8ef387d43f6461d2f4bc07b50b8cc16,1965,FALSE,2609,644,Dire
c31144a7087265fcfb0c5a76edef4db3,1099,TRUE,2065,966,Radiant
4368b8aee582f5c933ff6da4747fb187,1511,FALSE,1952,441,
75474b8bd5ee4f1097c9a77c5413e141,922,FALSE,2276,1354,Radiant
06c88e3c3832ac4d46e84a4b94f64277,770,FALSE,2619,1849,Dire
de677cf12f816790e0800046e2322768,873,TRUE,2517,1644,Dire
fe027e8b272c2283c58d7b7ada5e1663,854,FALSE,1669,815,Dire
5f24fe112b4ab6bd1bbe909890359ede,987,TRUE,1882,895,
6eb42df357042b596fbea1111f51a2c7,1220,TRUE,1687,467,
2d1dff11f494853b650e52ad6f86f091,1467,TRUE,1761,294,
c905bcb119fb9ba73978a07c2db28ad7,1588,TRUE,1651,63,
ad97ad99875886d91a82898b6723e9d2,577,TRUE,2326,1749,Radiant
bf76422fcc06654e9a9d861ce8a0ffa5,84,TRUE,1903,1819,
da95c98161701a7c8e3c6158c3525048,518,FALSE,1364,846,
f918323c5bda41619fbc7ba36ab31af4,1218,FALSE,2443,1225,Radiant
efd3076cfa096cce71328b21165cfe78,808,FALSE,2198,1390,Dire
696b4e21edc3a5d9b15985e811c2c44d,323,TRUE,1213,890,
baf13dc518ca4015b8e7568a59882f5a,930,TRUE,1344,414,Radiant
ca12510f76ccc3928d89d50b170570e2,332,FALSE,953,621,
e99beb76ab18d0c67cd948677beaf991,675,FALSE,2090,1415,Dire
6ee0ec2e69fe9c8f773d19d0227e9b93,1160,FALSE,2796,1636,Dire
2d13159777f9aafabe896aae7c6d846d,202,FALSE,2830,2628,Dire
99dfb64228a5f4cca303399de37a6783,1427,TRUE,2571,1144,Dire
1cfd86855205aa2a9aec2d65df42733e,1421,FALSE,1792,371,Dire
66f6e13d07f5aea869f11fc2cb3b3f65,1364,TRUE,2704,1340,Radiant
3a3d36634bb07023475a5e2f4fc47c10,1087,TRUE,2210,1123,Radiant
c8791476c72bffac5d92a1877eedf8d1,423,FALSE,3224,2801,Radiant
d9102cdff8df43bcaa53e3c42c9c7ac2,543,FALSE,3053,2510,Radiant
e9f530cff8333916b24d45550b696320,242,TRUE,2101,1859,
640fcf1907f24bcc4b91bf2a1dff50f5,1614,FALSE,1972,358,
b368c451bb2f0ef5c820311669e0d51e,928,FALSE,2182,1254,Dire
430bdccaa3d58ef88569724a6782550f,2571,FALSE,3107,536,Dire
6f0215b8bfa4cc6ecd2a646f6679a5f3,806,FALSE,2098,1292,Radiant
86d89e9cb4ca28070fa566fc47c8077f,95,TRUE,1613,1518,
f18a7cde024e3ab3de73a771553e2f06,1322,FALSE,2323,1001,Dire
316acfaa43c2974a4e48278c86cf649b,1004,FALSE,1486,482,
90d51bca7a493abd8b4d0469266d4d2a,64,FALSE,2732,2668,Dire
63134f89491509898a2803267a87ec6e,170,TRUE,2818,2648,Radiant
be0920d07cf1402f54c9dbf8bdad2796,867,TRUE,1478,611,Radiant
e71d19d32cbbe8d14e58b51e10eb6ddb,1271,TRUE,2459,1188,Dire
ba2311f5a202b65b56eacdae4032c1e2,1047,TRUE,3348,2301,Radiant
49adf7d2b0a5b6cea243bfe576eed71a,78,TRUE,1897,1819,Radiant
5b77e6eecf5f3d1a17b36c9198a0c5cf,706,TRUE,1900,1194,
2c53dde012e95ea48bba28efc1745f28,1952,FALSE,2471,519,Dire
5264d433ae956e7dcb6e00799bb913a9,1137,FALSE,1667,530,Dire
f955bb09843326c21b187a36f49f1d02,2639,FALSE,2932,293,
2611e5643937b47282344a7a1e648d17,2014,FALSE,2399,385,
d7a6754003d08ca4505014c01411b44d,61,FALSE,2670,2609,Radiant
045c8a1c618bce3f064b54e8a30772d3,783,TRUE,1321,538,
1234a20588cca2ed18b504036f4b41a7,244,FALSE,1580,1336,
aadf29429e78d7cbc1dc61e3931cf570,599,FALSE,2579,1980,Dire
77d76e65ac9f9318ed1c543fc4f23cf0,1994,FALSE,3001,1007,Dire
b222aee200a24890bf6b53dbaaaa4f89,1078,FALSE,2208,1130,Dire
2dd857102406f64a1313f9f52f0dc5b8,440,FALSE,2528,2088,Dire
4c04eef55081708ad3be56232c836ba0,2517,FALSE,2734,217,Dire
aad09e2217486f24209722cf8484b8d5,919,TRUE,1975,1056,Radiant
ef64b80c008d9f4929ef1388dca2ed7e,1190,TRUE,1498,308,
126904e3092be1d195265e74532b1485,1064,FALSE,2392,1328,Dire
c03ae9d6e988a0fc9d249d2060dac7e8,1065,FALSE,1208,143,
7ea14e1e66ab18c92ddae89cea7190ce,244,FALSE,3003,2759,Dire
b3138dfe54e1b95f0afb79b41d45b93e,2875,TRUE,3187,312,Dire
e1a691edac235d4f72ef345d5dad1643,687,TRUE,2242,1555,
4b847121930319bbbae529e5fab2d575,966,FALSE,1870,904,Dire
896938cfbe027b23d02be0448ced52fb,944,TRUE,3059,2115,Dire
71fdaebdcb29d1cc44742aa153f7ddcb,89,TRUE,1985,1896,Radiant
4b6cf6faacdd91d51b42639a4cbb9643,168,TRUE,2505,2337,Radiant
2a1416f2c0c17696aff578141ec3c47b,948,TRUE,1143,195,
de86b3824043210ebe400f12193f727b,1898,FALSE,2394,496,
0940a230a680795e83184b4dbaabf208,1902,TRUE,2556,654,Radiant
2cbd13fa239404acead9cedd582c65e2,1559,FALSE,1747,188,
a3ff6f6a83ddfb61b2da0fd8c554727f,1739,FALSE,2817,1078,Dire
47b3e29dd0bc9028cf3137b6b26da66a,2037,FALSE,3705,1668,Radiant
69609829aa6978464a4c7bf91e4ead50,1407,FALSE,2192,785,Dire
33f4b7132e89ce47f00bec31a52b9e86,1075,FALSE,1547,472,Dire
155d1fb2a0673ffd18aa2bb528a0f5bf,1630,TRUE,2190,560,Dire
1c69372bf7ccca9a270062d4d77381d9,2592,FALSE,2757,165,
47e501e32fa2feaa790eedef170c7182,1482,TRUE,2767,1285,Radiant
0b1974202515ff4e69fc7d63655bd462,855,TRUE,1083,228,
9e03c695aa0a688fb7f395b83f343d33,1020,FALSE,2957,1937,Dire
230b39174036f647c0813e134fb39d04,449,TRUE,1267,818,
1601ba326a19888b7a24bfc53d233b05,2003,TRUE,3398,1395,Dire
d65691b4bcbf14506736042d3baa49a1,814,TRUE,1294,480,
b78ed77efe88e0a843827c195d1450a6,242,TRUE,1584,1342,Radiant
1bc1482afeb540ce64593526e61c6c78,873,TRUE,2328,1455,Radiant
b5b5165034c935a511d724d8416aac13,1997,TRUE,2119,122,
ab92b9231b2730960d67636f153b6875,89,TRUE,2943,2854,Radiant
8c8359d702a1dffca7992f0f90153333,1473,TRUE,2727,1254,Radiant
f3d8c549035ea65e4fdf229fcf8099b6,1076,TRUE,1960,884,
d56985b992df0b67ebac00dc5b3a67a7,475,TRUE,2778,2303,Radiant
ee4b50bf5860040f3cbaf151b020a076,330,TRUE,3391,3061,Dire
a29a0031ae6bb2808a4390ba6386a0d4,905,TRUE,1858,953,
31c96e7b54ba31b906097d717d07358d,876,FALSE,1924,1048,Radiant
9d125ac64b138ee5547a909a2425150b,2947,TRUE,3383,436,
2eac3b0b3e441f37bf7c8de40ecc384d,554,TRUE,1804,1250,Radiant
3e52404dfe7c55ff54cb9c4618766cd8,2513,FALSE,3686,1173,Dire
abe80db929c7e7537e8cdb2dd017f99c,262,FALSE,2205,1943,Dire
ec26840d97f91a7b7cbb9219e7a99455,319,FALSE,2565,2246,
feae753730d4630bd681c7e1cca35c97,581,FALSE,1229,648,Dire
89aee9fefeae8e3d9aa3731d0a16151c,2452,FALSE,2494,42,
d7af79d287e71cf0f5da2c1639c35e80,877,TRUE,2487,1610,Radiant
54d073e88f684e632b7d1b76432d09b9,1443,FALSE,2126,683,Dire
dee87065a0b2154cd347b6d3a45dfe7a,1899,FALSE,2643,744,Dire
88f560592b5d0cb1b4d98a5f2757859c,219,TRUE,3080,2861,Radiant
e4b5d8457440dded63a89f9888667007,1919,TRUE,2056,137,
9550344b1f26f380d40d3d13a820371c,1413,FALSE,3218,1805,Dire
3425148a866dae6c00553aff1837ac05,95,FALSE,1375,1280,
b7e176d7a1ec383c8c9cf03a477509c9,1180,TRUE,2757,1577,Radiant
bbc4724651343ee4f44574fcad689201,756,TRUE,1525,769,
ebd992f91be70b8775be61956fe32d25,1635,FALSE,2128,493,
b46404d002966cc282617c7355564aa8,1215,TRUE,2500,1285,Radiant
4dca00e5c8d33db196af8fd6cd3e0d7c,1399,FALSE,2501,1102,Dire
a34ef5ab9b37c58716491fe9aa1672ea,1812,TRUE,1958,146,
b106e9a090ecba191e71bc79f2875288,1418,FALSE,2186,768,
33fb3c6cee5a1cbc3da29d73873d02fc,1769,TRUE,2186,417,
1b00b399c314290487e3767b1ea5562d,1790,TRUE,3042,1252,Dire
fbbdc5495e6d156f791bd502105e6dc1,1298,FALSE,1824,526,Dire
2d3d4ec98ac9fe73e68677656ec318a8,94,FALSE,2038,1944,Dire
0c7d723abb19b703bd6f5b4300eb17d4,1917,TRUE,2206,289,
cfceebc982d7ed4588ebf7b5c843fd51,3060,FALSE,3314,254,
0b1ece7df8e59374612d2d1caf622231,483,TRUE,1503,1020,Dire
ffac4cf2717614ee0842f4f3d502cc0b,635,FALSE,3624,2989,Radiant
e6bf9a845e8f2717bdd5dfbcb7e051ac,2387,TRUE,2658,271,
2fc1b2d28842df1d100dc00976687b75,3345,FALSE,3398,53,
aa987b3aff6c4888c9c2cbd8d721246d,2183,FALSE,2909,726,Dire
ad0b0dc44c90c248ee5935e02e59f37c,336,TRUE,2747,2411,Dire
bb5c33c6f584061d972cf0aebcaf1375,1924,FALSE,2061,137,
a4eadcde9844da5e2ad6da4dd89ce196,630,TRUE,1857,1227,Dire
f9beeaef8305e116afc8eb7e19219fbe,638,TRUE,2088,1450,Radiant
8167e2c35e6e2eb4ca7c6678345c4426,715,FALSE,2783,2068,Dire
5d268385a6b8bb5554506d51784ed0e0,1905,TRUE,2224,319,
552421ee8e5c45057d0fc5ba66ff45a0,1869,TRUE,3867,1998,Radiant
65cc440f1773543b4847b6b7cfdc1302,519,TRUE,2736,2217,Dire
c3ad756e481b714fa11f9da4dbf1468f,1547,FALSE,2062,515,Dire
4c130721c903c6c1c661055028eacc2f,119,FALSE,2736,2617,Dire
34ecc529bd9cb7b18a25f452380f13b1,1556,FALSE,2194,638,
deebed2a56cf6f15f564a9e0457b5e3b,1644,FALSE,2790,1146,Dire
9222460bec2e2c1c459d2c18a138bae7,1310,FALSE,1455,145,
4f7e81a7fc7be02a510789c6ffd1c8ce,1182,FALSE,1879,697,Dire
2df001ac9e661c81a412402e1c5bec1d,1059,TRUE,1326,267,Dire
b9d885139250cd2c6e17f56ab8990dce,1345,FALSE,2189,844,Dire
f68761d15fb674b3d4ad1b8ef3ef6cfa,1181,TRUE,1934,753,Radiant
9f53b3c3a1e5920e8f0abd3e6c1b5c42,1251,TRUE,3034,1783,Radiant
ae22e60b084cb83a0179d00e9f85f2da,4095,FALSE,4176,81,
0ad2b9dd043e72d9504c2eff83cb277f,1106,TRUE,2306,1200,Radiant
d8da5f9b9ef045b3b431d826a92ed94e,2492,FALSE,2598,106,
397662d59875170f5e2e0a26ce821887,174,FALSE,3002,2828,Radiant
fe3e93c9d8dc36990c0b72546d902d89,1611,FALSE,2199,588,Dire
035b68a0100be7475ab020c09a3bcb34,16,TRUE,2810,2794,Dire
41e66a6bb4c54c764fa1c7dc82e13115,1077,TRUE,1577,500,
e74b948165f892e439f6fabddf58558c,28,TRUE,1857,1829,
90c0445a30f2cb478861e563bd22c8bb,2312,FALSE,2394,82,
68a162f6231e17b6e50aecbb49261a3a,2621,FALSE,3181,560,Dire
c51b09a2405ad35ab9deb6b30b01a4c1,1536,FALSE,2513,977,Dire
0680f13ff9df5ac2cfbe412e8b23a328,283,TRUE,2213,1930,Radiant
deded7339bdafdae1e2f1aaf76c6b6a1,1373,TRUE,2403,1030,Radiant
3e02eefd66e637d312d3266e0b92b450,2820,TRUE,3154,334,
2aea8b374e1106904816e8255ada7b4f,1967,FALSE,4262,2295,Dire
9fbed9a62c3d59b37e4de49789224163,970,FALSE,2238,1268,Dire
4b4a20d11f2eacd2f43da9a5bfa553b8,131,TRUE,1415,1284,
45f932c0db1775f89d021a5f3416da88,1158,TRUE,1906,748,Radiant
6239b4879f903437618e5c2644f2475c,1040,FALSE,1995,955,
02ef32d372c1ff8a20d9af0a53ded673,1750,TRUE,2514,764,Dire
595b20e4cf3ecb097372e2ea3dec70ef,1647,TRUE,2361,714,
6e92a797eb26ff1c6d45c0510193e739,868,TRUE,1855,987,Radiant
423c45b51a82fafc6f08831d91e7c272,729,FALSE,1789,1060,
7742fde5176bc0ce1d08595905b8020b,858,TRUE,1041,183,
d33b2a4ffedb388b11a797f0c50f546b,351,FALSE,2088,1737,Dire
19139dada17fea5a42215978a41212ee,1091,TRUE,1336,245,
271acd2c16e3ad5d00e5edbf37572b9e,2034,TRUE,2587,553,Radiant
4bbb36746c72bccea4d92ca2cd27d545,2451,FALSE,3798,1347,Radiant
39c13e030ab320fa1453c955e366449b,1534,FALSE,3615,2081,Dire
a04890e38c0e01c13309f0ebe14719b3,40,TRUE,1636,1596,Radiant
31527333867379487065a53f7d5dfdda,93,TRUE,1908,1815,Radiant
d53b466cdcc14671c41ecf0fbb0a8775,2397,TRUE,3072,675,Dire
7301a971c00cf96c4da71e256bebc207,134,FALSE,2211,2077,Dire
adb757f32d67c70b0f3b5d02abf3bbbe,725,TRUE,3818,3093,Dire
34566340f18efbfe066809987e062fd8,462,TRUE,1779,1317,
f82eedfcdf499cb04de67b9e305de9ca,419,TRUE,1651,1232,
074faf40cac3b1805a6443cb8edafeb3,218,FALSE,1484,1266,
4bdc7a59d0a2ad1b201c93ba83a300b9,1714,FALSE,2018,304,Dire
fd2268600ca021aa3da46165c07c7b46,296,TRUE,1520,1224,Radiant
b5004db26399fb65953ad4b1ea4ce212,481,TRUE,1861,1380,
a1d59aaff7ae920c500af561ec348c2e,142,TRUE,2384,2242,Radiant
c555fc5bd46be945951a80fbddd01782,2083,FALSE,2607,524,
dcbbeaab1ce8064a2e36dead58466ca9,979,TRUE,2629,1650,Radiant
c547c6c434d76e9ac7ad2d360bad0bcf,190,FALSE,2041,1851,Dire
b9d37eeee2c8ae2397b98ea754273d79,764,TRUE,1343,579,
9188f9dd1642fe46396cdd9ab56199d7,2205,TRUE,2622,417,Radiant
eeb318ae717e50f98477dd9a81d2c2f4,1831,TRUE,2845,1014,Radiant
d5cbe9d66088e5d7027d9b53a48efe3e,1660,TRUE,4075,2415,Radiant
13cdd3c7aa0dc240c44a41bf76a90798,1507,FALSE,2935,1428,Dire
2173c61ca9f59cbe6490b5597be4ddd1,887,TRUE,2081,1194,Dire
598dacac8162d9bdf86628362dc10aa8,748,FALSE,2064,1316,Dire
924d8c54e12d8c2ebf933bb200744825,358,TRUE,2507,2149,Radiant
4f73aae77d8c8fe6eddcd87fac5f014d,1465,FALSE,1587,122,Dire
1b6bae44f1d4a94e4993bdc309e99408,632,TRUE,2476,1844,Radiant
19262977cc8f637aa1ad8f001a05bc4a,864,TRUE,2053,1189,Radiant
efaf83197911010ae167efffa036728a,812,TRUE,1134,322,Radiant
49f1902ce8144badf359b8256f5fa99f,1323,FALSE,2683,1360,Dire
41585d0ab906bf9f6d07d8b7b8b43f9b,93,FALSE,1855,1762,Dire
42c58b97f8cde4baf8a9672d4675fed5,1175,FALSE,1578,403,
4695d9e6b51346e8d7d48fa01d921343,1034,FALSE,1542,508,Dire
95759a8191cfc738f949ef243f65d8ae,1119,TRUE,1943,824,
acba06f456db40102823de23e0c93d3f,927,TRUE,2789,1862,Radiant
01aee3764e2143342e4067ec45dda329,1017,TRUE,2421,1404,Radiant
5947c5bca8327a0f6b562b59a33d795c,924,FALSE,1458,534,Dire
57eda44cc987206136f1814bbc91e6ea,1080,TRUE,2642,1562,Dire
9134c9fa8f2c938d55814b19150a9805,2362,FALSE,2898,536,Dire
b063f8a23078f6f1f9453b9cc53f9908,151,TRUE,1927,1776,Radiant
ab054782360409b265f7a01b54c6bae0,185,TRUE,2225,2040,
3dceaee5de101df0bbc975cba51d57da,675,TRUE,1327,652,Radiant
986998d958e25d5c4a20cdc5d8c767bf,59,TRUE,2178,2119,Radiant
d8373e28237a04f383a21f63c4b05fb2,651,TRUE,2322,1671,Radiant
5308d30e3e1a48c1b00a38a4d96113b1,292,FALSE,2881,2589,Radiant
76a8f96f623028fa5704710778f80fe1,1325,FALSE,2000,675,Dire
24f91f3de362f0d755c5c99f2102bc94,2395,FALSE,3075,680,Dire
17b24173050ba2f6c957c5456d11af09,686,TRUE,3500,2814,Dire
947e2418040ebc2f34e5dc61c8c12cad,2363,TRUE,2957,594,
d46e038632864314fca0bdface372d29,2203,TRUE,2644,441,Radiant
d5e2d4d60113d58d06b15696489dc724,1434,TRUE,2276,842,Radiant
e9f90763c8b22a5ecf4272cc82cf70dc,1036,FALSE,1357,321,Dire
a0b1c010685e7c13efe977e4e630ebee,2237,FALSE,2968,731,Radiant
bc2fe5c2b752150455885be2c8d08aed,500,TRUE,1606,1106,Radiant
7e45755443aa039c9b59b9efd33a88d0,1729,TRUE,1913,184,Radiant
f93fe41a117f062d4200bc8b52898c47,404,TRUE,981,577,
c7918a98e1723c1920371ecf39c4045e,1635,FALSE,2210,575,
bbe414ac9a3830fec8d1a010ab929308,1309,TRUE,2342,1033,Radiant
05ceffa3e4c898157d9c17e70c785e12,290,TRUE,2527,2237,Dire
44b2575b3e490ea0f00cb785171c5e0f,1510,FALSE,1927,417,
3af2b34fac4d235b80826d3b8472ea60,1170,TRUE,2020,850,Radiant
cfb46bfa8c811d22d9cc4bfbf63f7b06,1691,FALSE,1992,301,
1029a6d11bc245184efb74126246c3ef,2156,TRUE,2258,102,
a015e498e601c0bac59deb344d915066,2022,TRUE,2425,403,
59b3cce44d534f4f9998a0203b8c4de5,82,FALSE,2991,2909,Dire
ee32cfb90f2696442321ee4c6d9c16cf,1400,TRUE,2080,680,Radiant
1dd427d2ab71ade94e3e6a336260636e,1750,FALSE,2891,1141,Dire
6e427f4f63b1bab7112d85ddf0784261,1022,TRUE,1911,889,Radiant
4f1ab4dad17de8db7ee0265511fc4e11,43,TRUE,2232,2189,
42c8704911a9941c8eb8f735ccda1793,2525,TRUE,3154,629,Dire
b38db05f4fd84ef672800a6fcfe18f2d,288,TRUE,1553,1265,
e753e053fce5f6f43a1dfd6bb06599c3,214,FALSE,1821,1607,
9939a85274ecaaeb253d0b3427da467c,1011,FALSE,3367,2356,Dire
6fe74f927453ea84a9ce4a561395018d,1717,FALSE,2166,449,
944e2bb176bca5a1d7340ea30b999b67,577,TRUE,2586,2009,Dire
4d3276ad3736c56bc92008a8cd4a60fa,734,FALSE,2303,1569,Dire
8b99c6d977275506518a45658db47180,2472,TRUE,2561,89,
cddf7279b2c58c0d554ef2220dfe8114,760,FALSE,2223,1463,Dire
9776dbc804ed934e3e58ea2e0037e42c,2416,TRUE,2466,50,
a4a17dece850e20cd0d88d02b7522aae,2034,TRUE,2229,195,Radiant
4c2144f638155545de77c9d663b43f2f,922,TRUE,2322,1400,
831725c7db6edb0cea94a454bcba7393,51,TRUE,2117,2066,Radiant
6c0346b0a6dc23df72ea0654b82cd500,2670,FALSE,2861,191,
bb5358657b60f357b6e72c934feb4b54,609,TRUE,1942,1333,Radiant
1d35f737783febcb6d1595b4105b17ad,735,TRUE,1467,732,Radiant
37104517daa194ed2300547e4d4e4871,891,FALSE,1996,1105,Radiant
c23bcb9b8bc22a864fd5be834c58d940,114,FALSE,2604,2490,Radiant
3ca91daaec4c58a893ee53b7881b414f,1125,TRUE,2912,1787,Dire
1c68283e10a006aa8756a4e3b15a9f6b,1406,TRUE,1988,582,
d31ac8b2ff677ce624c180b1cced3c2c,65,FALSE,2036,1971,Dire
42a1f135b92f7588d5c2aa2a9407e09f,1289,TRUE,1414,125,
96d77f65cd17cbd3e23a704179f871da,749,TRUE,2641,1892,Radiant
050a0efb929919e719d51be75e62c2bc,266,TRUE,2324,2058,
c4428a35a514732b04e07f94d9a7f747,1943,TRUE,2341,398,
fc43ba9ba1ac3defb0b7ec1e2e5cdd35,469,FALSE,1261,792,
821dff71367ae64413efaf2f5ff23f44,333,FALSE,1873,1540,Dire
50af406c4d0c9b2d88465ceb68f3db7f,327,TRUE,2460,2133,Radiant
cc52d7c1911a63991162d68cebc640bc,3371,FALSE,3679,308,
f8d0ee7919d3cde9adaa72bdf9c671af,171,TRUE,2475,2304,
07a590a164a00a178ca12348e6431345,1406,TRUE,1826,420,
709a2224ebce8302c10cf6f3778af3dc,1472,FALSE,2042,570,
0d2e71955738cd6f4b0a10b06cc91d72,1960,TRUE,3504,1544,Dire
62a23715c9216cfb14242278b111822e,1106,TRUE,2652,1546,Radiant
7c1aa07e7653d661e40164c504338cc1,1953,FALSE,2907,954,
6ecbb835643a297701313a0603d9fd74,912,TRUE,2792,1880,Radiant
575fbf3698edc0a9f7346af8ee8c498a,819,FALSE,1673,854,Dire
148176a4a946be87a3e3d7d96e9ef8f2,2250,TRUE,2461,211,Radiant
727eec99f4936f1eabdc4443d1779631,339,TRUE,1355,1016,
89da95ff5f55c57da8eaaf1f58c26eeb,352,TRUE,1979,1627,
384760650ea4a92f88bdc6fbd03782f4,2157,FALSE,2373,216,
823bdbf417afe8c4e87e1ca71d724872,2767,FALSE,3242,475,
da56c3d853e33c715da8f96b20c8e787,2496,FALSE,2702,206,
b1ff6a7354cc6dd054805f100f1a765f,616,FALSE,955,339,Dire
4aa3ad181957c2bd9cd5e0094c0fdfdd,1300,FALSE,1866,566,Dire
e3974f38aa11a3efb6ca49f062e94a19,1373,FALSE,2202,829,Dire
82f758a1a6dcaf9005884fee74d103cb,2319,FALSE,2925,606,Radiant
c6882250f1c35eff8acb7aca16e24447,331,FALSE,3654,3323,Dire
45fd707cc134567e4f219ee51eadb88b,2254,FALSE,2553,299,
270886fe9fb585d968324250ee9dab21,1601,FALSE,2806,1205,Dire
456281b5d2c59c6b292df30acf109ce8,69,FALSE,2782,2713,Radiant
c9ee78d902476c7f474164c98723a6d9,2952,TRUE,3809,857,Dire
61ad263b6d7624339376aa042eda34fc,472,FALSE,1411,939,
f4ea322331bc363c039d8be14355c6e9,667,TRUE,2031,1364,
8c896b8002874f3b42bf646d0d43deec,190,FALSE,3309,3119,Radiant
d96b1e1646df2201a0081bed5e0f44c9,671,FALSE,980,309,
bc04c589052bebb3e419b58d94619672,18,TRUE,3059,3041,Dire
b15fa8d62eb1db2396edb416d6046844,412,FALSE,1678,1266,Dire
8897cbcd31fc3f8056578fbacecb5aec,364,FALSE,1108,744,
995bd5821d07b1e2f5b88e929fd9c492,770,FALSE,2015,1245,
a820623ff13169c7abd6955f39497d6b,1928,TRUE,2255,327,
b2ec90ad6ba6f235b70fb2fffb050b23,709,FALSE,2801,2092,Dire
76387d69a53ab6c2e9fdc48ff21e4ee8,1016,TRUE,1690,674,Radiant
e225b2be198118109809be5e1dae1072,1116,FALSE,1881,765,Dire
4f3459344578cb7c3696d3c965f41a41,2614,FALSE,2717,103,
d48af13ca3e281bb3f50b233ed30e609,2320,TRUE,2376,56,
98b49ba837df6e54c463fbdb94d23b5d,172,TRUE,2631,2459,Radiant
21c9a22be5d00f73a6dbecf2ac26b9df,852,FALSE,2363,1511,Radiant
eb69214b75ed094e6d4e0eb45332ca1f,1377,TRUE,2097,720,Dire
08697de1424aa55bc39a7a4e3fde60bc,1693,TRUE,2623,930,Radiant
ee118936b9232b54b633d245d7080a6d,612,TRUE,1378,766,Radiant
e3543497c26ad8637e1155fd63991501,289,TRUE,1703,1414,Radiant
663c1a65307b0889cc764551f0daa5c2,1421,TRUE,3287,1866,Radiant
fc1b82998697ee3bdbbb91ee12ad2a0f,1401,FALSE,1672,271,
86dec10ba79bbd0a3c3fee4d6b865b53,10,FALSE,2224,2214,Dire
2e5cce08d6ad4a780f7a5a499ceb69e1,267,FALSE,2744,2477,Radiant
1ebdd81fb595b4ee57c552615373ca11,1784,FALSE,2119,335,Dire
a764d831fed59f1f40c1d724c8dca864,752,FALSE,1992,1240,Dire
59e82980d618d9cbef6015217d2392d6,189,FALSE,2212,2023,
36d747129915b58058ee3452cd6a5783,1044,TRUE,2254,1210,
5872bff0929ea5615f5f6bbb8284d9b1,322,FALSE,2091,1769,
a4469216e465109a29f38467ae8983b5,1545,TRUE,2179,634,Radiant
25d2d7ff567d42acfd79db618c89b087,555,TRUE,2129,1574,Radiant
6b2dad2510bc08acc8437d1b76da01a1,1250,TRUE,2487,1237,
d8d002c97e1eeb02c38355e4d86a2bdc,1937,FALSE,2850,913,Radiant
b5e47fc860b6d1064546f505dda66807,662,TRUE,2459,1797,Radiant
6eb68672a1cfc9b213e0093038338531,781,FALSE,2263,1482,Radiant
e3fae9b505f1cb7651530b90664fb418,1061,FALSE,1943,882,Dire
9a642f1538da61ffece73fc83d8943a3,1714,FALSE,3546,1832,Dire
55af824e6a574c0e2d34526a8bb8db17,813,TRUE,2562,1749,Radiant
1ea2b6549e54059aac90be3506570721,39,FALSE,2191,2152,
a3fc2f7d689fdbe9b634de508de95d56,1167,FALSE,2114,947,Dire
bf21993a60794129e4e62ccd4fded027,838,TRUE,1134,296,
0fb10898239783f3396c5f187f1b9129,1573,FALSE,2344,771,
2bdfed49f601de59064aa98e185e218e,1,TRUE,1669,1668,
aeca89790c1610cc86a74d9d426a7832,1340,FALSE,1947,607,Dire
67f8f3eec4c2de0ceb7bf71c80f5df95,1212,TRUE,2866,1654,Radiant
73a70efb5536d16de18a3e477ac09825,2108,FALSE,2908,800,Dire
e6edf17c33ed26d03731a42667330f8f,473,FALSE,2848,2375,Radiant
c825785a46a375b43cc5296206144b00,649,FALSE,1083,434,
6ef4a3440696d9614073653bf932d5e6,469,TRUE,1958,1489,Radiant
37abf6c3b431bf44554f48cd20d7ff04,1009,TRUE,2151,1142,Radiant
236073d6972f0a599e0f1596fcd33a7f,2237,FALSE,3411,1174,Dire
17b2873c17192317f072f9bb69e4a3c2,779,FALSE,2585,1806,Radiant
33ae938e519414c41a4e62f4f3819ea1,805,TRUE,1827,1022,
2828fe5f117c3883b99a36a757676855,797,TRUE,2004,1207,Radiant
255af8f371e97d79cbaeb08c2b9365ce,941,FALSE,1207,266,
ce0e0129ea59c36d5b632c4c27b0fd08,1546,FALSE,2872,1326,Dire
d38c26138e48bdff9b3f258850470ec0,2423,TRUE,3713,1290,Dire
273fc9ba938535073c5cb25c4637046f,126,TRUE,2803,2677,Radiant
c1867fd2a1d5571c72d90142c750b1ac,68,TRUE,2326,2258,Radiant
556a5dfd6a3b256816b2529ceeebb5b8,547,TRUE,1231,684,Radiant
ae6dc4a7e3e64e5b2e3c008cc23a2fb4,1214,FALSE,2146,932,Dire
b401888c8ec66df1bed381553910fca9,1235,TRUE,2315,1080,Radiant
eef8d8bd8b3f8299ec159da8caedde9b,1075,FALSE,1135,60,
fcbfd8df790693cc49b9b6b5055c496a,394,FALSE,1252,858,Radiant
0ecf3f9f1ba714ddc8a1c6c8a0b1ea9a,2066,FALSE,2121,55,
f5976d1dd7cfb7190532989b6f64d693,456,FALSE,2855,2399,Dire
7813cd44a09625578767a49e0e2cf608,2230,TRUE,2316,86,
5ab2ed82fda5f1060618d1a550e7ebe2,1253,FALSE,1890,637,
ca5390b76fe4ce1155484427015dce29,2498,TRUE,3472,974,Dire
d5fd77f5facf5a488e6632571e9784ff,2082,TRUE,2868,786,Radiant
a3928fa302e233b8a5a84b0dc2baa4cd,886,TRUE,2075,1189,Radiant
4beae3ad669b4ebda74cf110b5b36faa,473,FALSE,1422,949,
1b9c1363f53198260ade04277a2c999c,977,FALSE,2458,1481,Radiant
bcafc8c8f8b299ec3d23a094c1ac9c4c,1892,TRUE,2012,120,
5965e308fca6bdd55e2932c7bc4f3a1d,1022,TRUE,3091,2069,Radiant
0c75d2624da054ebee5cc5f9a2920f0a,1627,TRUE,1791,164,
49e03700983964924a16a1271033094a,789,TRUE,1934,1145,Radiant
28754657c7fcdb50004ec3a7af81ae9e,618,FALSE,1744,1126,
dd04ed648385ee2186330d962ebd0c7f,413,TRUE,3669,3256,Radiant
12fb0cceb38acdcaa471962140af0a72,2467,TRUE,2534,67,
7efabcb32f54713b39394a89dbd22a97,1711,FALSE,2176,465,
58cb0762f31d3159a2652f65f9f057cf,801,TRUE,1953,1152,
dacfcdee30591422411a03c19dc6c65d,1465,FALSE,3106,1641,Dire
7ca099a5a869f539a2e17e8e272fefbc,467,FALSE,1122,655,
e0aaf839de41853ab1a13d6d335d2f0e,546,FALSE,1709,1163,Radiant
9487ddc7401d19bb89a9cc079432050f,78,TRUE,1912,1834,
20a800fa3214bca3899cc100452ee5bf,1089,FALSE,2617,1528,Dire
65b51bc4d0b91b280a65e5255dcca6a3,524,TRUE,3293,2769,Radiant
57ddfe1b0ea75b0241246efcafaada10,756,FALSE,3035,2279,Dire
96eeffe8a39a651a28832bc176b0a431,192,TRUE,2092,1900,
215dbd78eb3f3e980b5ba161e4ade11a,433,FALSE,1364,931,Dire
5fb998308aae801900ac69394e815c84,707,TRUE,1992,1285,
77f9ca4e43ae902da722526d73f6bcab,462,FALSE,1616,1154,
88d1cdacf54ed7b2596c4e41c952dd0e,584,FALSE,2405,1821,
bcc39d496164a6790f7918d3c4ec84e4,341,FALSE,1743,1402,Dire
fc65d7eb5e0b62d0c5173134dc6153f7,232,TRUE,1116,884,Radiant
5efba98e7e0d6b6597aebf388e615806,491,TRUE,2599,2108,Radiant
8064b08b611b74e3efea7be23cff15f9,2238,TRUE,3902,1664,Dire
a1db505f713528296af9e6c2f8a308f1,1667,FALSE,2061,394,Dire
fcb2bb2c40b4a22775141336e68b5504,1285,TRUE,2578,1293,Radiant
ee3b893afddfe0ceb2c14e1c19bb4366,1393,TRUE,1969,576,Radiant
85d0aea4bf27c4f92fddba46e9661ff7,37,FALSE,1794,1757,
17b48d33978d290410f4327b2b93943c,1377,FALSE,2564,1187,Dire
e3f6035a389936b3ff4624a095a131d9,1459,TRUE,2473,1014,Dire
0f2d90377df34ca13118945b893bbd2a,226,TRUE,2565,2339,Radiant
06c4ab9ff45fc80ad597633e0f09077b,270,FALSE,2895,2625,Radiant
4f05d3220f8b0babfed82f7b33af7a26,119,TRUE,2333,2214,Radiant
408091e2438f8363daef2daaed1a75ad,1161,TRUE,2516,1355,Radiant
866980d8cc3ee8f84b64ff46a3bbcf66,2960,FALSE,3549,589,Dire
e253c343a4af70a7a246ec4ad1c53e08,570,TRUE,1273,703,
4a4aa1e468bf3e38c6c7f1570bc1bef1,3721,TRUE,4018,297,Radiant
f12b3134d9ce1466f9ae12d078d04c21,998,FALSE,1046,48,
395a52936348ee26c51300c5834e67c6,522,FALSE,1763,1241,Dire
9e09eab29090b51500a19adff606274a,707,TRUE,967,260,Radiant
eb413613f416f3187e74f6b9fd6ac9c2,57,FALSE,1709,1652,Dire
053ddea8ebb079bec82df91b42225116,833,TRUE,1711,878,
e61489e70bd0499fe042a327caf0b507,1296,FALSE,1434,138,
583dda324ff316255abb43053123ed17,1124,FALSE,2567,1443,Radiant
83fcdef2b7fb81c02a5b9c9abd2674f8,339,TRUE,3154,2815,Radiant
0bc9069f4456cf76ac04d91260816518,1161,TRUE,2403,1242,Dire
cf8397a988fc1d3c8583e1c90a077fec,2571,FALSE,2678,107,
b30936cba17773504759f69eee967fe3,129,TRUE,2087,1958,Radiant
f52532d2505d427ac52ec790ac186006,1325,FALSE,1618,293,
4d7ab43ef81093df38dc1e8954c9122e,2626,FALSE,3412,786,Dire
46504829fd737a81f1c5c53ceb805145,1506,TRUE,2197,691,Radiant
91feeb4f0eee554eda429796b12e0fb2,862,TRUE,1958,1096,
730802b925c093e55abfb19e9c008425,1129,FALSE,2661,1532,Dire
0e0477ea43883e20aad931a62b509531,1481,FALSE,4248,2767,Radiant
1afcbd6982989858e8e0e025fa5b9a20,2384,FALSE,3219,835,Radiant
199a3c0eda855c71bfa38c3bd379f4e2,516,TRUE,2212,1696,Radiant
6f09ed80c5a5ebf611418a6f51b1730d,379,TRUE,2450,2071,Radiant
88d397cf2b9b8afb4c83e5fd60f25010,944,TRUE,1646,702,Radiant
f479f8c03344ddeac41bf335a588ed9e,183,TRUE,2053,1870,Radiant
48bbf77f45ca605f2d739a55d1f77845,82,FALSE,2058,1976,Radiant
85d5188b78e693e3b45dc400bb207154,507,TRUE,2066,1559,Dire
c071c514907adb9250c3817778610f13,1166,TRUE,3268,2102,Radiant
cc1ed873eefd1cd93d3b42a680e36fa4,90,TRUE,1828,1738,Dire
209b6ee985d35205764e41ab9d17c350,264,FALSE,1974,1710,
62e5cd58c80aad4a333625a40c2e2776,1860,FALSE,2172,312,
63dedf8b41170d0c1c7e34ee60d62195,1404,FALSE,2090,686,Dire
af4e89d8f43c95fb4f5e9b0b7069c97e,328,TRUE,1588,1260,Dire
0155f374365f47f8c19c00c5104cde60,1518,FALSE,1880,362,Dire
1d71a58cf89d9ee25e4e076f7b2376bd,905,FALSE,2226,1321,
136a68f71469aa7b21375bbc4e9394d8,693,TRUE,2249,1556,Radiant
09141c085dd21a11d15baa83a2168394,297,TRUE,3138,2841,Radiant
2e903e2eb8638c050997462bcae0c27a,859,TRUE,1029,170,
b24181f7dce8edda20e8ac3bf35ff4a4,73,TRUE,1273,1200,
067cdea18503c61c317cded14fd6ae04,28,FALSE,3040,3012,Dire
4632e5bc2d8aad538a13db60dd6682c9,819,FALSE,2283,1464,Dire
2d0a1c187ef2f6468d371a2b8ad9a3c0,1530,TRUE,1566,36,
c8c3a6db61a5867678526a0e0bf15ff6,628,TRUE,1165,537,
847bcfcfd41e5580aa441cec2bdf3030,233,FALSE,2113,1880,Dire
05425779d2bf5b46a59e6deded1d69fb,1761,FALSE,2243,482,
81f0c65fb9a20cad76a660e387340784,115,TRUE,1948,1833,
ece76b2d5414112beefcd52b35557283,1960,TRUE,2575,615,
732a7979cc9f9e108c8f0a69659c0267,258,FALSE,1786,1528,Dire
d76ea21b1f32982dad2ffe2316fa4e1e,295,FALSE,1843,1548,Radiant
22377e57647bce7049df727b0fe5d4a9,102,TRUE,1303,1201,Radiant
9cd6f8198ee207ff087ca4eec60abe52,2551,FALSE,2781,230,Dire
337268d02e840cdbd931d11230e8667e,832,FALSE,2543,1711,
e34c81a9a1789fdd25ae52e2a40464bf,618,TRUE,2178,1560,Radiant
5fbf3055226c62cd20beaf8835a1c285,994,TRUE,1442,448,
9e8adf597ee8db5053f7bd57fa192c41,1124,TRUE,1743,619,Radiant
ee3512f2ce25beb07dedc6c8559696c6,1702,FALSE,4012,2310,Dire
a572caf859f979b752048218e0aa6470,1033,TRUE,3208,2175,Radiant
77f47b8f53ea86442be9fbac8c990017,1560,TRUE,2814,1254,
19c1306781e3cb602c9cf1eb512dfeab,1830,FALSE,2633,803,Dire
24a2a75980ba92be45a7fae6b63bd772,171,FALSE,2677,2506,Dire
bc90d4c82cb1e0921d1b8780c993b083,1200,TRUE,2855,1655,Radiant
552282c356056bd443f72aa0962d0ff8,750,TRUE,2532,1782,Radiant
f7b48ef09d6da68466c626bcef43c49a,1194,FALSE,1853,659,
a922876a5b929b7170538c6c71ce6a63,616,FALSE,2122,1506,Dire
88cd90b10f94a4ff50ab5d8cec514acd,1528,FALSE,3938,2410,Radiant
055848d9d2fc771f84b5c8580a52e47a,1687,TRUE,2457,770,Radiant
efd4e1a35071673dda77999a77c1168e,2125,TRUE,2280,155,
699d0ad36b32cf4d4a6fb5eccfc4b719,79,TRUE,1958,1879,
f165f4cb9b0d440a869993b6d72f78e0,984,TRUE,2333,1349,Radiant
d18bae3bd1143decbad6c64399d69b5c,807,TRUE,2268,1461,Dire
224960eb5b9aad1ef9a4e6679fa94acb,162,TRUE,902,740,
11038e527c5e3aff2e96fea2eade9163,2381,FALSE,2457,76,
877f371e9f4bb84d86f0aa3ffcc00a93,239,TRUE,2152,1913,Radiant
945a0cde319328a7fe1376b36f64603d,1122,TRUE,1915,793,
ee33f660338ad85693fc196b79987a7c,634,FALSE,2872,2238,Dire
855a648bcd6276038d318217d63d0613,1538,FALSE,2368,830,Dire
5382b2f44e391e648d89dd4bb06c453d,367,FALSE,1790,1423,Dire
711312edc08c6022f1e9225a542418a1,378,TRUE,927,549,
45cec2816135d0cc93a0a415800a30a2,397,FALSE,2700,2303,Dire
de525765126660a5521c1b25405b2e18,292,FALSE,3501,3209,Dire
1557ad27e478ba356cebcf738862e89a,398,TRUE,2513,2115,Dire
951db5258d8954c2e11dad5983d06850,21,FALSE,2825,2804,Dire
5108f9d3e4270908f0e63af37cf86ccb,1229,FALSE,1590,361,Dire
4999b30a392c9b7108fa04de9ee51501,704,TRUE,1882,1178,Radiant
ddfb3c06172d18f486450b97c4570d40,554,FALSE,1600,1046,Dire
f0a73bb8b91fb02236acdec28f3468e7,1508,TRUE,2193,685,Radiant
1b472f81e3258c55d61308c8cdc3a086,1873,FALSE,2955,1082,Dire
0aec8b6e5f77059823b665ebccea25db,751,FALSE,2778,2027,
abc2209c53892ea1f129e2cebeb4ee69,585,FALSE,2690,2105,Dire
7223604f30c37a0421f95b736ccd311d,1069,TRUE,2179,1110,
9fdf374c28347b3451b5e86ef3834436,5,TRUE,2764,2759,Radiant
82c011750c8736b134365709cb498c4e,1116,FALSE,2886,1770,Radiant
380e5b0e0f7670d9a2e1025a56010d14,2410,FALSE,3405,995,
32e4b3011793e4f53a0060b106955784,750,FALSE,1618,868,Dire
484a06ddc85c8a8fa50af316befa3273,2125,TRUE,3428,1303,Radiant
9486887cc5ab40803667caa79f14aec9,673,TRUE,1866,1193,Radiant
411ca9c50e8b4ca9b2ce9c983f0badca,686,TRUE,2465,1779,
b775d0bac4e007163c063e9e09d2cf7a,443,FALSE,2253,1810,Dire
9721bc0887187df3fc4ad9b3ddba4b6d,668,FALSE,1509,841,
7f9bbfd06e1f8e05f663504d9a63163d,1105,FALSE,1273,168,
eb92e2e54443bbb7a97fce0b05d82f0c,816,FALSE,2009,1193,
894c6d81093a8e00e2b1614615d0d805,1597,FALSE,2458,861,
6c183e445f9d065511b35f92a4d416be,178,TRUE,1229,1051,
36fb4969a94d0b333036d46a582363b2,1383,TRUE,4886,3503,Dire
8a31f7b66134886e9401f3d988324706,749,TRUE,3063,2314,Radiant
09f0a54090fbf749125c210455939070,345,FALSE,2351,2006,Radiant
f1a6b74726edc5b18fbd1e1ceef669b7,1425,FALSE,2756,1331,Radiant
3ad18b77bf7be8ad7aa4be4904eadef6,142,FALSE,1417,1275,Radiant
141256f6c854ddea2b721d80af480bf1,1318,TRUE,1576,258,
c049f6bc3c66c9c4d29bfd57fd89bf8a,1502,FALSE,2745,1243,Dire
d8c1152fda55aa01d452dbd8f6db52c3,181,TRUE,1853,1672,
4a6d02132e726a085a9f0067e05627d5,323,TRUE,1692,1369,Radiant
654a854fe2444d98c9f7b0ea6cb94f89,2267,TRUE,2847,580,Radiant
de0c0fc45d1c4186cf46b9c3b672ccce,1009,FALSE,1628,619,
216510c7770f53c9b85384f14725ba06,1604,TRUE,1960,356,Radiant
cbfcbffa10ede2199a95daab090d088f,618,FALSE,1910,1292,Dire
82f827b9bafac0370f4517d997a16913,795,FALSE,2088,1293,Dire
8abfff99f10f39ff8cc1f42c91567694,1040,TRUE,1766,726,
b5a58a7920dfe849bd04464dd588e7cb,2560,TRUE,2750,190,Radiant
7244b155d071525e2bf19ee2461a850d,1138,TRUE,1729,591,Radiant
6b92dd6a6f20196e61761c5260248188,1408,TRUE,1545,137,
190d85eeb7ed8b9f412e52c0f29f4342,3368,FALSE,3597,229,Radiant
d3403c81e0f7d2d7fce78f14ec064020,902,FALSE,3396,2494,Dire
b785c1f71bc30b4971fd69802ed9b512,889,FALSE,2581,1692,
163114c49b097598aaea7779267c90d1,2463,FALSE,2541,78,
a20bdbdfc4e05d7217b8cd87973da11a,1167,FALSE,2752,1585,Radiant
2263c9fab0cc330092a1caf1e8c7ea95,521,TRUE,1174,653,
bd12ee49960b5fb1374259d8dc995271,2029,FALSE,2161,132,
a41dec26e5452f3e2a077b279bce9200,976,TRUE,1617,641,
008dcdac7228b3a7a55c352027a067b1,881,FALSE,2089,1208,Dire
c86c9e0104ebe53032c37cc08017844a,1079,TRUE,2230,1151,Radiant
fef7df422d295f20ffb4bb84f41f78b6,1469,FALSE,3801,2332,Dire
f748b07204e9161f799c93935c9c27ff,890,TRUE,2458,1568,Radiant
3cd1930cf87f2ca50f40435f2e308501,1759,TRUE,2201,442,Radiant
64eca1bd54b9425a4bce6edd41c2d54e,1082,FALSE,2681,1599,Dire
7983de1d081927234126ca516a22e415,878,TRUE,1597,719,
dbef300a0410c71031b3bd30fc9f5179,668,FALSE,2046,1378,Dire
16a11e2fa806a24af47b410b17c2beaa,1613,FALSE,2729,1116,Radiant
30ec0880fda5db2b8f3e1c01726caa36,14,TRUE,2019,2005,Radiant
ee4de5d88f5b1fc5a3d9448d77ad8e63,2680,FALSE,3096,416,Dire
aa23165f53a7942dbd5b8e2d4ecfc83d,964,FALSE,2429,1465,Dire
f11395b49cc96fccc089ce23e6c6de0b,1930,FALSE,3365,1435,Dire
4e5790ae050f31bc7b9ea117434b40d9,814,FALSE,1722,908,
817b600fe02feacefd81e28ec3440a5d,2400,TRUE,3431,1031,Dire
58facd3a6ed4550a7db47344a71e963f,1048,TRUE,2886,1838,Dire
82cd3f3e119b327e429a56b038718dd3,1604,TRUE,2691,1087,Radiant
272349a94064a7a1818b5c7ec70de035,392,FALSE,1420,1028,Dire
3c440d7418c95c062765dc0a6ae1857b,738,TRUE,1205,467,
9d1c50516919aabbcf6e2a1f628f30af,2300,FALSE,2708,408,
595fc654afd39ff50b546699ec4fb750,1825,TRUE,2332,507,
e1d579f5dc45c515a3825db27305ffcf,1256,FALSE,2166,910,Dire
03fb83abe724371485474bda397d8f1a,1184,FALSE,2448,1264,Radiant
c8a7eb3ec7884a936dc01233805aa11b,13,FALSE,1823,1810,
a87e5d2191a38fab4cded568a63e0b8a,622,FALSE,1943,1321,
269b8857963673a51b1f281dc7d0f5eb,1699,TRUE,2024,325,
7d5f9c59f67681b27f8106ad64ada524,596,TRUE,1615,1019,
0e7a31f7b821138003b43a97c8312d79,1091,FALSE,2941,1850,Radiant
9bcc32fea6be0f41ec625527a01e0f10,770,TRUE,1494,724,
33d3b0611e9434a422230f82592fc040,1891,FALSE,2837,946,Dire
8d36724b3df0be28c6279b0bf71a64b0,986,FALSE,2464,1478,
92ac8a5e947445b85546a5c65befd307,1513,FALSE,1934,421,Dire
a29d5252d6f0e34c1266706644a6d46c,1138,TRUE,1799,661,
88780e5ce33a3c715215360a796118b1,1761,TRUE,2244,483,
9e4d64c26c63aadc3ccf4025d69aeabd,1023,TRUE,1918,895,Dire
a0dc99aefb7122adf92d6c8e928205fb,229,FALSE,1410,1181,
ab53e4ed838ca88d1ace066ff33748a2,569,FALSE,1885,1316,Dire
9e1ba239b93b4ed57d811a1a0894c74d,1363,FALSE,3451,2088,Radiant
e1223ab586be187a384022d066f6f693,999,FALSE,3604,2605,Dire
886d8c423feca0fad32ceb32e821d96a,1630,FALSE,1711,81,
4fb4f8d042c362494cf0d2a079ea36e1,346,FALSE,2396,2050,Radiant
a9f43f5aa8977b0167a664ffd41c7aba,296,TRUE,1737,1441,Radiant
0bb7318118adef384e9f8e4d5c735548,116,TRUE,2865,2749,Radiant
d19f0471c00138c044ea46aef73af9f4,1880,FALSE,2042,162,Dire
2f39ece03db5d9937b3a1c6d7153fae3,344,TRUE,1951,1607,
8213c5d14eca97f29c7de43e15f33ef2,494,TRUE,2570,2076,Radiant
a6f8da0a81d726ecf9f214022d4d4994,1775,FALSE,1974,199,
da782bec9279f8c6acdd1220b220c050,926,TRUE,1419,493,
2c05d27e50e67909ea5af46e0b5e1e92,2533,TRUE,2816,283,
b0acd295539a07f3c9810fb784cd44b9,2026,TRUE,2923,897,Radiant
1cc171d27e8937699223a66d69e965ff,413,FALSE,3422,3009,Radiant
df7ad6c0ecc1e99b6285369d3bd16bc4,2501,FALSE,2880,379,Dire
a53370edbddf70a8839a8c9b5d5c9968,1041,FALSE,3445,2404,Dire
ec58cf1206a70f27943aeda5a5b74957,2759,FALSE,3051,292,
9570ebeb2023a0f199a76cd8b6626a3c,45,TRUE,2405,2360,Radiant
a774c7b1b1fd55bc6b93e6f93ef382a1,155,FALSE,2842,2687,Dire
6fe1da9bf075cf220516aa27f0f9996c,1210,TRUE,1949,739,
c55d44aab54ee8f4e1722c7cfa1ea7a9,864,FALSE,1809,945,Dire
edbbd5cb0a6d46ab8b4c5d7b7900527f,1289,FALSE,2487,1198,Dire
41a8dd4301e915bf73a46a4de04e4d01,2415,FALSE,4116,1701,Radiant
71ecfa49f4bb3960d182a920eec877cd,505,TRUE,1424,919,
931b94740e6e5c6ce58aa715a4ff2eaa,2106,FALSE,2242,136,
3048a1e87debf51615927464e57a8b8b,575,FALSE,959,384,
e28fa0c3aa792455bd17bb6d7becbc67,771,FALSE,1792,1021,Radiant
2ec30fa9413ce0e69d52fe66a69e9f33,1350,FALSE,1512,162,
037d357705f1922f8849fc6f51b38634,2303,FALSE,2429,126,
1846b35f036dfbf27c943da32d173ea3,879,TRUE,1193,314,Radiant
f1cb37e7e22262ba6d79b6f58ce8aae6,1040,TRUE,1958,918,Radiant
b6bb7613543d6c74d1030736c5602cb4,1939,FALSE,2353,414,Dire
94604bf46c75baf12b1d0c84a99ceb11,1273,FALSE,2182,909,Dire
157407ad26c89532cfee8bfe2ad9d69c,1458,TRUE,1798,340,Radiant
798035ee0a9939d2309ac2630080a9e5,2001,TRUE,2102,101,
7ce775233d3fbc2db2594d7f7dadfbb2,710,FALSE,3412,2702,Radiant
ed1217069e6a26f08b4d114a47958125,1571,FALSE,2779,1208,Dire
1b95073c21b823321cb5114f4bb40650,2516,TRUE,2787,271,Radiant
d286772eb932fdbb288420067da9a75f,1451,FALSE,1709,258,Dire
c1f32f8e3447c6e2f75a514d59b65eeb,1634,TRUE,1987,353,
c53a9237265e30078a36294b7097cd77,834,FALSE,1425,591,
7cec6b589abaea372afc8ae90f4d6a9b,1334,TRUE,2869,1535,Radiant
c7d8941a5518ffe708fa0925bd1080ee,1677,TRUE,2017,340,
2b669f0edd658642114035e1e37907aa,1719,FALSE,2771,1052,
a9e468d891b328f7eacd5ac52cb7955f,193,FALSE,2101,1908,Radiant
bd220517714eaa6b63ef4e087cb3828f,263,FALSE,3599,3336,Radiant
072239189af751721557e24f475a87fd,2402,FALSE,3027,625,Dire
9115c629eb94a658f2e066bd6caae1c0,840,TRUE,2017,1177,Radiant
383b3f8d254e028f7af4a9bf52a109ac,2257,TRUE,2698,441,Radiant
ea0eb61cacff8fc33b1729d6efc5260e,185,TRUE,2022,1837,
1cb692624daa67befa684deb55a4a7c8,1829,TRUE,2162,333,Radiant
966b9311e5f4ddc28de563e5707eaaeb,1799,TRUE,2606,807,
666ce31d975ece0415e72c021f6122b9,513,FALSE,1104,591,Dire
15e6208a2aed40db716f1b1a1cbc0d21,2129,FALSE,2497,368,Dire
5a0da22a1305a798550bd0cff384ec6f,1809,TRUE,2525,716,Radiant
a783eb83136bd79a4316346436834cf5,2051,TRUE,2794,743,Radiant
5f0ae9c03a4cacb895cbf83d52d02b33,1392,FALSE,3138,1746,Radiant
08b5409b83f84068e4abfc1b7a29cc24,1828,FALSE,1888,60,
9c438ff8486d8fce2525f151f081230e,253,TRUE,2756,2503,Radiant
c31d59dbe8977753eb089ab28eb1f121,2436,FALSE,2698,262,
2c79ee324fb904d5d2c571126199a6e6,1669,TRUE,2254,585,Radiant
a9dca8665596160a6ae965718e4e5375,739,TRUE,3166,2427,Radiant
8c46fc731f480d3e33fbb6cce60399c2,1592,TRUE,2816,1224,Radiant
37f24f9b82249b9f428e7a5ec60239a1,711,TRUE,2309,1598,Radiant
c01bb22d170fc7674ed289104715722d,1374,TRUE,1590,216,
7794122e01374c8c118fc62ec07c8621,2223,FALSE,3213,990,Radiant
767875e05edc5f3ccd0231cf81b81583,651,TRUE,1709,1058,
86f8df40342d30cbacfa72982c2744df,852,TRUE,1839,987,
c95c0986ff71aeeb61b80d3fa662373f,2675,FALSE,2996,321,
90279a738dcd27f37e17a7cbbc57746a,756,FALSE,1194,438,Dire
0fccb928b50ae58d077ec20829d05a8b,1049,TRUE,1746,697,
96c64f5abc8e2edf3e1e0d168006af76,606,FALSE,3033,2427,Dire
c23c84ff5a9efa25a293122d53882d20,2097,FALSE,3033,936,Radiant
5a83e8ad52febab76eee3ccdf8b256ea,1306,FALSE,2050,744,
9c4da7a8e2e7a8acaff10699a924fdf9,212,FALSE,2552,2340,Radiant
b1399173dbcdf6fb80ff68f7c68aedb9,821,TRUE,2318,1497,Radiant
031cfdf8f0dfc8e5d0940b780f480e12,556,FALSE,1677,1121,Dire
26eaf490bcbdd57e34106af8570faccd,1018,TRUE,1866,848,Radiant
8e2f617cf9ade99c90cbdccde0bc7b3c,1653,FALSE,2795,1142,Dire
d1cef82120917e1824ae7669d53b73ee,39,TRUE,2276,2237,Radiant
c42bf725e436f5eedf4f7ee4d111f06b,3099,TRUE,3398,299,
4081d3f67c56af72e3798983bebaf99f,1095,FALSE,2536,1441,Dire
8372a8e8ec35b48eab56cc3228677ba2,1155,TRUE,2608,1453,Radiant
fa4d8096034fdc62a72a3184d1bf6b77,653,FALSE,1928,1275,Dire
9d8d18fe41c258edee3c42457b7f5257,113,TRUE,1924,1811,
db7ac281b47d906a3178acc9d75fe18e,118,FALSE,2483,2365,Radiant
9e6303183db2f228b852be06c324c88e,470,FALSE,1835,1365,
8e17f962dec971c2513596cf75ced2b7,2506,FALSE,3331,825,Dire
75ebb0e9c31ceb5198e9414d7608c91b,1280,FALSE,2710,1430,Dire
80e1fc7cd05e0361bec9a26f38ebaea5,63,TRUE,2778,2715,Radiant
f21183f88a8fd6a8a66f78176bfad3e3,1935,FALSE,2374,439,Dire
e1df8aec387ed60afb16a09e35399f0e,1338,FALSE,2101,763,Dire
24df90a6bb90f8c918763947b0d7623d,1694,FALSE,2879,1185,Radiant
50dc5415c3977f54d610671114875223,1072,TRUE,1163,91,
7bcbe2fb8b91f5401068e34fa1791d15,1890,TRUE,3776,1886,Dire
196e60078fffd769814311b35db0d13b,150,TRUE,1275,1125,
1d3dbfd2269df6b7590e2d13d326facb,1306,FALSE,1866,560,
debfb6b14cfe946abf67c900175af5e3,2314,FALSE,2378,64,
4dd2c710ace81a0218065d8d781b7889,2025,FALSE,2108,83,
3d6b51273a7fa2988d82eb1f6c6a2b8e,682,TRUE,2216,1534,Radiant
1f8918eb7c0bc107407d1882c44926b8,791,FALSE,2123,1332,Dire
0a5bea90fbdde4c1c1a2f8e17237ec7e,520,FALSE,2524,2004,Radiant
2de771ffaef7b10e49da4a3adf110d42,1094,FALSE,1987,893,Dire
07902563868734be932187dc90b915ba,2515,FALSE,3416,901,Dire
457bd5d33d22919c36f6ba6d1c79e0b7,408,TRUE,2489,2081,Radiant
a377c5394d183fd29945fc47edb7d2a9,1694,FALSE,2536,842,Dire
3c7ff6059668582da4b8bb88c777c8c2,338,TRUE,1973,1635,Radiant
4f0c69dd65712bdca9785eba9f91c700,859,TRUE,1858,999,
c5fdb0593af2c1b2eebe43c2bf53a329,1536,FALSE,1974,438,
287d5e61907fc955e2f769d38670cd79,1185,FALSE,2341,1156,Dire
e43e4db3133aa23eb1ccfb265bb7d616,1653,TRUE,2192,539,Radiant
c65648d930300d98ae88456bac2b3d69,2715,FALSE,2748,33,
9ce24d1fb58ff86fbd6338c7fea056ea,1230,FALSE,2524,1294,Dire
c8014d2aa56e3df55a8019af9b5099be,892,TRUE,1821,929,
e0ac088a7b0245d167a6d80a000f2639,1522,FALSE,2122,600,Dire
2e33af94cab4f60786980fb8725ed8f5,732,FALSE,1847,1115,Radiant
a479e49c2d93ac2d89a1336690848978,1170,TRUE,1513,343,
10767100a6a7721a824a55784f6f0284,1415,FALSE,3102,1687,Dire
83e0826aa7f7020d8cb2da0437de4265,866,TRUE,2636,1770,Radiant
191dd102b559b94d1a1ea756594ebf53,1764,FALSE,2179,415,
121342c452f2c4ae434c30995cc6033f,1351,FALSE,1974,623,Dire
025706cb5a8832c3cbdf0abec101aea5,618,TRUE,1746,1128,
2375c44d20b9adff0248a4a6d76d852c,1183,FALSE,2271,1088,Dire
d3917b94b6f20c88a3994a104993886d,189,TRUE,2990,2801,Radiant
0b7663d633e870ea8143a26cd5c363ed,969,FALSE,2041,1072,Dire
1f7316271b3c2bb594b2fa6289d2d376,515,FALSE,1822,1307,Dire
e7dd92b8a29b76858cee6c268a91f3d1,676,FALSE,1755,1079,Dire
39612b13f1e78310ed4e751307f7975e,2196,TRUE,2418,222,
cd38dd320b88971f02246272aff4aad9,387,TRUE,1481,1094,
2ed21277bab79f1af66a04e7f60d51f9,60,TRUE,1319,1259,
7e930d8c6fe0a58e7bda9581c26784a6,54,FALSE,2672,2618,Radiant
0455a739194c7ae2b0b0f529a90c5d72,226,TRUE,2082,1856,Radiant
46db72184507a1bbbb399ba7e769ae64,52,FALSE,1723,1671,
fe72c91951ff8a135d3e19b35c1583b5,2003,TRUE,2046,43,
aced12747566ad17e0681f09b5e6c56e,501,TRUE,1307,806,Radiant
98ec6bf8474aa9ac84caad7e4c6ad19c,756,FALSE,3902,3146,Dire
62a05540c21123ee199b29b0c092a8ed,627,TRUE,2992,2365,Radiant
90808b84fdb380eb440021fe501521f4,241,FALSE,2395,2154,Dire
c37b42042845b3fcedf2cbf825f17a56,976,FALSE,1891,915,Dire
bcd053eb460d4ae0bbf20e9f2f23d936,2695,FALSE,4055,1360,Radiant
6018c10d53f7c0517fe478f5cfb55077,1699,FALSE,1940,241,Dire
fe435e5a638c3a028315084286228e1a,1605,FALSE,2584,979,Dire
0ddea6a915d74296f133f7ff6f7856ee,1543,TRUE,1750,207,
230d533c8ee184949b0cd41a1d0ddd03,2304,FALSE,3025,721,Dire
b3f75ad02f3db01f04cb51a91179039a,813,FALSE,1943,1130,Dire
9a325a38ec3c30690fad6f690d9e854d,632,TRUE,2102,1470,Radiant
3ed9a0ecd93336382cda92f55af86c89,1510,FALSE,2181,671,
e845765a05c2f450cbb5999a8acbd708,2369,FALSE,2654,285,
88919d4554cfdfdc200e3fd17662069b,1725,TRUE,2916,1191,Dire
68dbb7c1e12555c2f7c8e72bb5945538,622,TRUE,1933,1311,Radiant
ddea7c8b1737ba53cf00243ed3d2ea80,1478,FALSE,2294,816,Dire
bfc54f6aefc36275aa45d3f9d8e740f8,1202,FALSE,2243,1041,Dire
4264dc59f0770b0bb6a9daa04b3284b8,507,TRUE,1540,1033,
e6610ce7f73248a9dc66e4242c551aa9,2393,FALSE,2920,527,
a5a18b55f685ff6de445f6207e4a459c,1766,FALSE,2663,897,Dire
2a86832711f16f8aa2acb7b7376e11f9,471,TRUE,2488,2017,Radiant
37f286558bcf4f76aeb81b0a2160e018,1818,FALSE,2004,186,Dire
af4051a2b3fcec65e46f61073f092377,139,FALSE,1407,1268,Dire
eea5775ac4922d22cc25321296fd220d,1856,FALSE,2417,561,
365704d8c91f82b93f1d49817dc9c260,525,TRUE,1756,1231,Radiant
65b355b2a1ae6597200cccd4411f9dc0,100,TRUE,3538,3438,Dire
1e68ed80460607364a9cf74751c6df09,905,TRUE,2033,1128,Radiant
d34c82c268ed8f465aa4048559a42358,960,FALSE,2750,1790,Dire
0388cef8e3bac092332bd654d43fde07,1224,FALSE,1424,200,
6fd0a47cde835dfa724edc492d20e767,1070,FALSE,2636,1566,Dire
6240478bfef365d8af1453f0cbef5123,925,TRUE,1380,455,
fcb6cebf048b563a40d6ae6065e87c2d,2423,TRUE,2501,78,
18af4eae84ee036a523b4671cf1f31d2,624,FALSE,1914,1290,Dire
6e45e29384631f29494ad61d660c16d7,684,TRUE,1723,1039,
7b759812807922a89445fa223fff65d6,195,FALSE,1670,1475,Dire
939d9ae09683503c82d21a4eb345233f,1907,FALSE,2209,302,
0c164114e3902d8178f612bbe06296fb,1760,FALSE,2300,540,Dire
ee4b6e792134c98791057219eb749f1a,623,FALSE,1972,1349,Dire
47d7bf123d8158a3c50a85dbd74c5775,751,TRUE,1866,1115,
ca9eeeb37027e327591f14621cece813,313,TRUE,1322,1009,Radiant
21b60f032564ee7485ecb8060da38c20,512,TRUE,3081,2569,Dire
aafe6b289cf01bcc93b5892ae5c003a8,3027,FALSE,3399,372,
179e741de2e14ad5b93825418d9dce64,900,TRUE,2847,1947,Radiant
f74ad19e51d1c4746b848abf69aad638,1092,TRUE,1864,772,
b293ad8d050309705de0eb6f1938ca7c,80,FALSE,2147,2067,Dire
8d3cc41c3ecdfa28b8efbc067e712052,384,FALSE,2229,1845,
59bbbeff52f63ef06c61a55a01cbe55b,1104,TRUE,2408,1304,Radiant
fffad4da0ea8e162664175bb7219254d,665,FALSE,2477,1812,
9f752bca3b07e1864a933b5961d775cf,2654,FALSE,2755,101,
c7e7f7e9edd3b963b1dc616858ab46ad,54,TRUE,1976,1922,Radiant
802a66ddce7303e70657a48101121e56,321,FALSE,1916,1595,Dire
50eb056aa9fe8174988523930e31c851,2391,TRUE,3497,1106,Radiant
ed3537e406345e9fb1f3f1915bfb14fb,2727,TRUE,3247,520,Radiant
49b2c210d9bb0da10fab94eb515c5e70,134,TRUE,1567,1433,
ac9f451673c847107e0e859721a5aa7a,899,FALSE,2698,1799,Dire
8b224626d00d71937c9b206e26ee28c4,1360,FALSE,2542,1182,Dire
596a17ccce351cc92dff0322d5933fc0,983,FALSE,1818,835,
c8b6babff48ed95f860455f3feadeb5b,3066,FALSE,3102,36,
3fc781f64ce0f5be9277e60f2bdbefc1,2533,FALSE,2914,381,Dire
9f01594d7b00b67705aa6a4536d6d71b,1228,TRUE,1999,771,Radiant
72f6ddba984207a3f4cf6017c66b3234,1390,TRUE,2225,835,Radiant
1b5195fc631168ec5291afcd8fe7b5ab,855,TRUE,2544,1689,Radiant
3fc2619030ef8859dcff04c97946b294,1202,TRUE,1720,518,Radiant
223c491a0ff169717358070c4a3b6cc9,1875,FALSE,3046,1171,Dire
0a257213c9ec6e3a97a632731c36c619,83,TRUE,2752,2669,Dire
070fdebeecbb0cf5494dbc867ffb10e7,176,FALSE,1823,1647,Dire
1aa594541649e557eb2f3678f7f73bd8,1277,TRUE,1941,664,Radiant
b8d131f133025b719cb6e0b353bc9497,843,FALSE,3239,2396,Dire
152b562df9a464867d4932dc16465f70,1103,TRUE,1962,859,Radiant
47212223f718a6a56f581b73207126fe,958,FALSE,1250,292,
b04ec88c0538eb80423cb893dbc48ca9,1101,FALSE,2999,1898,Radiant
6526736d410151426c23062af5751fd4,761,FALSE,1667,906,
2cb487a291ad67e9d7f4352d8249d9b1,371,FALSE,1397,1026,Radiant
223553333495600af385ce8eb3855a70,1026,FALSE,1987,961,Dire
f6b80b3a924a76b3eabb8d2863207f82,1086,FALSE,1379,293,
ccae6dadb2760efcbe1963678f7fe519,856,FALSE,1607,751,
9cdb636b89d6e1962ebd8a1ab17d62d1,445,TRUE,2032,1587,
23cb173f653f1297fcb23f71f0f91325,1023,FALSE,3001,1978,Dire
1883a3a6b0ea160fa5075c9faf8e538a,1031,FALSE,1879,848,Dire
9aeddeaa43806a4273ae0e6845fb9a5a,1651,FALSE,1912,261,
725ff9328ce4fdfc48d380adafa31762,1037,TRUE,2427,1390,Radiant
3b406bba357f15d347be2c546c570a43,578,FALSE,1383,805,
5444a37d949ab4deb2d561fe24031e1d,1629,FALSE,2246,617,
6a9aa188f16cfcca96a03931548d8911,1699,FALSE,2037,338,Dire
3bebcadb1d1a73d3324bfad6d88c9024,1109,FALSE,2048,939,Radiant
9117aa857a85a4cc947bebc3348d7e15,3198,FALSE,3301,103,
d02e18cf1dc8a2a365c2b123a99497f0,2370,TRUE,3644,1274,Dire
ec384294eca2196fe063f542ba01ad77,1791,TRUE,1915,124,
e61f689d7cf46ad22c988106d7458401,657,FALSE,2039,1382,Dire
af479f65fdf6d4dab05a21af54e5247e,2821,TRUE,3382,561,Radiant
1ca31d0810baf3e373b02209c82bc903,2347,FALSE,2601,254,
80e046504792b93cbf4d143246b5a7ff,317,TRUE,2132,1815,
9836a46de099aa50292a4c00e3026cdb,1483,TRUE,1613,130,
bbcd55073e84ff2f32c2eb3219b742b0,909,FALSE,1556,647,Dire
83df4fb8eda9eedc32ea47c86a1e90ac,639,TRUE,1511,872,
cac90251237f2f324c454edcf819a2ce,719,TRUE,2379,1660,Radiant
f4b18d9cfcc36dc3ca186e3fd1dd33b9,1421,TRUE,1537,116,
5a1b737c40f19bec6ba0d4c8baf9fc91,1539,TRUE,2042,503,
bed3e636607ac786216659c955b683e2,1216,TRUE,2143,927,
be9d0f0cbd7e381f2d1b2c069e073d62,1512,TRUE,2105,593,Radiant
899d4e7c4c3ea376f121c7d2141a71ad,944,TRUE,2512,1568,
7a8419b5af93bee11814085a27a78eb6,1532,TRUE,2826,1294,Dire
38ece3f67b742a2027c7b67b36a71270,367,FALSE,1760,1393,Radiant
9645f09890c135ce69273008f21deca6,1400,TRUE,1940,540,Radiant
9e2cbc30ddc5482900dc79d7a7c3d343,5,FALSE,2270,2265,Radiant
7f2740b80831bb794722fe5b2d446f09,651,FALSE,984,333,
7f3e8846a5fa275f86a2f9546c2086d0,317,FALSE,1362,1045,
7f524f5f603de7ab402b70c2b72584a8,1965,FALSE,2270,305,
b8c2ac8716939769b126007cad06c900,206,FALSE,2303,2097,Dire
8675e28d45d7546199bcf57999c30b71,154,TRUE,1628,1474,
17d076139d6e2769343182af50543f11,1361,FALSE,2569,1208,Radiant
86e74ed2edc9a7d3083a0df7c2c5f344,562,FALSE,3254,2692,Dire
480db4187efaf93f738b54e2f45c8de3,1224,TRUE,1867,643,
f0a8cbcaac387abcb4a6cef469be9871,1649,TRUE,2562,913,Dire
65b790bb33d87fb49b246b5f0c63a45c,1416,TRUE,2142,726,
dc05a4a76e93971410e1f8c5df734532,1247,TRUE,1466,219,
290375621491cb04558ede45fcb60513,941,TRUE,2086,1145,Radiant
cd32a3a4852d09b5ec3a684a5e204983,1563,FALSE,2068,505,Dire
11d37ef3537d0824ef3eab3208a49f1e,1695,TRUE,2037,342,
11574005e9aac2f02815dcc808ca01c0,1000,TRUE,2163,1163,Dire
f6f71dfd00ee7569f181c01117236661,2394,FALSE,2865,471,Radiant
48bb1c62364e84eb08cb77662af2c29b,1115,TRUE,2210,1095,Radiant
2ea241a66307212b894ef9e37496a068,1083,TRUE,2329,1246,Radiant
6b43e22af6ea513a4f1156a240e01005,2416,TRUE,2920,504,Radiant
b0d68b4578de8d83d79dd7a14e73adcd,799,TRUE,2625,1826,Dire
6280868839079511e33436ef094e602c,645,FALSE,1983,1338,Dire
a9a74da5a73899aa18342cbaa9074f3d,2546,TRUE,3186,640,
46f05fa1876189ac07cf20353ad65078,295,FALSE,2565,2270,Radiant
b3b703bfd66870b5db79dba888342fa1,447,FALSE,2899,2452,Dire
90c31a4ca0257ca69b0c8e4f87468657,173,FALSE,2070,1897,Dire
c1a0bf9ec3f08c686c35144a34ea4499,680,FALSE,2673,1993,Dire
76e77e3aebad222c5d11e82a005da35c,21,TRUE,2520,2499,Radiant
09521211ed7667c74c01d3acc6582628,1213,TRUE,1434,221,
fda5212aa50795304c6f95593ec9143d,507,TRUE,2595,2088,Radiant
60ab3418e7e05477e16581c4668447db,1197,TRUE,1962,765,Radiant
ad9d1137084d741292b8d1e8706a605e,1254,TRUE,2127,873,
6381d89a8f779cb2e40a17887cc5ae53,438,TRUE,1886,1448,
22f092e788f0024201a6d7c40ce56a57,51,TRUE,1440,1389,
bb4b9db971e4e8fa10162a6750df7398,793,TRUE,1892,1099,Radiant
33b65a4b193d4cb0dc039640b1bedd62,1800,TRUE,3490,1690,Radiant
61f28bf5ce9996538c34de152185a5fa,2518,FALSE,2955,437,Dire
8c71c03ba1ccb47abfd82b5ebe0ff1e8,1516,FALSE,2471,955,Dire
2cfd061564bb0b9540d7d88f94ffe048,1843,FALSE,3142,1299,Dire
bc8fce597c4b07a8d2d0710d6d69cbf8,759,TRUE,1556,797,
ac1888451252cf1c796118efa8312296,2344,FALSE,2402,58,
0b3f90f8da63b360db694da91caf3974,1243,TRUE,1857,614,Radiant
b26423b43c3ceb0467b5288fbf689483,120,FALSE,2604,2484,Dire
aab24e5de389aad1e0796addf4bd2743,206,TRUE,1685,1479,Radiant
9b71661c3c4806b035bdc631267333e2,2537,FALSE,4055,1518,Dire
d3f63e8b559b73c4de9943c019adfc6e,1734,TRUE,1797,63,
a134258525cea3947aed176e22cf8d77,142,FALSE,2544,2402,Dire
e076e94306ea03e0410c439410499102,416,FALSE,2353,1937,Dire
3f5ed5342f6c5e98a164b1c286f5bbdb,844,FALSE,2123,1279,
7dc329dc98998414973aacd81767cf3a,1212,TRUE,3266,2054,Dire
5da1056a9978247e94ac335578764d6a,598,TRUE,2384,1786,
7addb6fe592c22b24b56be340680b824,1094,TRUE,2841,1747,Radiant
5b46554893e6f8523517fba7025637eb,2726,FALSE,2970,244,
96f30f11af8915f870251ed1b259bbaf,106,FALSE,2321,2215,Dire
d2ec16b0bcbbeb1885591fa988624d36,74,TRUE,3043,2969,Dire
042d28ed907afa3f9cfa146f368cdf4c,755,FALSE,2557,1802,Radiant
d9a3e3f01dea709142934e97e0110e5b,1700,FALSE,2421,721,Dire
3e85f055902e1fd3bcb0085102932f3a,951,FALSE,2081,1130,
08da859383722de2c41ce45a5c49a2da,391,TRUE,2989,2598,Radiant
b54741cee15c120d6ca7f3295ce11132,348,FALSE,2232,1884,Dire
587ba8be9106a03efa28ba01d1cd6562,2241,FALSE,2355,114,
bacfabd03b63c84926cb7ec9ed7bbe00,2518,FALSE,2667,149,
7bfffb7156dfe9afd395af6a954cbbdf,23,FALSE,1905,1882,Dire
d060fe256fd8abcec9a8317ccd53d2f3,2380,FALSE,2494,114,
365ac5fee165338d500f6d3cf960e8f3,1149,FALSE,2367,1218,Dire
194cb95f9f8e9b07889ad78575dcc061,2056,TRUE,3772,1716,Dire
57a40869405305b3e2ba4e1c556f1af8,1853,TRUE,2271,418,
0ca38d0a36a61cc3c9b62295ad141320,466,TRUE,1863,1397,
1d2703dfe3d3dd96403ca07052be0df5,1033,TRUE,3748,2715,Dire
6c67db3230e5a1096b317b04a0c5fe8a,1235,FALSE,2377,1142,Dire
09bd0cea8b2501193f948b4862dd8b9d,1041,TRUE,1836,795,
37d606c4a0e95f2431b3fede255ff5e9,910,FALSE,3001,2091,Radiant
ddaa481e8e5ea4870fe769473d79ee9c,599,FALSE,1681,1082,
d917c7e6dc49c472687286e9dd048f90,750,TRUE,2428,1678,Radiant
f249106ca6d23650fdeed581591bccfb,480,TRUE,1861,1381,
a05699593d51c8789d240a891a84a560,731,TRUE,2459,1728,Radiant
2dbc5e7aa01a848864608ae8eb81f212,2097,FALSE,2546,449,
4e6cf647697eb9e4e95594e8aaba2b4c,1353,TRUE,2030,677,Radiant
92e75b874d9493e71f1b3d08b1c6e090,1385,FALSE,2341,956,
a2d440bc58657965abc6c93bcaee8a73,62,FALSE,2767,2705,Dire
67f0922f671132b44f5aaffcf035a13e,2410,FALSE,3268,858,Radiant
68e029341df6b19398a46c693062990a,1929,TRUE,1967,38,
2f01c1608caa12e02389e8e7b61d5fa3,1382,FALSE,2688,1306,Dire
406148614e17183e89343c525938ef0d,973,TRUE,2402,1429,Radiant
fa2c11135790669f07b5c601d709a89f,1386,FALSE,1596,210,Dire
5f8ac79fbf0fca702b02458e83981924,1364,FALSE,1549,185,
a44e954d3e7c12442f2d96d4c4e4f5bd,584,FALSE,2355,1771,
2cdaba89d853f56d388ec0f76520ef81,1758,TRUE,2978,1220,Dire
3357c656ee32e923d1977cf546bf7313,1316,TRUE,1886,570,Radiant
ac0a36ce939813411ae2d5d619173d10,529,FALSE,1876,1347,Dire
a5d45be95f245b02ce7009c920935c47,999,FALSE,1640,641,Dire
8d1ce7c2c5f0d41eb40e5e3d5cc6f99f,886,TRUE,2811,1925,Dire
28d9ff1caead4f1dfef922f70c3bee73,1144,FALSE,1984,840,
0795fdc9e67d1e79c4f556a929a6342a,1089,FALSE,2877,1788,Radiant
463c46857974ed624ae44cee4be5f300,750,FALSE,1095,345,
6076d0a6c8d5c6ebcb3952a8b2473008,505,TRUE,1146,641,Radiant
c9d0cb687ad74569f8f67ef11a1f6b2b,1095,FALSE,1907,812,Dire
80803045dc871e9a5f8db72a9fc86d7c,395,FALSE,2798,2403,Dire
f323a4c8bfdf2fa396df2453d1d41f77,1307,TRUE,3431,2124,Dire
5a335a8d5755abe855ec1051f12dbaee,717,TRUE,3149,2432,Radiant
aef1d40dcdf0d20c72d3fb01b1380f50,6,FALSE,2052,2046,Radiant
8e11ea4518af4bae3b8d4368ebe9acb2,2121,TRUE,2764,643,Radiant
9fdc7f96535c5d471a7bf7e90822687b,2231,TRUE,2803,572,
e62cac252daa478b78b2e4ef0b130693,1223,TRUE,1544,321,
d9d2c9422b46065f0687ff6aa438f570,1807,TRUE,2607,800,Radiant
018b0f7607c862d6c0cb4bb93d45134d,73,FALSE,1667,1594,
7470c7034301a58e8b9c1df5468b03f6,190,TRUE,3564,3374,Radiant
cf4df1bb89229e3b9c339851dcd0deda,637,FALSE,1705,1068,
e04b7aa57a5cee915a4f1ba6e7f644ab,1110,TRUE,1832,722,Radiant
f0d9ac6a749e8a956512c2c290f53de4,489,TRUE,1988,1499,Radiant
70a59769acf708f0e74eee3ece0b4121,392,TRUE,1884,1492,
a41e35004e95186f641a7e6a5ab8450c,943,FALSE,2825,1882,Radiant
c36c7ea6897c7ff55abcf9c3dc271b71,1258,TRUE,1718,460,
7817d15408160addde826d0b011d4bf9,1275,TRUE,2184,909,
d26e1c6bcb3e7f42ec70ec870b6cfa39,1815,FALSE,2242,427,
cd6ac00128f7b038a2932956206ed1cc,2462,TRUE,2877,415,
8e88d582136175e9c10dc9db52ea535a,1149,FALSE,3513,2364,Dire
6887327f083ca6ad6f8543e68334bcf6,553,TRUE,1143,590,
1de151e202534493cc78970ba8084adc,1255,TRUE,1382,127,
a4f7f48165bc1b915f2d62bb4a6a35ed,706,FALSE,1360,654,Dire
a5ee142f327a6b0ffb505658a6e202df,1023,FALSE,2308,1285,Radiant
25ba8fec8b077ccc557315a92558b173,1244,TRUE,2177,933,
b0ebc37d491e0f52e120219e68677f36,582,FALSE,2287,1705,
189864d459079271388afffdf60df205,1488,TRUE,1867,379,Radiant
4dcafcc6a0852e1066a9377816278db5,398,TRUE,4062,3664,Dire
b2e0e5cbec1bfe262889575728e109fe,549,TRUE,1597,1048,
05e283b7349acd4354b96c10b5c30b13,605,TRUE,2873,2268,Radiant
2e9c1371aeb7eddda2b125140f33d738,2875,TRUE,3255,380,Radiant
243289bf45f6cd0e48595c5c29ef28a7,978,FALSE,2301,1323,Dire
7b146bb79d3d34411300a1574ab00686,1210,TRUE,2269,1059,Radiant
78f420cc3b8036c66d1c082a1585ba19,1326,FALSE,1419,93,
bd046cd8decf98f18c1a3c21aaeffedf,168,FALSE,2473,2305,Dire
fbbf95023f82a068e87f4ee3fe29ee73,1260,TRUE,2067,807,Radiant
35f89f5c73766a85e88716a275d52294,1555,TRUE,2326,771,Radiant
1c2afafb516064faa4ce9b67b79691e2,1259,FALSE,2359,1100,Dire
71ed0b9006e41dd803b978bb0db9a112,1083,TRUE,1269,186,
62464320e06203502a5009be883a73f1,2301,TRUE,2557,256,
9596b7e77e0c63f446b39be423bffcee,1347,TRUE,2078,731,
d348aeed4cfe4c833c936d50c570ba6f,624,TRUE,1356,732,
6515a242e91eaddf43da6b4c975f17ea,1356,TRUE,1999,643,
bf5863266bb285c42a7d30449f19f343,865,FALSE,2044,1179,
e8a4a3f2e3ddcd5791dfc5a013431d86,344,FALSE,2417,2073,Dire
c7a8a2af320adfd58f8071ca0f9c6c40,563,FALSE,2601,2038,Dire
0e6bc9fb830eb8d49a94107a2cf8d398,3,FALSE,2473,2470,Radiant
0604e0e6f28c6bdb13efbde9eeafc992,195,TRUE,1972,1777,Radiant
b9c4ee9ccef78a7e35cc3e8f52012413,1770,TRUE,1929,159,
e4f437d422657c6937205a9485a91738,153,FALSE,2560,2407,Dire
db9664707e880d1ad0d2007aeaedd2e9,752,TRUE,1580,828,
931f737084338f0094ef7a7ec297cccf,597,TRUE,1893,1296,Radiant
5fe09d8fbfc143401eeec01262d5b929,1699,FALSE,2493,794,Dire
c54fc2dedf61b164dea17eabd1813cdb,2142,FALSE,2494,352,
7c985787998fa6a8dc5f9a4f812743f0,1869,FALSE,2135,266,Dire
5bae5692849031abcb7c85a64130ca6b,99,FALSE,1881,1782,Radiant
f53f3ec5d617d3675042b5fb609a7fef,821,FALSE,1367,546,
d25da40e67addae62b3a16a0286ce524,1352,TRUE,2787,1435,Radiant
8e88ea2eaef7f717c00ec2de9366362c,620,FALSE,1508,888,
194edefffd2a81736661a303213be554,210,TRUE,2463,2253,Radiant
2d3492970996434f8ef878c6b0c1cda2,2242,TRUE,2570,328,Radiant
618a713906d4010d1f4947e1be201991,1165,TRUE,1258,93,
38ccbd8db5164c0733c3294025da3491,834,FALSE,2809,1975,Dire
89d9cc3950a748173a4650f91b2581a2,1857,TRUE,2558,701,Radiant
fd64d8f7b801eeecc7526e7542f91d09,1410,FALSE,2275,865,Dire
52b1aa45775024a44c901f41af18b795,1787,TRUE,1834,47,
92a0dd7dbc5a8735007a74cb590cd501,1154,FALSE,2025,871,Dire
ea0b457eb7697ad983d9b487bb58e47d,1932,FALSE,2717,785,Dire
2b5a85d4a93af448644a98d8d33d1061,189,TRUE,1936,1747,Radiant
4ae6d0d3e70b10d9e1a80738ed05f649,868,TRUE,936,68,
e8e24be68c848894599d8378870ae618,2647,FALSE,2867,220,
c5cc58b7b4f5785076aa3f5bfc0d1da7,484,TRUE,1780,1296,
871c0e30bc1dea8a6a9906e3594e3839,975,TRUE,1918,943,Radiant
859fd313ff7b65b222d595e805290cfc,1548,FALSE,2416,868,Dire
550494a80b2cb5c0ffa238fc0138ea7e,446,TRUE,2401,1955,Radiant
bef3537929247486eec0c4eefa8de1f0,280,TRUE,3252,2972,
acdefb3cd96395533e3b814cd5635e83,273,FALSE,1702,1429,Dire
f8927ce53453ce016ea1cc1611fb3633,590,FALSE,3497,2907,Radiant
9ef8a8a2f44c2a8e1e89eaec1bfd9312,613,FALSE,1396,783,
16e8732254bd8534631f29b7323ea923,1089,TRUE,2235,1146,Radiant
4abc59bdd28ab362e5d1c5ef1aaf6036,173,FALSE,1549,1376,
8f81d768da266a095c75a5852111ee29,461,TRUE,925,464,Radiant
110edbaee0b58b24783596e8b9212541,1293,TRUE,3397,2104,Dire
e38992def6a91216224f435a0afc66cf,929,FALSE,1576,647,
597712d314c026f8051a690de06dcbab,2362,FALSE,2808,446,Radiant
73922b93dc560b330dde298160bb43eb,185,TRUE,1874,1689,Dire
7c040116f74e0c9e58f1d580f0121d17,668,TRUE,2304,1636,Radiant
f776dd7db85165798300f8874df34194,813,TRUE,2439,1626,Dire
d50d7716c5453722d11b098e963f508c,1281,TRUE,2807,1526,Radiant
f60de2c849f61eb892cb425ea3249859,576,TRUE,1888,1312,Radiant
a2f68a353decf0584adc7e89fa8fc991,1712,FALSE,1880,168,
311b4e9c491bf8e1eba6fe34bd4ccff0,2146,TRUE,2403,257,
d43ca7cc3f4d82aec38348aa04adcb64,1419,FALSE,2083,664,
f9fddaf9d5a50c0069fc8173b78ed71d,943,FALSE,2172,1229,Dire
ac3df0ac0b0d7f1171867cfff54d7d0b,1814,TRUE,2212,398,
b24f81d303fd7850964350af9adbcc58,287,FALSE,2823,2536,Radiant
9768edd3db82fd5824a9fe3252bea3dc,677,TRUE,1912,1235,
bde6e949c6d2e19e44d542b0a787eb5d,79,FALSE,2150,2071,Dire
2071f44ac01af4bef4b22443bc12b4cb,138,FALSE,1613,1475,Dire
71e8f64c91ff4c5e22452736ed954785,2301,FALSE,2462,161,Dire
119e863d1fbe223b95faf3d4c5059dac,62,TRUE,2243,2181,
7ef82965c9a6e323f30c857ad84cb61f,157,FALSE,1783,1626,Dire
38a8c1dc0658a515255df68d3466dae6,2141,FALSE,3488,1347,Dire
d3770d573ea3f0a29e1e42a47be7ab02,2023,FALSE,2822,799,
2d0ada18dc40f25ad42a8abfd2beb327,593,TRUE,2216,1623,Radiant
37418139046a3f5bd044383a4c16f343,2497,FALSE,2615,118,
e9e70edb0c823f1bb0f7ce2db6d8d2a0,186,TRUE,2524,2338,Dire
d1f7001395eeb8dd6372cb2dae22d2b4,357,TRUE,1956,1599,Dire
701309aab1ee5482d6a2611d5c7376a9,1129,TRUE,3020,1891,Dire
25a0be6d7c920793e582a66a0096cc2b,572,TRUE,2289,1717,Dire
106e9b622de339c462693a8f0472a942,670,TRUE,1550,880,
f4be2f86f50139732274538ad2a86c1f,1987,FALSE,3061,1074,Dire
199c4772a3c805455c6609f66b2d8a1a,803,FALSE,2131,1328,Dire
35b18791798f3aab4f73f8d343900216,12,TRUE,1226,1214,Radiant
aa096812d6d9c4db7ef3e05b775233c0,2327,TRUE,2385,58,
33151ef36ecb105973dc88cf5102b238,680,TRUE,1110,430,
ddf190a0a2b088e9042c01963d74b712,53,TRUE,2014,1961,Dire
9934857f8f52ff1825884f81eaf052f7,461,FALSE,1529,1068,
e957c6ad2fa5598c75666594ad932e1d,1295,FALSE,2220,925,
f702f72908d5fc488c41d17d516d53d9,1388,TRUE,2116,728,
8dfc47624011e3bc4292787b352d1ef1,913,FALSE,2890,1977,Radiant
c682721fa4a485512034e13c0d574209,1154,TRUE,2409,1255,Radiant
526ea0cbc1e7dad4fe8179760413497b,320,TRUE,1274,954,
f9b8a3dec534789f48433e7fbfc93d0f,181,FALSE,2831,2650,Dire
7b7c45d4b52a0657bab8617494c6a706,122,TRUE,2046,1924,Radiant
2ccf6ed30df166d3359f4976c35fc5f7,314,FALSE,1888,1574,
4f16302ff4824c3af4b5d928fb4b1d7e,1431,FALSE,1809,378,
f133d22542b6d6dd0751dc4303008733,1789,FALSE,2551,762,Radiant
d665a6b53db969ca7944e44f7be5e9df,2220,FALSE,2802,582,Dire
8b1b1c21544b6b6d72d73114c0f52a50,1944,FALSE,2818,874,Dire
9486c44835e2f8d326ca370aa1152ab9,495,TRUE,4034,3539,Dire
e8ff5e5b167eef8f9f36cfdcb06d68d5,1405,FALSE,2525,1120,Dire
0e7051b51df74c6283cd9b1c659359c9,275,FALSE,2204,1929,Dire
e76024edd96a3150e6b660c8de9730a8,253,TRUE,1622,1369,Radiant
41348662a6332f4270aeb07ceec41843,624,TRUE,1385,761,Radiant
a66f1c38b183f8df7407c7aab1853940,406,TRUE,1712,1306,
c02562653d5f8730c9bba9c16e7c892b,1435,TRUE,3076,1641,Dire
e056cbe4dada7be00b3d2eb04bf9f851,1933,FALSE,2278,345,
a56862449892cd89646e867e1e29e3a0,808,TRUE,2141,1333,Radiant
ddd94185395a0909cc4260d41f5cf9e1,300,TRUE,1867,1567,Radiant
589fe5dbde6db5ccafd38d625b373150,1135,FALSE,1933,798,
a8ee32c05a0571f94683874c35150c6d,727,FALSE,2466,1739,Dire
2380d938ace7dedbd39485ce9c3f8bac,1488,TRUE,1843,355,Radiant
0735fd835758eb868afb000ccf2634f0,731,FALSE,1767,1036,
7f572bc73860e31e15a6287c11e6ff8e,1396,TRUE,2188,792,
9f11bda96640b949f0e6496592a8a22c,1089,TRUE,2837,1748,Radiant
6498e1b158e71caf014c2c299c028054,1152,TRUE,3580,2428,Dire
b3cdd195d9c644e0fe6f5d3409346032,288,TRUE,1948,1660,Radiant
6989193923422a9f150c236f2e2b981b,1418,TRUE,2165,747,Radiant
abd8a8aebb8b28c6d357f157874eba3d,74,TRUE,2513,2439,Dire
da11dd01e6f3fdde42f8b5b21b505d4f,375,FALSE,2192,1817,
271dca0a2d841d22b7aa1689c66e8ef1,279,TRUE,1785,1506,Dire
93292e8d4a088c1cf1591666868c0a98,563,TRUE,1919,1356,Radiant
55718c79c1111cb21b739304f28b029f,1187,TRUE,1881,694,
f7d7a1e5c22003f30b21930535f5c770,1227,TRUE,2024,797,
58233064afaa6aaebda42657b33bd3ad,1514,FALSE,3300,1786,Radiant
9636a78064f1ebcbab75bb5426d5e526,1242,TRUE,1327,85,
654a129ab1574a0009f3c4e817b63c8d,2101,TRUE,2672,571,Radiant
08d099411b26e233d1fccff7b041051a,2382,FALSE,2523,141,
15d81247bcb7898bdec72a4acc5fd9e7,631,TRUE,2139,1508,Radiant
7adbd179868853d2b34fdee79742fcf6,1838,TRUE,2047,209,
772678aff96fe2e1d2c343347f8a6c2f,208,FALSE,2485,2277,
85e4712023214d59c7443d2a27db8268,241,FALSE,1711,1470,Dire
7f2b663c4fa0e78ae79b03a7a1a3d2c7,1026,TRUE,2277,1251,
e91b7828199f546eae929c89a500e9c6,1076,TRUE,3190,2114,Radiant
1220794eddf77f3bea88b89efd7e706d,1696,FALSE,2134,438,
aa94e43d80c223b66ff54a93efa1a2ad,1402,TRUE,1593,191,
64fa6454c581e4234f5009d39878c33b,2027,FALSE,2396,369,Dire
efdcbdd807b47da12299e229ace4b57e,1062,FALSE,2210,1148,Dire
6c26395a57bb9437217ebea8f193276b,1804,FALSE,2956,1152,Radiant
806dcf753090ddabce9fa5a7d6155a45,1398,TRUE,3162,1764,Radiant
5d013e7b21648385dfe6639c8e5e9c79,1009,TRUE,1566,557,
79d6ee2e14d0883f509a9a4c6c1d4475,1019,FALSE,2552,1533,Dire
d57b29ae84f3a5da20c82705e166ae8c,657,FALSE,1994,1337,Dire
9f78216192e159379a7c0c5c99b31d82,1244,FALSE,1961,717,Dire
8457e0f09e9f7bcc280709c2e4916b2e,127,FALSE,2577,2450,
3e1bc39ca6d819702d021e720a4f450b,2528,TRUE,2869,341,
a8d3a35baf8c5c64952296e53ebe6941,1539,TRUE,2302,763,Radiant
1bc737046017cfaa0c6122a142428d8e,407,FALSE,1876,1469,
22988d83c6aa93561e1ef6140a2eaf63,2300,TRUE,2803,503,Radiant
9d55f7d83ef9c44b08be3bd7374f4f6b,1668,FALSE,2375,707,
ad8b86d6b9752951c476d9f9e90601ec,1461,FALSE,3904,2443,Dire
01643def8f3a39f81b31015ffa106c49,328,FALSE,2386,2058,Dire
d3737c9ff514bf4ae9040c6b315b4cbc,1120,TRUE,1352,232,
fc813296d4c89d3446208eb1b40ec951,85,TRUE,2164,2079,Dire
f77eb35e5d56ae56ab70884694c88b89,121,FALSE,2540,2419,Radiant
022324c8bc6528ee6bf6c6aa00c94d6f,2513,FALSE,2753,240,
1280b8ea794161b5a6d253bd18004485,1587,FALSE,2177,590,Dire
732d4101fd0452e663a18b1f3cf68609,1715,FALSE,1881,166,Dire
892d3d2b05704ff6a0e5a5ad666db65f,2651,FALSE,2703,52,
0971a77a89d142885389553cec89b281,651,FALSE,3358,2707,Radiant
b6abfd82111c4b1efff4f94810ec6171,491,TRUE,1958,1467,Radiant
f871c65f761fdbfc91d820e0ab111b1b,760,FALSE,2403,1643,Dire
d22de85cd56fb1d45d06c8b257727532,1815,FALSE,1987,172,
a66bb4a2a30053a3761b7be034369bf6,186,FALSE,2101,1915,Dire
4eeb0c012b1a0e4bc72a4bf9a1c2d274,169,TRUE,1690,1521,Radiant
f228c7c3e20474aa34f2ad2d0fc8c8be,350,FALSE,1967,1617,Dire
e3ef50c7b0cd915be3820c26c9113fe1,1581,TRUE,1753,172,
a6f0859d5ac975f14b9d6a229b76c265,1546,FALSE,1873,327,
b50701b239488b83f38326c876349659,169,TRUE,2129,1960,
787dd088994340451e88c7d8d08c95a8,2159,FALSE,2455,296,Dire
daec9ef35f45699c0df7210b197f9183,237,TRUE,1615,1378,Radiant
5ee3085fba25b791c8ad97293118d82f,237,TRUE,1385,1148,Radiant
88b5c36140e4e23e421db98c4e4f2192,471,TRUE,2221,1750,Dire
7b1e3babb273c09564f283d564497fef,2322,FALSE,3115,793,Radiant
61a322e9ee469b681428615dd94fe7f1,457,TRUE,2937,2480,Radiant
55ba322ae3781c2692057bc685338726,780,FALSE,2581,1801,Dire
bbe5753dd065372aa4e9d9c56ff73300,2,FALSE,1614,1612,Dire
b1a78eb3d2ae7b1e8d8c36e0d0cb3fe8,1040,FALSE,2728,1688,Radiant
398b93f7573c8605803493a5e53c2781,1820,TRUE,2439,619,
1cf58a375699b65a0aed3e1eaa892efe,525,FALSE,2190,1665,Dire
144ec2e04c5f6be806357cfb0d04c4c0,2393,FALSE,2877,484,Dire
a580ea0fc84b8cba6807cd2111aa1ca2,1798,TRUE,3324,1526,
05f8010b1b1a1a8c132a9a60e676b877,188,FALSE,3101,2913,Dire
d970cd3de2c14c13918012de112bd4bb,365,FALSE,1946,1581,Dire
bd0f4c21991bf840e3211dd7a307d129,548,FALSE,2565,2017,Dire
7062cc98c3ceb1e70dee545542587477,1822,TRUE,2790,968,Radiant
447efe064b43ee2ed2a357112c6f96c2,2558,TRUE,2669,111,Radiant
2dcfd0d52a1a029f232b539b2de31764,162,FALSE,1736,1574,
eccf217f1ce91a8babfa4e459deca694,986,FALSE,1142,156,Radiant
f326deb2b4d194e2a0bd7074d63f1a2d,855,FALSE,2810,1955,Radiant
707912203308f7ba6e0c69d7f665d930,1718,TRUE,2885,1167,Radiant
8d3f53ffdd6ff598e98c513df90da7b9,4427,FALSE,4767,340,Dire
a6c33e181e48cf335d7abbeb503b9940,1691,TRUE,1861,170,
5da2540850cf737609c501416fd9d39d,351,TRUE,3005,2654,Dire
b15abc2f6d41e36b0d403b07377f4dce,609,TRUE,1377,768,
5ac3800fd01f06156ce6fb15ce7ae0b1,1279,FALSE,2640,1361,Radiant
b27680bc065af59ceb41f00bff76ece7,1470,TRUE,1811,341,
e1dae0c576d2317f88e3203985d8f4ad,1103,FALSE,2315,1212,Dire
1404531ed534ff555febde1d1729bb5e,918,TRUE,1072,154,Radiant
1c04009a17db725fc7c5c57810c3e1d8,833,FALSE,2846,2013,Dire
b27377d9afa1cf480b953613ccc32f7a,75,FALSE,2526,2451,Radiant
50dfd78c5b1a64441fb2f1a37db7f2b4,1836,FALSE,2496,660,Radiant
1df548ee60b655b9c97b080dcf5c86a4,2140,TRUE,2998,858,Radiant
894d81416101cd03d0ad602b428ad4de,802,TRUE,1770,968,
aad2d8284018c44751544840f4056ccc,1315,FALSE,2040,725,
c96367aa99e054686ee485ff68ed7575,890,FALSE,1280,390,Dire
1eec060b9f1905f99afd51e845737d53,1030,TRUE,2268,1238,Radiant
740f786f51304291689de1c68f7efbb0,1837,FALSE,3877,2040,Radiant
be7a77d5ad1c028c76090f69d1fe1241,446,TRUE,1086,640,
5225ba7e498492a5c838e102fe08889b,16,FALSE,2212,2196,Dire
76a0601a462706a155728634b8c4f3fa,1775,TRUE,1835,60,
bb5836e44ad14c97a77ff800de17cbed,2320,FALSE,2865,545,Dire
9c846b2f69f023bf6698521acd75f675,928,FALSE,1975,1047,Dire
058e6927564b04aa2df17f25ed40d463,336,FALSE,2095,1759,Dire
1bd37d8009db5c24ce82699b87e938de,1404,TRUE,2170,766,Radiant
469e6d30be18ac9c6d592daae3b74557,1097,TRUE,2582,1485,Dire
2b4f871b18bc6b003d230de024258702,1370,FALSE,2105,735,Dire
b89df272f383c3f45e8302599c4ed998,67,TRUE,1502,1435,Radiant
cb5c85a6300f19f149dad9f8a0c6c21d,638,FALSE,2597,1959,Dire
b7e1a45d0580db7a14820580cbfd5863,1434,TRUE,2100,666,
482eaedd3a3887255363eb355ca3f377,1435,TRUE,2337,902,Radiant
634ea73a02f7dd983a5db3b5e9c12872,367,TRUE,2242,1875,Dire
9aba7d8b83af15b94fb7d8ee4d8ae6ac,1092,TRUE,1980,888,Radiant
70b8c998fac61d5c1d56ba2612b3f975,150,TRUE,1112,962,Radiant
6df64d56c8fd77b5599ede25852e3d29,540,TRUE,1602,1062,
1cf2a6837f1eb3396b0da4bdec0288ea,973,TRUE,2776,1803,Dire
bc8a92192e7f06924a8640a9d019a86d,236,FALSE,2365,2129,
8f7f2de1c9443af5752a74a887dd5c64,1225,FALSE,1403,178,
24af6cd3c128a389735a7443a86bc9ed,410,FALSE,2030,1620,
9ff48edcdcc43b36b9e235e89655ee1c,366,TRUE,1962,1596,
4f526e4ba118cd4aa64e203dc20b2394,489,FALSE,2608,2119,Radiant
d54e921a92261004042dabdbcb30ea53,665,TRUE,3242,2577,Dire
8909ab1449b495bbfe5728638bf0da86,2030,FALSE,2507,477,Dire
abae517733ea0f60914ca91b5b961a87,1503,TRUE,2802,1299,Radiant
2454ab97ae54f068c951381c5bb9a471,126,TRUE,2182,2056,
7252cadfedee5e2ca053914ec3f91602,1134,FALSE,2354,1220,Dire
d80f2b31c45c012b7787816f5510590b,1997,FALSE,2336,339,
2abd9575bda0323588fe702dbca2d48c,534,TRUE,2443,1909,
4128c314374d4ebb9ba6dc26da91640e,454,FALSE,2134,1680,
1c3fdca8836e355fd4b3d65007792640,1225,FALSE,3796,2571,Dire
eddf3c4a6239ea76ce9c511eddc7e2b0,1377,TRUE,2403,1026,Radiant
601bedfe1936836911aacf2199a8b49f,1389,TRUE,2111,722,
927b0632eb0b7fe841f6884af859a641,274,FALSE,2403,2129,Dire
57833ff770029565639149800eb02901,668,FALSE,2043,1375,Dire
83ea64bd060a72e06d3eada901cf4d49,581,FALSE,3138,2557,Radiant
572f7007d77900b0060a4fdfdd8f641f,984,FALSE,3499,2515,Dire
cc2f3df7e13e14ac0e097894b18bd820,479,FALSE,2968,2489,Dire
2760f13afaa1f369178a7508f8919631,1171,TRUE,2266,1095,Radiant
15e40db32b9c862be415a1b5e2f7a11a,1264,TRUE,2241,977,Dire
1c00d9cd21906ca76e2b4aa0293cf09f,2152,TRUE,2201,49,
1250d8e3fa9070bd43ad3e6ca7a949ce,265,TRUE,2334,2069,Radiant
d8c05f21dd31761722ff181b29f60772,793,TRUE,2527,1734,Radiant
ee01d7664dcdcf11f245b33b25ee71db,2255,FALSE,3336,1081,Radiant
a70c696cae2a360c494f0370fee85185,1080,FALSE,2306,1226,Dire
7d9f712f2d834c2642276c2b57aebdf4,1488,TRUE,2125,637,Radiant
243daf8a736dc08a6167043f571e58a5,1812,FALSE,2246,434,
204b34f47dc9408a793eea71758cdca2,926,TRUE,1750,824,
07b8ed43bb1e6b2bac8acaec5520fe7b,2080,TRUE,2234,154,Radiant
5083fd3a9a0ecba2ff7655f06ea41f6e,616,TRUE,1286,670,
6297ab703233541cc953aca1d440d9fa,2724,FALSE,3511,787,Dire
2c9a3fdee182b8f6a9944f0e0ed85477,1933,TRUE,2151,218,Radiant
f346f533f080bcfd207bce7919d72f8d,1745,TRUE,2550,805,Radiant
9922f8c35289fa28803743a182c21ec5,1958,TRUE,3317,1359,Dire
3afa8853beeda0ade7a1646c80f09cde,296,FALSE,3363,3067,Radiant
e684aa0b5b759887c427494396cbfdcc,211,TRUE,1801,1590,
6f19df662729f4f6ea1f0e73737edf27,1423,FALSE,3704,2281,Dire
fc9e3c3c31b9f87842d64cd831427562,590,TRUE,2098,1508,Radiant
86c67d3be6d4c84602c6ba6859710a7d,2456,FALSE,2610,154,
93954c862d5ec2ef52110add3655119a,800,FALSE,2961,2161,Dire
c331671e7382a5bfa54f3b46bde5c459,550,FALSE,3119,2569,Dire
e9142746e61f6ff4dc6ab6bd0b0dfe48,540,FALSE,1950,1410,Dire
7e59da16ceba53efdc97c9b9932ddd07,112,TRUE,1113,1001,
c34040f399bd6b30a5526bff3a0a7056,1461,TRUE,3340,1879,Dire
94cc732221dd449cfbea5c60bf51d102,1803,FALSE,3928,2125,Dire
679943e9efbb533e6a9403535d0a99bc,1554,FALSE,1694,140,
cb12d46bc08c34e0ff4499c4bc759f42,950,FALSE,1066,116,
5178e23a496b7a51db8522fe6a4f9e94,307,FALSE,2280,1973,Dire
71a798042f9068381d271cfc64bdddfb,1584,FALSE,3149,1565,Dire
359bd9f9af1ddfc7bed8918802c771c1,1560,FALSE,2315,755,
1eb4e6dc0cd3f03229bf19f47294598b,470,TRUE,1065,595,
f5782188e823a9c2f6e2685c69c04e6b,1641,TRUE,2201,560,
320671f467a0e47c36ca7478b9047ea2,260,TRUE,1295,1035,
3240bd94962812f4ea668a6df508c58c,2207,TRUE,2873,666,Dire
e0285651bfddd8e9ffb75d09ad95380f,1363,TRUE,3001,1638,Radiant
9caa020ce9ad314e3c4d599d54b360a0,1714,TRUE,1771,57,
4f185aa3784ead3d4c2cdf6d361fc8d8,1392,TRUE,2099,707,Radiant
8e93b9da5390a01b7005bf36fc8ab98f,778,TRUE,1947,1169,
88134588beec1417b7664d99722ef6fa,46,TRUE,2066,2020,Radiant
4eecac3ab6f7182b9baf716f6c9c145e,1063,FALSE,2034,971,Dire
64ae4f8227d23fc779fa68aaecd44e46,632,FALSE,2367,1735,Radiant
32c5a9eb961cea33ed95b771c2f59053,1325,TRUE,1921,596,
c87b0f00ffd1990df6ecc436b2ba1daa,995,TRUE,1382,387,Radiant
cff2d552e0d15b1b04d4377fdc7c205d,1606,FALSE,3250,1644,Radiant
346a625940829544ab84670f6ee60e64,1459,FALSE,1916,457,
358fdff84d9aaff561ca367bc1d256d2,2208,FALSE,2344,136,Dire
bc17e71e4a0d7e6d7d0286437652b3f6,871,FALSE,3077,2206,
cc72a2b6d26e10944b014c1bf14b838e,132,TRUE,2177,2045,Radiant
186eaede665a7809db560024210e6fd1,212,FALSE,1538,1326,
bfd19a1a572f3f1e76e9eb10c74ea789,1418,FALSE,1617,199,
91d64d4beaaf79ca3144fa8c2c4edd7c,255,TRUE,2767,2512,Radiant
6b9776737464b9df40c88e77080b795e,3698,TRUE,4346,648,Dire
110394bc91bf13271549189e878fa043,1789,FALSE,2215,426,Dire
334704e67106d586c069bfb407241a2c,1180,FALSE,2065,885,Dire
d84ffbe026ff4d5b2bfb2713eda3ee09,263,TRUE,2582,2319,Radiant
9029c15db15a669bb86e0b36cadb384f,516,TRUE,3300,2784,Dire
6f8bbb07d26e310e8ca5ab1988b4d7ce,548,TRUE,1329,781,
0094f56cb27346c947404f609bb04b81,43,FALSE,2752,2709,Dire
37564d5ec4d2474e669bcbffc2fc0b1a,1132,FALSE,3402,2270,Radiant
84146d453d094189ed8c569ddb9f6bda,309,TRUE,1892,1583,Radiant
0db1a4c38a8ffda2b0d1662c4b78b416,1699,FALSE,3238,1539,Dire
8a9f567738616bebbdd3a2bd01b71560,597,FALSE,2597,2000,Dire
5a1d5a2037a3f848bf986e48eb3ccc91,1463,TRUE,2240,777,Radiant
c7df33016245163e0b1c7a3680cc5b32,1391,FALSE,1639,248,
bb5e756fe0a1559db42e5038e7d4153b,503,TRUE,2251,1748,
402f865985d9ef9319a3b230c0e319ca,3192,TRUE,3358,166,
5b27aa5f943c04b204fe5f98fff82756,721,TRUE,1113,392,
9ad9b4a9728722ae5d749c705f50d86f,1529,FALSE,2507,978,Dire
1fbe04080b5bfe890843a0c57acedf6b,1027,FALSE,1353,326,Dire
9be50b9fed16927d957b47f88c21dddf,280,FALSE,1527,1247,
5d3f14970635c6acaf27432b8bb13918,568,FALSE,1217,649,Dire
41628d699d67cd2cb365b9722276b8a5,1331,TRUE,2190,859,Radiant
dcc4050522ddd128c9ad8b32cf41c8a2,1490,TRUE,1638,148,
6305ac26d0fc4e405221c92ae813ac0d,1229,TRUE,2413,1184,Radiant
2a2a789188074c88d8b3fdf071545b26,1886,TRUE,2531,645,
a7ddebbd05e46184b11f8e69a773ab14,136,TRUE,1516,1380,
5b2e4d1fd4f812cbc856c08d92c9ee77,1503,FALSE,4608,3105,Radiant
2a7750ec7e0a95ea96a761bc9cb63b77,1072,TRUE,3350,2278,Radiant
3a7ec7526368a81d4d437ac9f80765e0,329,TRUE,1944,1615,Radiant
c81e9ecc73db38d76a63ef050a4ddf49,252,FALSE,2022,1770,Dire
3b1611c7851741885cda63a4ccac6e28,663,TRUE,2219,1556,Radiant
6deca05f6d94d15f32fbca2043a95650,11,FALSE,1530,1519,
6692b61512062ff63413c5132b048346,2928,FALSE,3019,91,
8a64aeb4e9de55f9c8fa8d9b66a20f36,159,TRUE,2956,2797,Radiant
c8ebba87d0fe91f84feb93b09402d381,766,FALSE,1360,594,
0431a153e31a1db00caa72431a12d831,1282,TRUE,3104,1822,Radiant
f402db8cb1b39ef6b7a2a95c9c8ef9f8,1251,FALSE,2157,906,Radiant
374a3f98d1d883352086118c2efb2082,1214,FALSE,1826,612,Dire
60aecc284b9e2cda8910b069fdfdc7ed,1558,FALSE,2029,471,
3341cefbfaaa47cdcd7fa1b4ef66c678,933,TRUE,1738,805,
fff8117e45340af82a45a9902461626c,937,TRUE,2604,1667,Radiant
ee021c1f4a4862d0b1640ce88b478c0e,866,FALSE,2129,1263,
f201205dbcef5557669d441e1950bf9c,2404,FALSE,2687,283,
7a753d0559505f45538092bd7c9c3d8d,803,TRUE,2197,1394,Radiant
6fd3674a9c0b0ac825c2f39d91ceccbb,599,FALSE,2726,2127,Radiant
b197539cf74ca36e734e06d76b62a889,66,TRUE,1434,1368,Radiant
d330fd7818b126cc9945bcd9d65bc4f2,2262,FALSE,2453,191,Dire
36ec38d5a5010b93d1d388b61a4cd997,2431,TRUE,2723,292,
4b44f51b97a9ba97c509afec1fc71c45,2781,TRUE,2955,174,Radiant
8b503b6aeefdd5925bf3ab106295d15e,1349,FALSE,2457,1108,Dire
60e317e6ba4e01e6f53731b14f044370,1589,FALSE,2772,1183,Dire
1042f49c4b46402819fdd7ae94a7d04d,792,TRUE,3082,2290,Radiant
8922eb8e3c066bded9de197e913af171,2775,TRUE,3400,625,Radiant
e23464cfa39837d18ce3c31f8eaedff9,1434,FALSE,1554,120,
1ab8751baaee019ef3612500b469802b,285,FALSE,1921,1636,
76ddddbeb8c8ba5a4eb1d752f0c1c362,766,TRUE,1921,1155,Radiant
3544a8722eaa6151b2c7a46f948d6054,1483,TRUE,2896,1413,Radiant
abb3c21f7c517d5ffafe390c52e2d79c,1603,FALSE,3253,1650,Radiant
fac65d53295e00d9d49c3a6054baeb0e,1316,FALSE,3057,1741,Radiant
a74db9448cf0f53c1624a90df5b569b6,1422,FALSE,1768,346,
9bedde4613e905a6e1c14d50f4ddf10c,429,FALSE,2845,2416,Dire
0b674599170f6112789a91d932ade5e1,1556,TRUE,2135,579,Radiant
0c90713b5b9dfa7484a5b847890ff609,12,TRUE,1867,1855,Radiant
b3e03bd08665fb0d3e0b8d9edef310f9,494,FALSE,1399,905,
f32c1ee85ee8b45023e2b79f66982bf0,2307,TRUE,2384,77,
7c000ac8817cc5fa9377234ca69c5d18,1555,FALSE,1929,374,Dire
37468662b27f784aa8071840f87d0aea,282,FALSE,2339,2057,Radiant
ed3b4421bbd9bfc1faf5b1036adbfabc,1705,TRUE,2607,902,Radiant
ecb91ad3a8d6ff34d259821d6ed52a18,2214,FALSE,3656,1442,Radiant
ab33117937a6ba82eeb2890021140efa,727,TRUE,1934,1207,Radiant
88359a9017de7f575af344940bfc3398,1829,TRUE,2282,453,
f1443f046a40861480bbdb4e953fd9ea,58,TRUE,1575,1517,Radiant
f4a15a105cf2d742f64ad8f35d971293,747,FALSE,1973,1226,Radiant
9a073510160b2f1fe426f0a6f97357da,2228,FALSE,3090,862,Radiant
51e1bff13fd2674d7e7b671b81d462c2,2043,FALSE,2859,816,Dire
77c679c19c4f986484f1d4dfd28e1347,932,TRUE,2477,1545,Radiant
762f6d2329dfc2954ad862550b1cbff3,455,FALSE,1931,1476,Dire
ab8027a962b59e0fb1bd5c0337ba49a8,1314,FALSE,2627,1313,Dire
b3eccc1bb24b1e4143d26540646f4482,1874,TRUE,2679,805,Dire
825028fe957585d8aac7e6b4b36d3fda,26,TRUE,2059,2033,
62ed534a7108986143bec4f086de049b,2130,FALSE,2278,148,
062f227a74086a4aee9f0ea69873a7d1,736,TRUE,2051,1315,Radiant
e540e0a407aab9b11df82a634a0c5322,92,FALSE,1215,1123,
de2eaf16de8cc6c64741dcece9c757fb,1764,FALSE,2059,295,Radiant
c02c84b0301a1bc0be922da670b49838,1002,TRUE,1900,898,Dire
23acbf0e3aab2b3356f3854448b553e1,1534,TRUE,2508,974,
a2467fd37c7baba55f02752892b3010d,60,TRUE,3882,3822,Radiant
5a008fd49716e393d840edddb7b37246,2012,FALSE,2638,626,Dire
45875abc7f106deeea20bf8aa8bc8f50,2739,TRUE,2782,43,
75295670cf68d4ef4a7dc377bf9a2a3b,2144,TRUE,3105,961,Dire
8cce601ebdb8651754c0987a7e84393a,1867,TRUE,2030,163,
fea7faee98fb7376d8ae25cca7f7955e,366,FALSE,1397,1031,Dire
e54f35656c22d0248d1402bc5bd177ce,618,FALSE,2391,1773,Dire
37cc73f5ff369653bfed87e622e7d938,820,TRUE,901,81,
41aad6d97f4cc631222f3efbd572a32b,1176,TRUE,2095,919,Radiant
248d9b37531aba293e7a4ab7fd1fa10c,1415,FALSE,1632,217,
56d9d54c78a2bb38a5f4807c2904ba4a,259,FALSE,2780,2521,Radiant
8c197a82ee4bdbb5f4f5b16f116d5150,109,FALSE,3320,3211,Dire
8da045035efde177bfcb2fe9cd631715,861,FALSE,2480,1619,
55e284fb3d637ab0eb21c1aee9b1e341,1564,FALSE,1619,55,
d9a81ccfd1c9b7eb70e41235b2ffb3c4,2416,FALSE,3227,811,Radiant
679ad0c8e39b27c024cb1bbf5bc20f63,1601,TRUE,2201,600,Radiant
b660b98311ffc8327298ddcfdd9fbf37,2111,TRUE,2177,66,
da0b02e11a23210fdee66ad203d91f71,1761,FALSE,1853,92,
ae7f1f44e9d76ac74156ba6a7af7518a,458,FALSE,2798,2340,Dire
9eac9efd833c50c020136f17df932c9c,2237,FALSE,2988,751,
65cbd10b925b1b51bbe33dcc3e0eecd5,1989,TRUE,3163,1174,Radiant
6ad2a36b57bb7f4d91c4c2b9f3ff80fe,375,TRUE,2098,1723,Dire
8bf3145637447511f8e95e88648640f8,1885,TRUE,2937,1052,Radiant
acd3ea3b24e717cc5a11ee6880eab203,2162,FALSE,3330,1168,Radiant
736ebb21bd60d5a89dff18eade61c725,461,FALSE,3141,2680,Radiant
0c912d2d471ef4de5fa01ad98f59b31f,1112,TRUE,1458,346,Radiant
f426466cfcc5097a91aab4e0207eea96,227,FALSE,1893,1666,
5fa8b5fa9a55015d4da871e80e45c4ca,893,TRUE,2360,1467,
56012e19e7e662fc51202c294b1b02bb,927,TRUE,1595,668,
66fdc269438ae8805fb0eb3a509244a5,890,TRUE,1581,691,
f7908590eab044258a24eddddd5a73a2,99,TRUE,937,838,Radiant
d71075ec8d3a068bd9e8c6f870c5cfa0,209,FALSE,2447,2238,Dire
11f8ab7c2485ee52e6231cb1e60463b7,294,FALSE,1973,1679,Dire
421857cc9682acdff56743f2529d34bc,93,FALSE,2167,2074,
c236f926bd9706aacb6eb6124f6618a3,633,FALSE,1663,1030,
c54ed355fe3f64564c0edc124cc33ff6,285,TRUE,2915,2630,Radiant
b0498f33737ad355b8b9036d037b7bb3,1629,TRUE,2223,594,
471a6022cf5278a8b7015da0973ba578,1058,FALSE,3069,2011,Dire
434e5c199b1bfef46b354d1a7adbecad,1530,TRUE,3178,1648,Dire
7620b04421b0232cb6f5f96584e234ab,2528,FALSE,3015,487,
3b01b255c9c72b618992b63288436e39,1567,TRUE,2881,1314,Dire
9e31312d3fb51ea1f26490c4f4a7ed90,1974,TRUE,2521,547,
ae0f4344aa77f3e279949892e4f0559b,2284,FALSE,2984,700,Radiant
326ce322f354de8907799449d7d9614c,356,TRUE,1595,1239,Dire
1012b41b5f08ae3e7325d8603cc55081,1511,TRUE,2458,947,
7b1b44160d9c81e88f8910d93f0cb62f,1995,TRUE,2089,94,
08e1e7a50d45e61552c01eba31a4bc63,2133,TRUE,2179,46,
3b094e29d2ca77ccb322e1512b088a28,497,TRUE,3128,2631,Dire
2b91b3c392b08c62b0a0ed30cd077191,610,FALSE,2526,1916,Dire
24f77ac07054c11828a2e907e84ed035,1090,TRUE,1714,624,
84f9fb0d3efa3a32dc96231d7ffd0b35,486,FALSE,3026,2540,Dire
18498737e3c0b87d5c3674cb9cffec8e,1218,FALSE,1692,474,
be02b2eea00c4757f90b8ddd4e95c06d,1055,TRUE,3390,2335,Radiant
62852637a2a75ea9b5b2acf0a55d12b5,1264,TRUE,2053,789,
ac7c46b92b4fd7f2022c83870a3d705f,1383,TRUE,1553,170,
fc4712f1b569634ac7ae4b314dab27a1,382,FALSE,1306,924,Dire
be75ca7b0f9a59ebe83d7c7dc853730b,92,TRUE,2035,1943,Dire
3ad4100b7fcda18375217c9573a9c0d9,1310,TRUE,2188,878,
ed26d37c3c0421ced45c186b2332dc00,2723,FALSE,2762,39,
23498535d45371748802009cdea88735,1755,FALSE,2045,290,
0bf2ffa13a4dfeb4b0330c67af39b7bf,964,FALSE,2165,1201,Dire
900f26948b704cf5c624c42b362ef87e,2649,TRUE,2792,143,
aa1baf07c6a7787a0c8f0b8d23950eb9,537,FALSE,2561,2024,Radiant
d7dd5777628ab6473d08fe923975aa09,904,FALSE,2691,1787,Dire
8c96ffd5a780ad35c95b4d11cba6d87b,1199,TRUE,2799,1600,Radiant
6ccca1dd0ffae93d2bd152695e67068d,1239,FALSE,2553,1314,Dire
1e0b52058c26d1427ce80b90bbeeb3d1,554,TRUE,3069,2515,Radiant
1c34a8420916f64314e32110f260c7a2,359,FALSE,1491,1132,
0703e1b088ea87304808976401db0955,1729,TRUE,1896,167,
aefbfe3ce97904c5b527d8c71338ed0f,1533,FALSE,2369,836,Dire
6b1443f080fcf9d1d8831c3afed08136,642,FALSE,2440,1798,Radiant
6a00e6968173f58b78ede59c180e02e2,828,TRUE,1048,220,
1551ea88324bf790c4f86d1e0b02a0df,1628,TRUE,2549,921,Dire
e1b26b985612fecff74310d8325bfe9a,905,TRUE,1710,805,Radiant
f7c764e1cf233030644c02c92051288a,1120,TRUE,1920,800,Radiant
da715e4c0d0f82601ff270e721e14f08,653,FALSE,2482,1829,Dire
768a9e536a1984c600e59cecabf2fece,222,TRUE,1552,1330,
6e8259a173f58a9b1135d7c413470965,613,TRUE,1887,1274,Radiant
11c507b0ad2db826088e7674ebbc058c,622,TRUE,1667,1045,
b3a8521db5fefbda51d2ab81e7a7efc8,3728,TRUE,3810,82,
5fffb527516724f4802af03a8cde8d6f,605,TRUE,1383,778,Radiant
38fe9a2424e976928e9562382210ed9a,1122,TRUE,1621,499,
66126bfbec88190adc17276f0780c8f1,438,TRUE,1643,1205,
d96af2372a1db62c85769835eb05ebba,1363,TRUE,2458,1095,Radiant
2027d3f984d085f098e9b6bcaf7629b9,2134,FALSE,2171,37,
84d35e0d555f296ae8a9435fe1073457,24,TRUE,3188,3164,Radiant
87df97360193b327e830743c4d148feb,1317,FALSE,2790,1473,Dire
f613f9f69e5aabe44658a5270ad05590,1224,FALSE,2963,1739,Dire
49d3c308af8dd2cf6ee0ea6bedde9fcb,1747,FALSE,2837,1090,Dire
2f39aeb77639f49187a92682078312c4,1346,TRUE,2827,1481,Dire
3271d3fa12f71168fffd2a72487a4f0b,3000,TRUE,3387,387,Radiant
ca7ba8801083b68aca43072e276090a3,1657,FALSE,3586,1929,Dire
eb7f75a38a352cfae5d4aaedfcfcca34,788,TRUE,1954,1166,Radiant
c56c066de9a755dedd57a19617573ae1,673,FALSE,2284,1611,Dire
3ae9f8909207dbe47845a5b7bf3c3c10,824,TRUE,1592,768,
8eaf7169439ead49525d26411fa70905,765,FALSE,2767,2002,Dire
02cb4341ad1f536a8b16050f5aad69ae,330,FALSE,2916,2586,Dire
5bff7b7269b6f3819ff016d8b6a8ffce,2366,TRUE,4096,1730,Radiant
23b5eb4a53f81244343a19629559f42e,1667,TRUE,2520,853,Radiant
554eae852afb9c157dfae204a4fe9e4c,1370,TRUE,2226,856,Dire
f97fa0294a0b3e107cc88e6317a8a3fe,1028,TRUE,2248,1220,Radiant
1133f39ca423ae08efdba7c38f1bbcd7,913,TRUE,2879,1966,Radiant
02531f66a3442a9d117ab1ee995ddb3a,1790,TRUE,2636,846,Radiant
1a0872f20a449fce45d8ec3108b26aa3,1438,TRUE,2616,1178,Radiant
19c8d7bb9bfbcfe6c2b8b125a461ed27,1792,FALSE,2976,1184,Radiant
3511d0da0cb99a2c7b3b6b0b03b1ab81,998,FALSE,1653,655,
ea63afd57b930df17b07ea5a2accb032,1741,TRUE,1790,49,
aa943a7e1ba85d7ef7231d1925b7bbe3,1806,FALSE,2495,689,
795381c86af03ff68dbda78a6b5ddcf2,1822,FALSE,2484,662,Dire
4eba2397a500d8c873d5172409277122,1688,FALSE,2149,461,
8a8b070411c8d6475adfd6ff76ff3031,362,FALSE,1994,1632,Radiant
e287d04b85a06fcb68bf0a17dad64311,616,FALSE,2168,1552,Dire
f0a63bc635f6153d4e6a70156009ee77,318,TRUE,2408,2090,Radiant
0e60704e9a84a12f0c12c283b95625ba,897,TRUE,1679,782,
9eda5a592324aaba51e8317d741c49c6,2879,TRUE,3504,625,Radiant
072289d3a52d080304cc28c477151345,517,FALSE,1902,1385,
92feadf3604719dae97993da8d74f932,1932,TRUE,2848,916,Radiant
2547f8b2eca082de2b140bff8a6c595d,339,FALSE,2530,2191,Dire
d51949d0f76d9aadeea0fc28d76f4369,368,FALSE,2561,2193,Radiant
b57cf9f952e557659e81c77e454a49a5,987,FALSE,1610,623,
a44b207460aec9d4b6ed27bc5faad3af,2220,TRUE,3781,1561,Dire
42da70c71804a6b16f0ca9279544a6d2,768,FALSE,1836,1068,Dire
01dab91f387305787331c5e6c300521c,445,FALSE,2973,2528,Radiant
a12d166155c499b1ca9e6f09335e6f06,38,FALSE,2686,2648,Radiant
54c7f34eebb98c184081cd8de91a0492,2519,TRUE,4072,1553,Radiant
89f2783777a8850f1dcfebe0e9019241,1697,TRUE,1999,302,
bb89348a82fa0cc5f3f3d2db593b24d7,542,TRUE,1658,1116,
8f0d25c11b7b36abf2684796c6678c9e,1960,TRUE,2767,807,Radiant
250f46ccea6a489ff06a0f8b724c1389,1715,TRUE,2372,657,Radiant
3772dee9111ffae78065e018d1d44848,1734,TRUE,2202,468,
bcc75f9c16cee67ea285c33a11332500,1704,FALSE,3139,1435,Dire
aa87bbe4ddf64efd5d744d26f1714a67,2151,FALSE,3529,1378,Radiant
3f1f28ab94a014ff6198d5b2ce3ca69d,663,TRUE,1775,1112,Radiant
8a399fca4ccc3c2bb4689017c812d9b3,1023,TRUE,2052,1029,Radiant
c2c344ae9c3f8edcae41de2371586355,307,TRUE,1478,1171,
1b8a748a09385bb7b3648fff95114913,601,TRUE,2158,1557,Radiant
dac9c2ceea69857a2d4a58dd42aa747b,1465,TRUE,1765,300,
3dcee36da501d4f2c9e566624c3e0a88,263,TRUE,1731,1468,
e5c054e0d4b3e829cd5d8083b30ff1a6,1143,TRUE,1255,112,
61dfd2c8916c18c9bd8190520877b453,1171,TRUE,2032,861,Radiant
01fd828417c200399f0aeebcdf60c408,2581,FALSE,3057,476,Dire
5e6441c8407c9d0bd8f74f337182bef0,301,FALSE,2391,2090,Radiant
c33458ec59aa0cf7006f4b7856f4d7db,198,TRUE,1762,1564,Radiant
fd8e6ffe440c9467d10482a79fc25b52,936,FALSE,1915,979,
691af299cdeb71eca35995c54e2578d3,1405,TRUE,2370,965,Radiant
7dd5b6a878a67ec31ba0438bfda04b4b,578,FALSE,1843,1265,
83aae9029da9c91ecd1c7a71777e029f,1671,TRUE,1732,61,
96d8bb1f31fe39366cae983c2c75d0ef,1824,TRUE,2809,985,Dire
e7cfa80692da6032de7337d1a45cdb3e,162,FALSE,1712,1550,Dire
59139c26b0627b1c89db83025c52e443,1726,TRUE,2827,1101,Radiant
2eb0ca69f4eac8086fb281e6de26de85,642,TRUE,2682,2040,Radiant
15b694186330753576277677a20af699,1251,FALSE,2828,1577,Dire
8a34490403d24a53e876d964dcc3a709,403,FALSE,4218,3815,Radiant
aed3dc98bcb3c24671131693e8c4518c,1406,TRUE,2913,1507,Radiant
0d5399f97beadd1b79ba77ae856874db,2006,FALSE,2325,319,
e77e1145067c5670aa19c7cd1ae2543a,369,TRUE,2482,2113,Dire
22527a6946af13caa3c0d522b857e017,1226,TRUE,2387,1161,
f026f9f72bc2255f5ef3317f92a06c3e,1880,FALSE,2689,809,Dire
47f186950cbbc3cfa6f7da12f6a160f9,491,FALSE,2057,1566,
a2cd34cbf1e3996ddf651192d68015f5,1417,TRUE,2104,687,Radiant
6291464579beb0be031a9bd8dd0eca21,500,TRUE,1944,1444,
3f77f9c4d8cb63dab4a25391a893fc87,2043,FALSE,2193,150,Dire
b462acca640cadde6094edecc2024103,1234,TRUE,2028,794,
74ab4a729eeb91d13ab24910df788d42,1543,TRUE,1922,379,
96034c79d77c2c7aaa013cb2c782a311,313,FALSE,1941,1628,
fe8e85bc1887c80656cbbbbbb20849b9,1154,FALSE,1890,736,Dire
43f8331484efc90a2c1f9c014a0565b1,721,TRUE,3354,2633,Radiant
1bfac36df8c5c2c266cd9613a0cb93f0,1329,FALSE,3426,2097,Dire
c7ef65c03fce279515eb4a62cb7a3ab2,1081,TRUE,3568,2487,Dire
e9953fbd852c2fd0643c562314c3004f,328,TRUE,1795,1467,Dire
7868646bb7baf6739a026ffc9bcb02fb,820,FALSE,2675,1855,Radiant
49fd987f9bcb463431f3fa541b3fa541,2480,FALSE,2814,334,Dire
8979d9649040e565012c3cba588ca537,2497,FALSE,2834,337,Dire
e193f6aeb3bf097e725f4c9ce759d9cc,1156,FALSE,1930,774,
7fdbb07a55a012988df90db5bc9449dc,2246,TRUE,3147,901,
d699b5345dcab7bf46e8c5cf10ebbe72,580,TRUE,3602,3022,Radiant
a5b83ddcc5e5b1d916eb3b6a9f416979,889,FALSE,1951,1062,
daa92d5986afa75a46f9d006e8b13107,2057,TRUE,3118,1061,Dire
9c5ecdf8846bd99f36c956f315769b1f,306,FALSE,1666,1360,
bb2d26d9abc721e541d6c93b648231e9,2356,FALSE,2701,345,
c245c83338ffcb8176238b1de89d5de6,340,TRUE,2311,1971,Radiant
d9498cfee490eaa451eef7e99d95c267,220,TRUE,2378,2158,Radiant
e369f0ad6dbb17b5985faa1689e7cd13,1218,TRUE,2020,802,Radiant
5af9c9b147e4b5ad7612aba4afc6229f,1311,FALSE,2486,1175,Dire
71d7d77c8e94a88bb4f67bacf4a76b5f,1876,FALSE,2133,257,Dire
e5340208b73a7374cdd0683658553bf3,1592,TRUE,2024,432,
ff095225683ce946edbb55a7db80e7b0,983,TRUE,1878,895,Radiant
4bc6d6a0db37c32f5516acbe1b736074,1081,FALSE,3146,2065,Dire
70fd8b8b0a360bc6135858a4960d45ec,188,TRUE,1393,1205,Dire
0d54cc58cbe88917c0b15d23225d97b9,1520,FALSE,1903,383,Dire
f708bccc4dbba264baef6ea2850218af,589,TRUE,2462,1873,Radiant
3791050ccb5fb86bdb4671f5b6b2bba7,2060,FALSE,3244,1184,Dire
87c1822f8f567b792584175e8ae8c5b4,154,TRUE,2129,1975,
1fb613269ee842986940bdb78dcfbea1,770,TRUE,2469,1699,Dire
5ca109bd0dcecb63ca59115907644a0d,1874,TRUE,2533,659,Radiant
029fb50a630974555e2ff53e610bbd7a,1445,FALSE,2907,1462,Radiant
d22859600e8e85ff45d1df68998752e7,856,FALSE,2075,1219,Dire
cb2fdce811396f32a9809664a8e7865e,1236,TRUE,1908,672,Radiant
0be961adc7f801546bd90bc1eb6a703e,556,FALSE,996,440,
5e9cb7351057c21e17ba598a6e046ef9,593,FALSE,1349,756,Dire
d0f7f1a500ada904292ece01a1c3aa8b,1281,TRUE,1323,42,
50e7613bb131f41e8923cb002bbf34d7,1377,FALSE,2151,774,
a94d858cf3e1ceeb3ba6f739391491ff,325,FALSE,3060,2735,Dire
a243141f29f7d4dd480d7384292c3bc1,1090,FALSE,2537,1447,Radiant
dd9b789f3f46e044c3a298d742babf58,702,FALSE,1042,340,
ae8debaa4454ca1457ec19fc1e0b670c,1222,TRUE,2520,1298,Radiant
b40697bb5b8553ecfcb2f82f181b661b,1362,FALSE,3577,2215,Radiant
5bde3fac8c93730ad1f4c660989d24e2,2098,TRUE,2963,865,Dire
3c31214033c697e78c40331d9de395bb,1151,TRUE,2010,859,Radiant
f2a1725c8b1a8ada0c291b912e748a40,1371,FALSE,1954,583,Dire
93ba4df7ce97c8f754d5e3a4c7af2021,1803,TRUE,2439,636,
07f4429ace8ade2dfc90bfff9826d91b,3190,FALSE,3280,90,
4312d1039213e81bab6ab9a0f4446af0,909,FALSE,2849,1940,
292e7fb2c607c037b9ed213be5a6ebe8,772,TRUE,984,212,
b3fe455574455b187f1e5f3dfc4b2af1,3026,FALSE,3569,543,Dire
293ff70c87993a5785a50ebf43e6d565,2074,FALSE,3791,1717,Radiant
1542ebba56a7ba99a27431fb03a0c993,964,TRUE,2492,1528,Radiant
7d6a02e910fd983768bb8d8b18181f04,1895,TRUE,1977,82,
5c854be825441a661b0d67ce363f73af,1274,TRUE,2263,989,Radiant
32b64c13247c28382af52cc516ef3e28,1279,FALSE,2278,999,
d7906ed33aae82a59de3bce3b7751956,1258,TRUE,3673,2415,Dire
be7a5836dfca9647b630256acdd8fb85,1266,TRUE,3262,1996,Dire
192ed043b4b9b1312780ee8a51eac7e3,860,FALSE,2873,2013,Dire
b4e02fb3abc0bc2f747075693876a5c0,624,FALSE,3343,2719,Radiant
51c4eeef4f62d702714a9634085fbf7d,1397,TRUE,2357,960,Radiant
a9bef10d6af71202dcb93c1aa3989877,1038,TRUE,1420,382,Radiant
2c56bdff9a7061f12cc5ff7b49c04030,3214,TRUE,3328,114,
1e42003ecc4c987058e9cc94b8d56f41,907,FALSE,1337,430,
df38cce0e1daa796c1131e3534f85e9c,1540,FALSE,2006,466,
82dd07f3234cf31ee228536db9e692d5,170,TRUE,1262,1092,
b5ea4b32bba00ccc7a1615ab4aeeb67e,390,FALSE,1514,1124,Dire
8118c2a2308f9b1baef3c3f1e5fbb2f3,1186,FALSE,3300,2114,Radiant
5a8abb34b6ba1aab233fdbec12ef70fd,1445,FALSE,1876,431,Dire
8b046d4fd0e70d564719fd7e7a06a058,122,FALSE,1546,1424,Radiant
9bca0d0337b7a4e2497430ff6275c68f,1094,TRUE,1447,353,
9ca0946699b88a9bfa5bb4d394d366a4,719,TRUE,2698,1979,Radiant
18113895be19e82edf2940b781354f6a,1089,TRUE,2593,1504,Dire
9d521b1dc3b8c69ff2b101dd51d031f8,807,TRUE,1874,1067,Radiant
2c19ab4b55f0039b4f930ed6f07c8bf4,2477,TRUE,3553,1076,Radiant
1d1d96d121d6d04719589ba6f52079d4,2973,TRUE,3498,525,Radiant
2b381b384b7e354245a80c3d883cad5a,1054,TRUE,1275,221,
d1fb0cb06b7745ffc13c573ff6fe8ca4,466,TRUE,1097,631,
c30da17b81712d1381e25f66febc6334,1617,TRUE,2434,817,
cc6502ab06063c1843d18e8dd7170202,2289,TRUE,2568,279,
d58ec9d5b8fadf82f43a6fc024886699,496,TRUE,1594,1098,Radiant
1e95e9d1b118272b284ac98f0da09e94,3885,TRUE,3938,53,
73021f8200cbeb4edeccc9d03352beb9,936,FALSE,2539,1603,Dire
6ffcd892e886daf6ad76878e992c735e,1352,TRUE,1437,85,
9e73c16f7de1942f56abd6c693952454,4095,FALSE,5156,1061,Radiant
92464a0becc0bd3d0f371c89ac1aadc4,2304,TRUE,3182,878,Dire
6fd2e80a57f4a76c283cd4d33d43c1fb,876,FALSE,1750,874,
0cd9b4ab73a7e053375e4b1aa2141e03,1055,FALSE,1877,822,Dire
571be2d9c2405212ac109a9be1a16058,946,TRUE,1587,641,Radiant
2f687004c20d260fa7a1066052070030,1398,TRUE,1819,421,
002559e19a608c49af726eefc3a5189d,2988,FALSE,3461,473,Dire
a556520616a5ee3c12d641264c41d228,286,TRUE,2261,1975,Dire
6fe938a48647b51312f401b729e9a6e1,2121,TRUE,2558,437,
92a8dca12272d9ae9c33a1257553109a,1526,FALSE,2192,666,
56b36352e4b336383be6554d5fe24b67,1839,FALSE,3186,1347,Dire
04ec2af86d50e305c0f1103d2e66c33b,194,FALSE,3259,3065,Dire
372386bf884fc4fca686a21060bcab1c,498,FALSE,2750,2252,Radiant
7a4ac9bd64af714bcb39cf6b98f248ba,1418,TRUE,1472,54,
d8a616ac52cb2e5787d964b61fe9a991,770,TRUE,2438,1668,Radiant
cd2cf10e3c5a0c9f0b68391944b3dccb,618,FALSE,1121,503,
d94b05cd33e91ebabeb610941aa6af29,360,FALSE,1614,1254,Dire
d206dce984e56a9941f61bc4190c3a17,308,TRUE,2121,1813,Radiant
230bb321eedacc501728e48ad4ded026,617,TRUE,3115,2498,Radiant
e0fac7080df129e01465484797faff6d,772,TRUE,2064,1292,Radiant
f4da6b45a4678f1c8668ddde2f4f3d03,1778,TRUE,3004,1226,Radiant
aaa17a4ed2fa65ab38e2d8e6a923cdc8,1247,FALSE,2519,1272,Dire
abfd4cb7cefd4e117c41d722bd3c1594,1181,FALSE,2185,1004,Dire
c3c08e0ecd5d44847da3e1d38e96e318,377,TRUE,2792,2415,Radiant
f94bd0f3c1204d4f788f51ca57fe49f8,1507,FALSE,1889,382,
97e7f628dd0a878a6fc7fe5dc4a72bcb,251,TRUE,1543,1292,
2b565f39ea4fadc3b3e7e5834e439ab9,938,FALSE,2100,1162,Dire
908f559e4871816852060c105f642b60,1039,TRUE,2357,1318,Radiant
0c2df1c51c82bf31dd4c06d6d6bc62e2,1759,FALSE,2510,751,Dire
f5931cfbbc56a3ff0e31e2c55665ec8d,268,TRUE,3714,3446,Radiant
8f3b79d232c1a48120f404bb2bc5250e,570,FALSE,2202,1632,Dire
2185489e232b306dc51d47653ad3a465,3538,TRUE,4119,581,
07f36c38bd0e84bd25f64ea310f11579,1047,FALSE,2943,1896,Dire
1e0b59ec9c9c1a2e2f1f1ae65d934c86,1674,TRUE,2501,827,Radiant
e8bfac6fc8455c87ff4bd5f5e0f56694,68,TRUE,1391,1323,Radiant
484a3835f178a938d67be3df4069d985,134,TRUE,1012,878,
6defe4cc5650f7560805a020fab3f6b7,1801,TRUE,2020,219,Radiant
f94cfb38e18426c052cb096cce1c0835,79,TRUE,1347,1268,Radiant
4645b1c855f51159003b4c806703901e,2627,TRUE,3136,509,
326209bc6148dc11f88dd52457301610,2249,TRUE,2362,113,
8ac72557e8d3988052fa4e276b3f4e41,163,TRUE,2133,1970,Dire
8d16b10ff7171f009eabbdecc393884a,1418,FALSE,1879,461,
258370ee9eaba929063ee89a1b3dea38,1945,TRUE,2257,312,
f126a5ebbda78104756a2d00a8291968,1764,FALSE,2486,722,Dire
96d8cd6655eae6f72b3fd94d254d9156,7,FALSE,1220,1213,
16bcca06ce3682ee463995908468073b,60,TRUE,2183,2123,
0aff3cde2fb29434bce6c37ec80b8b08,1593,TRUE,2122,529,
b3cb63b98db7160344fcced248cf8809,1557,TRUE,2946,1389,Radiant
f6c363c834be6490194402cc44480103,2301,TRUE,2865,564,Radiant
b0832473bd8c8e727e0993fbf3ffa234,1040,FALSE,2100,1060,
15a03bf75caa5eb78dce111052b29baa,2179,FALSE,2222,43,
1a64d4570b12ee4c3bb548c32f5d25ba,988,TRUE,3543,2555,Radiant
ae2bb09289d5a75745c290c8e4b01e17,2478,TRUE,2949,471,Dire
08dc59e3a2b59b52774632eeea28d278,737,TRUE,1623,886,Radiant
4021e6f4b37539fed6e58894b7139626,889,TRUE,1029,140,
8c566a45fbac8784ea59144ca9c3e065,1762,FALSE,3562,1800,Dire
2c6ab62b08f821109fe44894cc74cdc2,185,FALSE,1941,1756,Dire
0bd78739a18363b74559700ec641799c,935,TRUE,2409,1474,Dire
a5f20871c875ce07f3f3fdce6463e39f,3555,TRUE,3587,32,
f785b854ee2e0a34305e2d5dea71fb2a,109,FALSE,1860,1751,
e8f0f31bdad5f48df28696dacc16efff,2796,TRUE,3245,449,Radiant
9b818ea2f597d3237bd101066e744afa,1142,TRUE,1727,585,
5f4286bb0e0e751b64ccd5223f6b63ee,2713,FALSE,3692,979,Radiant
f7bfd5fcf6ebf1461af48309a746bfb3,1699,TRUE,2796,1097,Radiant
43608341027efc6f663988c26208c0ae,2137,FALSE,2712,575,
44bb3be9f9c442da08f8b014cc47b514,1743,FALSE,1901,158,
3826d01cedbac775092cf1dbf23d1137,966,FALSE,2026,1060,Dire
4bb1b6c7f38154b2613331aa3bf71203,109,TRUE,2447,2338,Radiant
30d443e722aacd81030e122fa35c62c9,2627,FALSE,3018,391,Dire
c110628d09a9c30dd4c6f78560daa1e9,598,FALSE,2402,1804,Dire
f34f3b91929f82270250ddbeaa3ca5a7,2305,FALSE,2875,570,Dire
3552eb2cd018ad4f31e2e854df5784d6,919,FALSE,2530,1611,
65ef093eacbc233781a95a8ca0f30389,548,FALSE,2544,1996,Dire
bb32156751cd29d38c74e7ec50e418c9,1510,FALSE,2275,765,Dire
4a0aadadfe3b9da26395413ae6cf2403,764,TRUE,3048,2284,Dire
dc79ed0ef412d87bc4a0bcd279ff862b,2451,TRUE,2828,377,Radiant
dbac5bb8909307a7aa72500bfafa32fb,2740,FALSE,3100,360,Dire
d11a8fa22b517b398b0db4cd4d3a42d0,177,FALSE,2026,1849,Radiant
1542e237acad585dae364427b12d1dde,1305,TRUE,1690,385,
da98d7b60273771e0ccc196425dfa9a5,1331,FALSE,2459,1128,Dire
43852bd8ea474dfe3141a1ac00f355b2,3773,FALSE,4070,297,
bfe430bf826956a29c7453add1e680f8,1451,FALSE,2323,872,Dire
074c5bdbdeecad15e19f1453d4eb88f3,186,TRUE,1580,1394,
0a88c9eaa2f798c0171905fbecffd120,1054,FALSE,1776,722,
f75c58ff18a8733590cb28bf9f056348,2856,FALSE,2974,118,
fc4c575bf3293d131142a8917e9fd461,197,FALSE,1848,1651,Dire
d2c49640facc5da7236b77fd7eafd032,882,TRUE,3073,2191,Dire
397b3c578db492f66f0cba2079cc3254,1447,TRUE,3552,2105,Radiant
52f01898eba899f09c6339e162322e38,955,TRUE,1977,1022,Dire
50baea4e7be13d0f2c4b139b7bcda37f,319,TRUE,2606,2287,Radiant
1db6f074ba0ac04404362ed6e1982340,893,TRUE,1166,273,
39d7f30b826c5c765fe305eb66bae12d,1148,FALSE,1221,73,
e3ec9316e9048bc6046c41688dce6b2f,99,TRUE,2134,2035,
97d8fc4a06370e7dbf31383ed204119f,1947,TRUE,2625,678,Radiant
061f3758ccb84ab8daac3649ce1784e3,808,FALSE,3285,2477,Radiant
1f43839c9e8c9bd2183c7dd94e03b699,611,TRUE,2679,2068,Radiant
cb84520d63dcb6488e6bf27defdcc035,760,FALSE,1804,1044,
e18b31fc9a6837777e3efbe5856e104e,2685,FALSE,3055,370,
dd2570bf4f885ed45b725008b07c9563,55,FALSE,2584,2529,Dire
fd2162cc6af4becddbb217e1d6ed121c,1529,FALSE,1975,446,
95ab2e9e0a17234b672698c289c69c5f,1448,TRUE,1906,458,Radiant
1530bb0be3133c001758de6882ff4514,749,FALSE,4060,3311,Radiant
c02fb85deb0f4788db5f7cf23fc6080e,896,TRUE,2852,1956,Radiant
1c2299d420a5e6dfc020ee818a70dda5,942,TRUE,1107,165,
3f80b2df4a7505fc5a31d20b2de85c17,2827,TRUE,3008,181,
36149a733d465e7cf835a6bafdb1c13b,372,FALSE,1707,1335,
9b34bdee943a63b141cd6beb933cce04,899,TRUE,2401,1502,Radiant
8f08625ef8d0791d799aa44d3b3106dc,1370,FALSE,2363,993,
8e2995d7d59af5d6a1b210c7da82e9e6,786,TRUE,1791,1005,Radiant
19fdd835873140dd14af0e97483dd5b1,802,FALSE,1976,1174,Radiant
fd3a26b6d9d166b9034d4710f8fa717f,1702,FALSE,1908,206,
b21667b709c17246de378d078937e3c5,16,FALSE,2309,2293,Dire
721766f3e499f003798f186728970fa7,1141,FALSE,3024,1883,Dire
2975173671155b020b2e325370ca0356,1819,TRUE,2700,881,Dire
c4b63abb4d630f146bc59b1a41b59c94,755,FALSE,3453,2698,Radiant
e994b14e25f1e226713af8d41e12c4de,894,TRUE,3729,2835,Radiant
88ac1e49d66b00d383c82392ff92b9e3,243,FALSE,2526,2283,Radiant
09d6ff363024b88e03cbbc3305844ebf,1093,TRUE,1666,573,Radiant
5c5158368ce6d87efaf162a56884cbab,1772,FALSE,2004,232,Dire
17e4578b076fb9a79512be419b6ecb33,1740,FALSE,2107,367,
57a090f33e59cb730af7c68fef6168d3,352,TRUE,1390,1038,Dire
4986cb8e857b4754b25e4aec482a5262,867,FALSE,1288,421,
d0b282931212b58d4721ee947d034b07,1027,TRUE,1080,53,
75f1ad96b23d5e51ac7aa2ce6c907bfa,2046,FALSE,2906,860,Dire
a2f16a5b1db94f3a6c5c6bd60c70cc95,87,TRUE,1293,1206,Radiant
19434ebc4e26f5021643cc39182e0a04,366,FALSE,2663,2297,Dire
f6fad68ca4967dd69988a9a57914fc52,649,TRUE,3411,2762,Radiant
35065d79d6ee1fe0b4fcc788e979e21b,624,TRUE,1679,1055,
87bf841de1fcaa165ae7d6be91ebcbcd,2252,FALSE,2799,547,Dire
b073dd07f77b6f7546d072019b7635ba,155,FALSE,2356,2201,Radiant
a44946f39eab8c8bedf65a53beb90202,1251,TRUE,2495,1244,Radiant
7f933e4a058bfcd73e7eac78e79586e3,725,TRUE,2222,1497,Radiant
a0b451dbb09cafd2f3b60e2de6d5a773,1075,FALSE,3206,2131,Dire
3b92c3c4286abdac52de76646803e6ad,307,TRUE,2196,1889,Radiant
b76d71771a57b1f8a6526e166e6e913f,1355,TRUE,1532,177,
8e84997ced5cd4239b4009a23cd1fd37,134,TRUE,2697,2563,Radiant
602a94c527e24b1709439e6ebb11b1e4,2273,FALSE,3104,831,
1cc7803b7dfda4e287fcec141c416c74,2214,TRUE,2470,256,
17e48ab1b19931ed26b973815f7c376b,905,TRUE,2966,2061,Dire
a053b13e922b5d0512442604193074dc,2113,TRUE,2473,360,Dire
b6c924b5c175add9b785869ffb6b7c57,232,FALSE,1678,1446,
72f95a53c9294444df42504252574379,1223,TRUE,1408,185,Radiant
8461b2203268e0c2c99f671cacb2e231,2506,TRUE,2772,266,
ccdb3e6eed6ac2e2ca678f9dc339c942,762,FALSE,1970,1208,
1506722b14c273bf18cb7c306de86183,720,TRUE,1548,828,
24f73eec1f2bc5464c200c2ecb01a92b,1505,FALSE,2236,731,Radiant
e988e0ebddd9f52f6cb0c7c1bda8b467,97,FALSE,984,887,
d1a1c5b97f7103fec3b53ced6bf6d4fb,667,TRUE,2251,1584,Dire
4f1ffa22c66f6ff94d59c28f1d646178,2522,TRUE,2867,345,
ffb44c2e5bdd9c7ff3306b95a53f3cf7,1473,TRUE,4370,2897,Radiant
f028a01387ba06d150951670eb51e73c,1487,FALSE,2267,780,Radiant
cc2e23a21a46479cc00a9362dd2ff749,2588,TRUE,2831,243,
4acd1923f2b1a73e5eff0019abf5e610,174,TRUE,2239,2065,Dire
4128940c515ee41439bd28ead42d3501,1391,FALSE,2309,918,Dire
7383fa0684721ef26191c0a98007fc94,656,TRUE,2713,2057,
42a2ed48736a62bfb32fc80cc4887423,266,FALSE,3148,2882,Radiant
98f95fdb86f17549e362523af47e43f0,30,TRUE,1893,1863,Radiant
280cf83d5b50cd645739b81052c17878,1365,TRUE,2427,1062,Radiant
7c51d091ab1d6a9973ebda04d8d6370a,2787,FALSE,3139,352,
752412dc395d8f6bd8a1dc333a29fe6f,248,TRUE,1631,1383,Radiant
74071554e850a8e14ba9285e9a59c0ad,954,TRUE,1581,627,Radiant
2408aacbd688836d72c202820a3870b2,1153,TRUE,1325,172,
db6b61da6a2fac6504a2f5a6fc6e8765,11,FALSE,2212,2201,
8c0efa554221f843344a0263b1536d39,152,FALSE,2177,2025,
e8c689724e9a530e386e6bd28f360578,708,FALSE,1393,685,
61f67639e7eb6b7ebe158e42fc2bcbce,743,TRUE,1658,915,Radiant
44fd99a5148ec7bdc08799e2d6d4e448,427,FALSE,2052,1625,Dire
2d052089de5622e55e2e48c47921d3a2,414,FALSE,3063,2649,Dire
c985e547180d9d8505fc246e2da4afba,1828,FALSE,2849,1021,Radiant
6911352f4bf3bc594ee5df066db1aaac,87,FALSE,2242,2155,Dire
2929589a3464e62b82ef070e3bfa156b,692,TRUE,2483,1791,Radiant
fa371cc3e88a3dbac1cf1a80b8f8d11b,735,FALSE,1889,1154,Dire
65214a453c45b43e3282ded0525c6855,783,TRUE,1647,864,
35b703b019bc3e7a0b4aaed77478d70e,1781,FALSE,2803,1022,Dire
d2791d71347e145c41546b58af14ab02,1333,FALSE,2662,1329,Radiant
019a497af1b2a214cab08aa24241b100,1461,FALSE,1769,308,Dire
96c13531ec80582172e0c72d8f1bdea3,860,FALSE,2436,1576,
571a4df2797bfb7564e0904965675fb4,762,TRUE,1172,410,Radiant
44d5ef54c61b37177c1f5137919ce9ba,422,FALSE,2461,2039,Dire
277c6b151cd3511a7d9b826769c6445c,1901,TRUE,2765,864,Radiant
44eb826af717ea727f7a66ab8cca66df,542,TRUE,2501,1959,Radiant
f6f359b437dd94463c5aa09540e99faa,1193,FALSE,2179,986,Dire
e3d06c0fd3ac56c53812de8ef420c292,999,FALSE,2328,1329,Radiant
63adb3eb5e3b616732361e90bb28569b,1018,TRUE,2791,1773,
b9798f70af7ebe574af7a4f240dc546e,1722,TRUE,1901,179,Radiant
cd6123331d4402bcea7323c68b3130ac,1144,FALSE,3946,2802,Radiant
9b039b27c552a116033d74a6836bcc61,1175,FALSE,1562,387,Dire
8879b2afe8b6dd8c8b0564efbf15ba00,9,FALSE,2085,2076,Dire
727c15ab3f056a4a781aa82fa91d4020,93,TRUE,1413,1320,Radiant
895a2c6d80263644fec715892f1dc3d0,153,TRUE,2265,2112,
ad59e03b5b021255f01e23472039d3ce,353,FALSE,1963,1610,Dire
138b8d12a75f8241341f7a4498a4372e,1488,FALSE,2901,1413,Dire
b38998e67ffc818a7f46ed6490ee01fc,2125,FALSE,2401,276,Radiant
864742e3e1b765688c5af9d55feed3fa,2399,FALSE,2815,416,Dire
2415f89d68fbd549bf13bc6d1bec4723,5,TRUE,1376,1371,
a4bc12049282c3d839176d1b8255b945,436,FALSE,3239,2803,Radiant
1fa9c3991ff20936b0db6bdfbef55016,1708,FALSE,2413,705,Dire
e034938f5644a13f584376a41fc4dbae,864,FALSE,1974,1110,Dire
75626ac28a09fefb05df0f84955c71b0,1865,FALSE,1985,120,
a4b776c5a8993c66a7ce535d653e4e89,810,FALSE,2531,1721,Dire
b3be104b5451e8dfbf6ee32e055f0d4a,2477,FALSE,3532,1055,Radiant
f2b2af28de1ad94d2a9b49aa33d016e8,986,FALSE,3057,2071,Radiant
531c6ec189895b53af08192bdb8e5321,1263,TRUE,2056,793,Radiant
b5275009fde10a83c957ac2d743ac80a,1270,FALSE,1730,460,
d04508a8cebaa3f7188e8e4a1c5f120f,1084,TRUE,1683,599,Radiant
98215980a71d07a67bb7bbdfda92de9d,338,TRUE,2178,1840,Dire
f5f3b04c2a3b74ef3bebd5cddb1ee16c,2693,TRUE,3250,557,Dire
f136e3d7c292ba1d7780e1f088a48815,463,TRUE,2315,1852,Radiant
e3e30109d862c650999dcd01a759e5c7,2055,FALSE,2721,666,Radiant
34f41ff25fde8b422d4fe2082abc172b,1435,TRUE,2997,1562,Radiant
dde02010c2da768039bc2b46bcb1335c,1205,TRUE,2226,1021,Radiant
51702f471f430e69324cbc86ee81ce46,151,TRUE,1882,1731,
f7b1b1dab97348e2c1ddbfb3b450d5eb,69,FALSE,2353,2284,Radiant
2b660305280e4c47587c3a6f273163d4,1274,TRUE,2120,846,Radiant
963743379a40428aa86cdb08b6e8cea4,739,TRUE,1584,845,
2e2e41d4123163ab6f635c968d0448b6,634,TRUE,1074,440,Dire
c8a6e57d8375738cba54b49c09aa742c,140,FALSE,2865,2725,Radiant
6029faf8ea8784f4f010ab085da2b394,901,FALSE,3097,2196,Dire
83c752f8b7c890c2a835531c2e88527f,177,FALSE,2068,1891,
1ac2436c16822837d9e927de62bbbf41,2749,FALSE,3085,336,
00bcbc31280615e69956e6adf62d06c1,229,FALSE,2299,2070,Dire
10db7fc22616ea9cb8302d8c78e84cb8,2199,FALSE,3093,894,Radiant
185b666bb3fd4c937467281d90f629d3,926,FALSE,1557,631,
4b4350a48f3ddcdda0447c488cc70c38,521,TRUE,2905,2384,Radiant
1d7c888e14b0e97c15f1daa37bfe2afe,1207,FALSE,2868,1661,Dire
abeac9a4cfd701e7efcc05d1ae744a92,951,TRUE,2296,1345,Radiant
b6d0e1f62ceb038dbbd49cf2ab950f7d,1158,TRUE,2059,901,
df411d30e1fcf4fb8e6c6b393faa92bf,150,TRUE,2385,2235,
3e2af226d91fb4cf1afaa3fe37468ed8,2277,TRUE,2665,388,Radiant
3323150ed61d9d481febd083612cc2fa,3232,TRUE,3606,374,
f06e0f9142c2ca6e443fd2ad8917d298,1021,TRUE,3102,2081,Dire
e9308d2e4e51a6a1e0fb17148f3fcbc7,72,TRUE,2761,2689,Radiant
764928344c9e3cf72aaa4428ed1b323f,149,FALSE,3689,3540,Radiant
cb81611e4faf484a0809b728fc3bddbb,974,FALSE,1273,299,
6f2c079ee9264da57eefb7186c9fbe36,156,TRUE,1001,845,
d907b06f5b2472a874a9770cf82c893c,428,FALSE,2829,2401,Dire
8b2fd5913683ee8bd3026b7d6d1a6a7f,1412,FALSE,2476,1064,Radiant
09843073499144010db688aa72c30782,183,TRUE,2978,2795,Radiant
5d4281d0835c66c037113ca974f9a4ad,299,FALSE,3753,3454,Dire
0bde2509d76c549aaabb464d39c04348,363,TRUE,2197,1834,Radiant
795e7a4948e8ee871c56509d4bbd83e2,902,FALSE,2303,1401,Dire
e36451f5f4389b798371ba42b0a22063,808,TRUE,2866,2058,Radiant
926e861794e73aca79bc987f446eda49,1721,TRUE,3030,1309,Dire
6661df9fd0f1aeaa20b96d63df95da52,596,FALSE,2015,1419,Dire
533e75ea76784f13e20f0f61a2131888,1175,TRUE,3555,2380,Radiant
a6ad67c99c0afc3fd5e183e101998a3a,835,FALSE,2771,1936,Dire
f11001ae5e4081ea7ab024621f89347b,1872,FALSE,3566,1694,Dire
88224c59e2c63dc7e44c16a556715031,529,FALSE,2450,1921,Dire
be1d1ebd5af093df8dbc9d9874e3244c,1420,FALSE,2447,1027,Dire
00a5d238dc57de3a806f47488350ab42,1324,FALSE,2387,1063,Dire
7207cc43f36ecea3fe6ca83a6236be80,417,TRUE,1766,1349,
4d5c3f367e542a7dfaf6eef1b81f0be0,2294,TRUE,2497,203,Radiant
4342a98471f8da8367e03537f52a4867,1344,TRUE,1404,60,
9d94908c6907ead128acbc7f8b5ea2a8,608,TRUE,3766,3158,Dire
40fa8874254af66d7c471ad932d2955b,1927,TRUE,2108,181,
b6bf38aeeb72bd71dbc907fca3656a1d,721,TRUE,2819,2098,Radiant
15d68a4a62a696a1dc35e7fa573d7739,1736,FALSE,3124,1388,Dire
b458cddc0a9a65ec5696348764c99f78,717,TRUE,1537,820,Radiant
6aebf5d68878638a7912c77910c46521,587,FALSE,2873,2286,Dire
f9b190dbbaaaf956b186ee1e64b6f496,65,FALSE,3454,3389,Dire
a47b4944cf0b7047cf7240d7a2ab80d5,191,TRUE,1073,882,
31cd91cdf4de7ed6efc3d68e96084cee,382,TRUE,1143,761,
17b8d80abd3d466cabd2a8bb00a96c3c,136,FALSE,2987,2851,Radiant
8308d889eb4bc7431e757dc8e4460ec5,1504,TRUE,1788,284,
8c1db6143189717354dc850279780b5f,94,TRUE,1680,1586,Dire
48efa8e02ae052c253550908cabb6765,265,FALSE,1804,1539,
ac84f4772cb5b409f4e1e4800534e03b,20,FALSE,1643,1623,
c10886304733d99e6c709d2575537a41,1933,FALSE,2512,579,Dire
7a650cc8719ac0850fb3aa3b8b80d9e7,990,TRUE,2048,1058,
e2465fbeefa77b4067e6c95698fcb834,413,TRUE,2495,2082,Radiant
c32a0a6d884b2084ef06274b700a0ad1,1443,FALSE,2231,788,Dire
46337c091ecc6ca2c19fc0ed7216b29d,1584,TRUE,1991,407,Radiant
cd8ad52242898e42d2566e50c58b292a,1622,FALSE,1949,327,Dire
49e83cdadf9cb9e53e3d1a10367fb1ea,369,TRUE,3089,2720,Dire
f24d43d117e2caf03d3c4ab5a3ea51b0,870,TRUE,1977,1107,Radiant
fbc1a2e712c4235e57261426d1ad7809,1666,TRUE,2209,543,Radiant
5b10f1edfd3c716a3f8c7584f9591171,1874,TRUE,2667,793,Radiant
83be8710ba13f533f682d687372ebc2d,997,FALSE,1169,172,
c2b7940cfceaa3bd4c9842df520fb123,315,FALSE,1548,1233,
fcd4cda9301d9b8a39fef00a2854ebba,1588,FALSE,2146,558,Radiant
c6ad1162b1f15b5ec0a9a38569f3a6ff,2137,TRUE,2301,164,
4c852db1af1c839d47655fe46999de3e,1267,FALSE,1988,721,Dire
92af6c6b4e27254af035ba9152c53a76,608,FALSE,2305,1697,
d539b9cf8500c7aa12a0394c3d94fc81,1633,FALSE,2555,922,Dire
33611f17151f90338f701edc22520a23,804,FALSE,2422,1618,Dire
0d97e00cf09e02f3590886a6b26ef071,122,FALSE,2400,2278,Radiant
2ac9a903f77fc8911726a6d2558840a7,1122,FALSE,1938,816,Dire
c9726817e9ba929d679589bb1a2334b9,1624,FALSE,2715,1091,Dire
4478b868cb11544059a42c19bd26226c,1287,TRUE,2795,1508,Dire
2aa8d2e62389c9694a3793b5605d9786,1386,FALSE,3141,1755,Dire
75ae9c6ed1165b8ced4acf6c3699949f,1802,FALSE,3094,1292,Dire
c82866214e410b407afb6d744aec4f1f,1114,FALSE,1799,685,
f29b4487e46d945ea5a57abe36b7b797,433,FALSE,3488,3055,Radiant
b67cb4c76b89a5f7085184f436f71121,328,TRUE,1475,1147,Radiant
5497cf2b662b8f6bbcb616d4540d7377,1084,TRUE,2038,954,Radiant
8c44e74beeae42b249252f365414db26,1674,TRUE,1864,190,
c977026d59c47032a927aa59df037517,1567,FALSE,2596,1029,Radiant
0d2fc535eeb3958399427d7b9b64c6e6,457,FALSE,1300,843,
ba926cc106c62446b570f3e57e975b50,2291,TRUE,2457,166,
dd9be26caead2d6ea92869055a68544d,602,TRUE,2500,1898,Radiant
37576ffab0f0fb4b7c84a9f1a0d7081a,1480,TRUE,2431,951,
086c05b424521aad812510bc1e66208b,1711,TRUE,1939,228,
f6756daaaa2e7472155d494870e1e57a,1192,TRUE,1948,756,
35f6be87c42d2d271f2a3341b115368d,1943,TRUE,2657,714,Radiant
f8f49af7b00e2cd65a0ae247416e5bda,33,TRUE,2533,2500,Dire
dc1e7054b9c3789c296d446a8565cff5,291,FALSE,1758,1467,Dire
ec2854395fb065ce68babb9ca0b67ff3,1812,TRUE,3713,1901,Radiant
940ec2ad7b2f975d4cfdd745dbeaa57c,541,TRUE,1599,1058,
497794757ec84da96ca176dfbc21b82a,521,TRUE,3365,2844,Dire
2e65e1bb68623f90ceb302ca1e0f342f,683,TRUE,2833,2150,Radiant
6b5bcf0ab80216ecbb6830cfe9b1362f,958,FALSE,2215,1257,Radiant
0c9157f459a9292d43507a2f58bbd8db,842,FALSE,3245,2403,Dire
eb1f3fe062fe226c6c5e5011ce6b6920,390,FALSE,1682,1292,Dire
b899326b4a70cdb67a6aa5e06c3efc55,1539,TRUE,2129,590,
cb39154a8c05ddc3ff24a9e14e308d77,253,FALSE,1695,1442,Dire
bcd53675f7f442c7351686e5d068b328,1030,TRUE,2196,1166,Radiant
a7714eacef1649462d94a1b57fc99653,554,TRUE,1566,1012,
a6c7af0aa2c5628c2e756034361047fb,1232,FALSE,1838,606,
d910ad8793e12ef0d68b741f9bf62373,751,FALSE,2042,1291,Dire
7020063b33ef4b6ae747332e9d783ab8,1730,FALSE,1840,110,
77f9a76486e5b9a187eb76fc1f8884cd,498,TRUE,2599,2101,Radiant
3b1bf2bf4d9f3a12afca0eaa11cbcbe3,1068,FALSE,2096,1028,Dire
d5bbc848dd48f27eac20909079bc1491,1536,FALSE,2860,1324,Radiant
bed53d54a8efc1292f51d9b09aef6b0b,2584,FALSE,2679,95,
bf48a419f474f5648448ad6389787f6f,315,TRUE,2225,1910,Dire
9b9add811b55707dc594448332ea670b,2818,FALSE,2853,35,
1f9f0cc7e81138bd01ce048cafe3ff49,857,FALSE,2244,1387,Dire
b6261506ff608a66708005cfe9693b35,433,FALSE,989,556,Dire
d8e19426aaa4876456a33ef96334101a,117,TRUE,1618,1501,Radiant
5411dc4b9d3ada7263b103e97f2265b2,1331,TRUE,1933,602,
6939fb5b00cf361a84553e8c43a91317,582,TRUE,1010,428,
f7caef5789c4d53e7b5c186a67c0a8c7,1065,TRUE,2338,1273,Radiant
4a851da9b7e961baf2dfda52a8af9d35,2460,TRUE,2779,319,Radiant
437b2000c6f74a2246250cca5326a1bf,67,FALSE,3589,3522,Dire
a4e7a9ecc6915785606ef34f334ff8c5,1279,TRUE,1655,376,
356ea707369bde93b0cb68daa1f14b61,1769,TRUE,2536,767,Radiant
f6977e8dfca3b8da803226dbbb90f98d,1456,TRUE,2126,670,Radiant
70c53fb303d38e4a4c6bb0e63b161702,3313,FALSE,3499,186,Dire
ffe459c5bbf1ab9eb53a02247438685f,596,FALSE,1969,1373,
e92ad4136b1eab958a378e838034a88b,2079,FALSE,2271,192,
22c32436f3349c973b9931041a347200,10,FALSE,1709,1699,Dire
3251825fc959829dccd90e4b0ea97310,1846,TRUE,2313,467,Radiant
a45f78b1da66fd17d7ed0e9f86eaff97,1931,FALSE,2612,681,
a416496bdad5f79276bbf58b5a5aebfa,104,TRUE,1056,952,Radiant
56580e3d75168b4d724fe7e837e4d133,910,FALSE,1874,964,
e11900565f77ebe69f803e92816393a9,1474,FALSE,2838,1364,Dire
ad633b975d192ce3a28cafe0b4f568dc,688,FALSE,1513,825,
df9300526748207609475dbadd91222e,1178,TRUE,2520,1342,Radiant
955ee8996cb09f59843458ec3919e389,1063,TRUE,1877,814,
33f92ecdc3cefedbbcdf0fec0258b614,1326,TRUE,1532,206,
ad68034639e3694debb67e5ba96129f0,1345,TRUE,2847,1502,Radiant
d46d0c82287bb3ab5881fd19eac97e94,2415,TRUE,2476,61,
f28aeda28c078f84ae2fddce83a4fcef,921,TRUE,2005,1084,Radiant
4b61f06fe4b8f0001ca50c4c2af8e1d5,1209,FALSE,2459,1250,Dire
75e42d6a4a4402b86fdded1325255a60,586,TRUE,1709,1123,Radiant
c61b414cc73cbf71febddf9cb44fc713,864,FALSE,1482,618,
6f42bbb4aea24f5b417e213a80fc3744,1574,FALSE,2013,439,
6bf73c8a6bb14fde52ddf71dd540179a,542,TRUE,2211,1669,Radiant
467c6109f5ae847d6b76fd9e40337a6f,1547,FALSE,1790,243,
8a36f81fa014cbb1683b85747bb10079,1207,TRUE,1483,276,Radiant
05dd3ecb9f9479441c58cbde34604855,2482,FALSE,3492,1010,
146630737b3caae8376d6cb47944ea0d,1531,FALSE,2473,942,Radiant
767d2232c7ec07abe71ecdc6123cd836,150,FALSE,1876,1726,
70f997105645e832c57b5819eb52a0bb,1539,FALSE,2616,1077,Dire
3372b49f4cc2b1eeea7ecfeb446e5b07,300,TRUE,2826,2526,
694042ab2d2f1e2acfe302af04222454,1387,FALSE,3075,1688,Radiant
f553e36f26c935f9e0d59c8394b487c3,964,TRUE,2187,1223,Radiant
4f49e1997c74f1e3d42b20b3fc26cba8,1358,FALSE,1887,529,
1f674e3b4435e22affdb99d502614329,1217,TRUE,1519,302,
372c15034d000205307cb2c251f0518e,534,TRUE,1888,1354,Radiant
94f7afb65fc64f2920e90edd19e1208c,469,FALSE,2245,1776,Dire
ba08dad7b8880a5dd367119b91bbdaba,132,FALSE,3314,3182,Dire
c15e27ea0f8c275833b5a8a9b56b0574,1775,TRUE,2182,407,Radiant
ab2dcc64eb6878b07bd8ae7b698e131f,1370,TRUE,2148,778,
e54ee1059b3f7fc95273e22d95b9fbf9,2891,FALSE,3365,474,
6e2eb7757dfb2e9a6e5d1f99cdb7af2a,558,FALSE,2104,1546,Dire
63d88cad7cf9fb8e8812777154550aad,1109,FALSE,2666,1557,Dire
0c073239dc81797e88e2f30231e1e4e1,1394,FALSE,1849,455,Dire
af534fd22b7dceeb230370b7db9209aa,1477,FALSE,1513,36,
9bce2432ab8c6a3277b5d8cfc4700d06,1085,TRUE,2052,967,Radiant
2edbb158a656a1c08809bc095ca69d6a,610,TRUE,2378,1768,Radiant
7d86a473345011147f384d946ebe7644,1262,TRUE,2262,1000,Radiant
ff84e243c5dd96a02b2749e045eb9f14,2218,FALSE,3251,1033,Radiant
f1db0ae9f9e15a74a995eb7f120cf653,1738,TRUE,2378,640,Radiant
1504c106d57dd66888a327f5e12500cc,1088,FALSE,1455,367,
ea398cdf8bd0ebeec342195608ecbd22,1317,FALSE,2578,1261,
e65f5fcd07dd493f303567180e93c5a6,2971,FALSE,3530,559,Dire
189cf7ed1d2e5d2a52968b78ec1c9dd6,306,TRUE,1250,944,
5e525b7ebac8ba82de10cca020462bf3,1753,FALSE,2594,841,
aed5b7577dc1a96779447f7f556eb2d2,1706,FALSE,2600,894,Dire
b036701a828fadf2fdb5b8d955902da9,1211,FALSE,2339,1128,Dire
7422116416609aba7aca0455ac092bb9,1619,TRUE,2129,510,Radiant
385412294b57bf7270ebd2f3b0c1ccef,359,TRUE,2223,1864,Radiant
9bd2276c955e36ac4edd9cd397bb5dbf,1980,FALSE,2052,72,
78cf2a6082e8f4c2bee530fa85c87ef0,201,TRUE,2612,2411,Dire
2b00c506b77ce2a2da1b11d7fe6f3c59,1895,FALSE,1930,35,
3245bc0554304b554ef6ef573b04d348,937,FALSE,1330,393,
b11b4a1e4866567fc22fff479e284b61,2727,FALSE,3022,295,Dire
5b9db6389f492dc85b41d89a7273978a,409,FALSE,3090,2681,Dire
c265e356b238bae3ccc5a23f5753fede,1564,FALSE,2923,1359,Radiant
dd013dd0718a398995b34c74a41d30d8,224,TRUE,2843,2619,Radiant
576ceda48e3f47617c3e17036b14c460,1214,TRUE,2192,978,Dire
3b8ca337cb12084ce69fadccfb20f4d6,1922,FALSE,3460,1538,Dire
ec81766745568f8110b312b84c528bc7,2349,FALSE,2392,43,
9155d324904bd80dc9a4f535750b1f57,2302,FALSE,2567,265,
92b5f578f2700c29f5cfac7539bb8167,1142,FALSE,2397,1255,Radiant
38414819b6786d20d7a7036e702e9928,429,FALSE,1918,1489,
d3f6aa102e39f7f23343d8518fe7085d,134,TRUE,2161,2027,Radiant
661bab1e8aa65be3eccd8f99defc28e0,876,FALSE,1262,386,
ff31ff71410d78c0192e15aedbe6f31a,1197,TRUE,1298,101,
1bf389b0162af9942edf547a3c56a9af,1126,FALSE,2240,1114,Radiant
713f577cb1dc3fbcb2653e0db8c72e6b,35,TRUE,2353,2318,Dire
4694b59de19fbc6b9039d173da0258d2,172,FALSE,2403,2231,Radiant
c8fa25fa757601275b56df0e6aed4fc5,271,FALSE,2777,2506,Radiant
e21040f5bfb055654be5934546ed0943,334,FALSE,2484,2150,Dire
ef0fc807fe9c838e6d857560ac5d9ba5,1671,TRUE,2187,516,Dire
23783e3e35ce236a181ffb68a9309c95,129,TRUE,2046,1917,
d05ef9c8ab7c43204aeec56df5479b46,925,FALSE,1998,1073,Radiant
6e15d855430a775c9522614939876333,2002,TRUE,2169,167,
dcd5f822df0431b36f622ec5bb8c3270,174,TRUE,3393,3219,Dire
7b6ae9e72747e5805a25d2af2421fc41,2075,FALSE,2523,448,Dire
f771863390cf158544f7cbcc5d80282a,1711,TRUE,3078,1367,Radiant
cf951abf360ec91f4c90a3d98d1cc71e,1633,FALSE,1849,216,
35011e2f31ab4e51540f5b6e2a3f3a52,1087,TRUE,2121,1034,
d25daa8b875c3e05e0df5f8bd96aa87a,286,TRUE,1352,1066,Radiant
7a1f74085b532bef3ebff4c7a1b72afc,366,TRUE,1309,943,
884c681132f56089ab432fa43494057b,1891,FALSE,2150,259,
f15bf445906932388a9cd89a99e5d8c5,1200,TRUE,1941,741,Radiant
7d20b907352777afac7944b4170d5808,396,FALSE,2239,1843,Radiant
268cd5d32e5765bda2e3f6b3aee5edf9,1021,TRUE,2872,1851,Radiant
9a43b1304d560e4f36981b4d2d3d3826,2232,TRUE,2502,270,Dire
08eaba4c14aa361c67030618582ca10a,2033,FALSE,3570,1537,Radiant
a590378de9f12b3ffe82a029f028be95,2583,TRUE,3382,799,Radiant
b228b29e9cd89437576fe8723749b8d1,2123,TRUE,3507,1384,Dire
532b3f3cfacfb55f70f2ec352a54f5ed,1098,FALSE,2117,1019,Dire
f4b2e55c9e29a13b34163645ea078bde,241,FALSE,2125,1884,
adcd1a73324a20d5945f31764a3027bd,364,FALSE,2662,2298,Dire
246b402da18acc46ab95e97b17cd22de,2469,FALSE,2877,408,
156cf5156e9ea24bda5aadc01425ffe5,1708,TRUE,2274,566,Radiant
a9e1385915f4f7950bb8624d29dc03c2,1470,FALSE,3586,2116,Radiant
72075950694414106b925f3943794b37,584,TRUE,1993,1409,Dire
64f9ed0879f0747e68cabaad4e5810b6,1757,FALSE,2371,614,Radiant
b572c97199ec294720944304d0d313d7,1149,FALSE,2814,1665,Dire
721e45b15fb0ce84577510712f5cdea9,34,FALSE,2663,2629,Dire
88793720286c08d94eae5d40481e9385,2082,FALSE,2675,593,Radiant
5b0639559f4226c975241ea58e71f5a2,1126,TRUE,1784,658,Radiant
e278552e6d18ade128796cd2e4b66c85,651,FALSE,2875,2224,Dire
416d50353db5b8c30485cb7dcd0b62c8,2128,FALSE,2246,118,
f6c1244383aa09034e85cc919d0f35f7,845,FALSE,2973,2128,Radiant
55b7e6f2b332cf0aa5d04a09cd6290b8,1,TRUE,2518,2517,Radiant
446cdf7471a9b7ab7e8b43d13b93cfb3,1142,TRUE,2079,937,
bd7843e2e648f3355136dc9a18e71fc7,388,TRUE,1278,890,Radiant
ea86b2e2ec167871602fedcad4a95f71,776,TRUE,2732,1956,Radiant
b64f9330e48d94912c5ef86fb89cafaf,1643,FALSE,3384,1741,Radiant
c60be6d34bebcdacc007b055c7470ac2,726,FALSE,3618,2892,Radiant
5922950d2d4090b5fd2fcd9f6b0b6762,2785,TRUE,3001,216,Dire
4b5ad994b5b12dfabe207d2fd7295dc4,1610,TRUE,2838,1228,Dire
72579f5b066edc2abc0bc07d084979a5,1760,FALSE,1966,206,
e69bf38b70b3e47d031abd0224dfc632,1422,FALSE,2093,671,
fd8d62a7fc30bdba5ce6b67588ac207f,2272,TRUE,2394,122,
b945a04ec7dc1f653b9e69b52ff782b5,872,TRUE,1824,952,Dire
db51b2ec3f1a9f55f8c24c4b5937f973,1579,FALSE,2327,748,
485bae46d62f5e397c679bd9734a5351,2947,FALSE,3078,131,Dire
c37d26e06036af6386c31e865471a963,721,TRUE,1905,1184,Radiant
412461b22d9446c46bb4a8b075c32f10,45,TRUE,2983,2938,Radiant
e53e6491304cd3ae747cbf0d91fb0e12,1664,FALSE,1841,177,
a9fc5d467e996b3549ce4f02c8f565d5,719,TRUE,3502,2783,Dire
2e786f52ee80b5104dca4117621fe9a4,417,TRUE,2237,1820,
8020477c3ffe668aa5ba41e2f17ebeb0,53,TRUE,1663,1610,
6452444680b560b6b64375fda0c73f40,1349,FALSE,1878,529,Dire
8816ad74ad0661def76d79f5a8305b4f,812,FALSE,1837,1025,Dire
094f43cae8e29dd6ea7c71cfce984b18,536,FALSE,2442,1906,Dire
65df73207c039fc5d8b5f5e2802feae3,2178,TRUE,2287,109,
cd8afd8580746833452f5259d13b6834,1485,FALSE,2162,677,Dire
dc74ddfe332908ce0c76e8eaf8d6da6e,995,TRUE,1749,754,Radiant
8da3a923dfd5a26623aa7a986ef19156,1300,TRUE,3093,1793,Radiant
53ed536f5fa4e34ac06a0c819a1fc6fc,1618,TRUE,4187,2569,Radiant
dc4e417057cc4c5e0ba9d52f4e3d56b9,1096,FALSE,1977,881,
ae7de4de622a98f4f626ed1def479326,19,FALSE,2911,2892,Dire
c1735f017e6b03576668f904443ba5b3,870,FALSE,3109,2239,Radiant
1fc47e37725e163d6e599daaca5c041d,401,TRUE,1810,1409,
860a72aae24a1d77afdaef426f90c124,1478,FALSE,2842,1364,Dire
75b470ee5004a6c0502586d6396d0615,2168,TRUE,2793,625,Dire
3f3ceada8c1248d12d0b0f888824d768,1103,TRUE,1584,481,Radiant
95b5bf8442e9f72a9f16abdf351084bd,800,FALSE,901,101,
5229a639010241284178171094868d6d,1831,FALSE,2794,963,Dire
a0b8aed2c8bf865bbf413592b8a3c04f,3329,FALSE,3390,61,
36582568f4448894ec977e67a464fd98,647,TRUE,2855,2208,Dire
e97366d2b0f46c024a5e774015deb7cd,522,FALSE,2435,1913,Dire
1fb61c8056d277c6d38d04b2409b5ed0,1280,FALSE,3198,1918,Radiant
d13f0f5fff8001facce8cfd5e20e9bfb,6,TRUE,2303,2297,Radiant
81c80cb2c48813666a9dd9c70b93cc33,477,TRUE,1898,1421,Radiant
d48067c421f9d14e77b32e447904616b,341,TRUE,1976,1635,
b9985393d94a877ef6613947bf7a337e,2086,TRUE,2560,474,Radiant
2d234d16c15e5ef62be646c164e04de3,325,TRUE,2149,1824,Radiant
f19f632ffa3bdf50bbc14e8078d0aaba,2479,FALSE,2995,516,Dire
d513ca0dca0e4687bcc329bc0c2fd314,1163,TRUE,1230,67,
1dab6fdb92fe475c297326f7df4c9b59,1030,FALSE,2457,1427,Dire
ab8bd27e20a99129a36a28418e61ace3,1214,FALSE,1679,465,
9fa68a37401306d40eef1195bd302c64,2103,TRUE,2793,690,
be639318abb405ccf0b85226fcb43f23,70,TRUE,2275,2205,
bbce30e26baedec82e37f183ac8b8044,2414,FALSE,2549,135,Dire
00680b1ea7e6066b0a2bf4ed6057a032,2449,TRUE,2611,162,
1c0cd09b3a48dc944967091f48edbb00,350,TRUE,1042,692,
46d2aeefddba8cbcba83baf6b5ad227f,1210,TRUE,1318,108,
c2cb5feadba0d6d43ba9f4bb735f6b0d,2100,FALSE,2253,153,
6ae4de98776429b9b5e7cc6310e0c813,1751,TRUE,1799,48,
c5836f96e1f757bc304407ae473f3a85,881,TRUE,2238,1357,Dire
efe56358d615ef0a7aee127bf36651bb,3155,FALSE,3595,440,Dire
1d7f0d05f9976fce5241dc33d022f061,618,TRUE,2260,1642,
48a8fb39baa6bfd8ca494a4c52977a44,1877,FALSE,2383,506,Dire
3e8f59f80237c3aa9a502e94bb9721b4,51,TRUE,1589,1538,Radiant
4d7d00b0c14ea8f65f64fa75f8481967,1655,TRUE,2129,474,Radiant
b39abcbf32e7c98500bed62646cd494d,731,TRUE,2870,2139,
43179752d1ee75baeaea97750c507162,1959,TRUE,2438,479,Radiant
bc0a469adb8d569e3295c7dc8e4f33b9,1191,FALSE,2742,1551,Radiant
c1bb85a28d2eaf919b47d6e9a15391a2,308,TRUE,2775,2467,
ed6dd4d1f0616cb1cb76b10052690f7b,1246,TRUE,2452,1206,Radiant
b172fd9da1fe3b7ffcc3a8ee5a8cc57f,71,TRUE,2334,2263,Dire
13c82cc6993717e1b6e8fe1ca35ab65a,647,FALSE,1576,929,Dire
2ce77ece91a35d324f7ba31702684e34,1064,FALSE,2969,1905,Dire
620ae1af9bad27736b079f8141c55200,1814,TRUE,3410,1596,Dire
51f34fc73f55456df94ef04a0247cf2f,61,FALSE,1081,1020,Dire
b99f310ca9090cecfd3e779750364be4,2159,TRUE,2335,176,
49b03a51108bb4ea7887d9370ac6881f,1401,FALSE,2872,1471,Dire
63757a1731c28c1a719ac1c82c487ba4,1861,TRUE,2320,459,Radiant
7c2acabcde82cbc65b74067612758f96,682,TRUE,2156,1474,
c41f51e1e88a8312e9fb61d734ba75a0,90,FALSE,2511,2421,Radiant
2061f6865ed64154b42c57b81850b2bd,2134,TRUE,2350,216,
eca093f818321d001165754cbf7ca803,1202,FALSE,2859,1657,Radiant
fd9ed5a3396a209412a6d947b6692dc8,43,TRUE,1150,1107,
ff20926d98c44a8edba459e5a45328e5,465,FALSE,2315,1850,Radiant
6b261b252c4e3b1038db6a6b29a580f2,2044,FALSE,2203,159,
2021f16d39739309480b15505e412647,705,FALSE,2783,2078,Dire
c2db567a20c0cb8c44828947c49134d8,1967,FALSE,2724,757,Dire
eb44b221791fee835563614381e9b0e1,1130,TRUE,1677,547,
423f6b9ce1ba723ec461d5c546ac4d4d,24,FALSE,1070,1046,
772810e03c088bd2f84c4160893b9719,497,TRUE,2636,2139,Radiant
82e1b94b8bb9bcfab8835ee5126045ff,326,FALSE,2273,1947,Radiant
7798ebcef4db9d23cf48f1745ec25728,1286,TRUE,2683,1397,Radiant
9537a803f82c7dd6a2f283ccb202e5c2,695,FALSE,1764,1069,Dire
f1f0542ab550a80754a669e902a3c61f,1693,FALSE,1845,152,
d855228f841cb14bee8bce3c285daf0c,1164,FALSE,2376,1212,Dire
976da620ef686b492d407f57c7e071f5,606,TRUE,2761,2155,Radiant
6e2eee01eb3df09fd567d88a7d45dc5b,1233,TRUE,2051,818,Radiant
02387481cfd68e80287eef448905f4bb,1318,FALSE,2011,693,Dire
b111285a03052a45ead9ca16b58b3bf3,1410,TRUE,2426,1016,
c767d285420403524ee24b4ea6aee483,2402,TRUE,2553,151,
c101eefc34dfbc6b64e2cd4b0f127969,2463,TRUE,3407,944,Radiant
052245b2c002691b45506ed360bfb1db,1018,TRUE,2804,1786,Radiant
85a99060eedceb34dbf191fe4b0bd6d4,1469,FALSE,2759,1290,Radiant
16f951dacc055b1b41da3b4c7f41f96e,626,TRUE,2327,1701,Dire
162270cd969e41f6b252e9d159128996,1083,TRUE,1209,126,
f2afd79f3ba9b02f7ab3c65f56627c37,1567,TRUE,2013,446,
d4bfedbe77026ae8b624df8dee3e516f,156,FALSE,1886,1730,Dire
faa13c17b140e95f8e6b3a9d4a692b0e,2846,FALSE,3081,235,Dire
e8ded7aa23188cf6f62a21ed69198452,2718,TRUE,2878,160,
def53c42e76d3da0ef71e8a9b91a7e33,2141,TRUE,2726,585,
05439d2abe4a7b05d6f1dfd9e6759aed,1710,TRUE,2006,296,
b0992bdb135f82f96a9132fdd3dbdde9,213,FALSE,1229,1016,
51ed31e0a6f3b1d06beaa5aa00a4a47b,3343,FALSE,3732,389,Radiant
2a61cc0a32fd7ac812965cb10fc8a435,683,TRUE,2496,1813,
69fae3a7da110540667ef9425e8cd3ef,842,TRUE,2526,1684,Dire
3e07c362e5e1afd3da26d08adfcbb301,297,TRUE,1953,1656,Radiant
dd28c4a50ab154bac4057c06f9235e92,224,FALSE,2708,2484,Dire
b39ad60894f1c26a0b99c01768a4d4c0,487,FALSE,2394,1907,Radiant
24adce2c937075b1a44d4adc629c30b8,1545,FALSE,2413,868,Dire
cf87c4067d4a1e3c97a363b8d953166c,501,FALSE,1497,996,
5a4755e3a39b80fc509729c8ffcfc057,988,FALSE,2298,1310,Radiant
77588646d089f575348055b3ccc2b39c,4,FALSE,2480,2476,Dire
03a32fd01fa5e642c468572152443a36,2481,TRUE,2822,341,
f24b55176c6b1356a95f2b79b5180522,2119,TRUE,2526,407,Radiant
8ee7f3d375f07fa4e4d21dd4aa512478,94,FALSE,949,855,
5574a83032fa35fc06312d988e38f930,1229,TRUE,2207,978,Radiant
c024ecc478615f0e5629520dfa6a71ba,50,TRUE,1267,1217,Dire
ef9c2155f8f50c8fee245a2e4eb8e7a4,1547,TRUE,2739,1192,Dire
249b997bbb07f6f137e7dd768cf2ed5e,887,FALSE,999,112,
daae676e5c642a77f8a30e56d6d56f70,1179,FALSE,2949,1770,Dire
48e29d3767cea228e371cc24e147acd8,927,TRUE,1666,739,
e989db02be3105babf16e7f7bc7ab4f0,726,TRUE,1869,1143,Radiant
80e3af6ea66338597d1456d4156fae42,1237,TRUE,2998,1761,Radiant
73b0a8904ac6dbfd73b318bddfec8391,1175,FALSE,2012,837,Dire
1698fc1a1f15dda015b12838624a33e6,2347,TRUE,2496,149,
06726e4117db39b5126069741a331ac6,2594,FALSE,3756,1162,Dire
a8fb01b8356625c90e8ba5c9c83f0826,593,TRUE,2799,2206,Radiant
4f63f5920ba92fc9e4462f98df686e5b,26,FALSE,1313,1287,
9ee412768f339aabfe4f7126f4e9d3b5,1414,FALSE,1996,582,Dire
524abc4708f4afa2d4b3139de2f921aa,30,TRUE,2176,2146,Dire
9d05c238e5141d7df2b4beacba7047e2,1460,TRUE,2578,1118,Radiant
504e6f8664bd1a701db1c0ac20e6380d,1174,FALSE,2200,1026,Dire
d01514a8c1e11ece3b53f2d41eef829e,283,FALSE,1538,1255,Radiant
348ebae120d149ed9a9a55cedd550676,175,TRUE,2525,2350,
2bdf751b8c06564a7fbe45b5b694ec2f,328,FALSE,3135,2807,Dire
14d035203686094496eb3774e84d4751,1091,FALSE,2549,1458,Dire
bcd3d7d86c16cd0a4aed6714e4225fa7,944,TRUE,2286,1342,Dire
a6e92d1369e8ea0d54f0d13fc658b6bb,863,TRUE,2462,1599,Radiant
91ed9b6313bf83b1eb7692660a42ef1e,1880,TRUE,1929,49,
cc60c7e762939f49a1e3599a5d1ad64c,557,FALSE,2362,1805,Dire
e5b49a815f84a1daff61a620e89ffe54,315,TRUE,2085,1770,Radiant
30be9c03be5f345b9df60881b935bbc1,257,FALSE,2417,2160,Dire
e59dae7b0935259e109e26335988d55c,1922,FALSE,2795,873,Dire
bc3f8d1d8f02bb6417d7b169aebc3af3,1315,TRUE,3758,2443,Dire
dd1640dca46132510c4fab8ce98e5f10,1060,FALSE,1860,800,Dire
563069d32a63ee55244bce4dfca8c72a,2275,TRUE,2553,278,
a6fd33008d16dc05749ce81e330462b6,1569,FALSE,2363,794,Dire
d25da39f1389eda8a941febcc7c0263e,220,TRUE,2740,2520,Radiant
568e57432109668912b877c8f6be2825,1422,TRUE,2610,1188,Radiant
00f577362256effaeefdf09d741be7a9,39,FALSE,3764,3725,Radiant
65b6b9f670ae72ee93480ead1ad14f97,331,TRUE,1069,738,Radiant
f3b1f2cbc57a4c72fe779ed3da3f0367,920,TRUE,2462,1542,Dire
08db9a277ccd58b39bca68af6bc17de3,731,FALSE,1857,1126,
085a7f2e5afd73797b812f927a3ce6fa,872,FALSE,1335,463,
41fcb19c06a0b6d1265b145c74b5f024,1527,FALSE,1667,140,
1e81697283c46b809547610827e696f4,299,TRUE,2684,2385,Radiant
6d336fbf2f945f0a47b0cae5b27b9445,875,TRUE,1058,183,
7f1663a45d192a962d3bae8f7e4b4559,1438,FALSE,2420,982,Dire
5d68db1544258c23c299f8dc2fbf5326,843,FALSE,2760,1917,Radiant
ba32ea7a0b61abb01ddda35dd5e7c4c8,1488,TRUE,2105,617,
d123749f15db7eee9861eebbbd3a156e,1057,TRUE,1766,709,Radiant
6f0cdb127954d36075f49a6d0c7aaf4c,349,TRUE,2325,1976,Radiant
680b742f7b1a398802404d8571c9ba70,732,TRUE,3064,2332,
bfd07073c645857d47f0501d4aeb63bb,1266,TRUE,2900,1634,Radiant
d9a9d40e4100af7184651f53b6262023,1245,FALSE,2095,850,Dire
4e9be1d0a4a36959d3b0c1ed4ea07b69,1018,FALSE,1522,504,
7e7e97f130875f092f5266aff36309e2,188,TRUE,2168,1980,Dire
23427068fbcb553b8ee1975c86fc593d,1059,FALSE,2752,1693,Dire
92c787fc67bcbbcd5aeb7cc07abd1a61,2405,FALSE,2436,31,
3dc82f95d10f791b7e90320b0cabbef0,171,FALSE,1759,1588,
03f1c076b4ac6690a7dc0c0a0d26f454,1335,FALSE,1892,557,Dire
44a4f0a5552def3811b8f162e2eb3cd2,1739,FALSE,2482,743,Dire
03a565c39e3339b4f626a359b7b902d7,1395,FALSE,2159,764,Radiant
e919cd23d14ff169258c6140732d1b22,224,FALSE,1403,1179,
a4604ffad34c7d3abd113a527c47a1ce,2179,FALSE,2219,40,
0c07709e37cccfdce93a77a5eb018037,961,FALSE,3479,2518,Dire
6a38dfbb87f46e3db36e09823c21a805,446,TRUE,2370,1924,Radiant
6af4190391c19bcd504224d884f1ce21,790,TRUE,3308,2518,Radiant
e12c3f0a1d698ba85b9f786672cb1425,322,FALSE,2752,2430,
8fe8871d368785c641729af0407a60ca,258,TRUE,1594,1336,
b627f8c24ce06090cbc9c9228c0e881c,399,FALSE,1361,962,
43d3c618e405764ab5b4bde02f4d3fd2,1528,TRUE,1923,395,
b124d263c46dfe250c4854887639063c,2245,TRUE,2526,281,Radiant
22d00e44f09c2f822e28eb0432a05719,268,FALSE,1444,1176,
fd4a9d7162a52ee5ffb5417302ecd071,973,FALSE,2541,1568,Radiant
8e3aee4a494def0a3117156bc812b0e6,3329,FALSE,3452,123,Dire
f7e5b11d7144aebaa6a4881d9feb3938,3003,TRUE,3965,962,Dire
b0d99d50571dbc995651230d1f01c610,2153,FALSE,2782,629,Dire
a5a970289614767b52210dfb76b8015f,186,FALSE,2902,2716,
237787e9079c1d8555b269302761ab5a,2186,TRUE,2860,674,Radiant
c9ce6b1ced19d2438e9e2806d6aff163,2197,TRUE,2391,194,
3435c2fed4d0c1a5bec1f50b186d7ae3,1494,FALSE,3154,1660,Dire
02d82982570e5f598b11e41af04862a5,704,TRUE,3037,2333,Radiant
5f3d8d93dbec0c324ccf10f87bcbfcb6,1019,TRUE,2765,1746,Radiant
f443b4143ec912b30b9223b022c5fcf1,1255,TRUE,1756,501,Radiant
214520a0a1692030f474db26868fe7d7,144,FALSE,3094,2950,Radiant
4dc840dd2ca9f5fc0c7ff8ec26a562a2,2254,TRUE,2565,311,
8ea35c56b8d97fb5517c849aa3398ee0,802,FALSE,2104,1302,Dire
39c66512ba579c0b5b9308219bbad3cc,362,TRUE,1988,1626,Radiant
e655a2363dec3b2c0e177b702d73d0ef,815,FALSE,3017,2202,Radiant
d278973fd86e7c485ecc191b6c260585,104,TRUE,1909,1805,
79e3a556170d660698d05c57d77ed3ec,542,FALSE,1269,727,Radiant
2e63d1c85e68304e6a97d303014a8b59,1678,TRUE,1908,230,
8ea30abc0983ba92890f8fef50dd7df3,332,FALSE,1747,1415,Radiant
f44d82bc113b4400b2276fbf6f42efaf,1624,FALSE,1898,274,Dire
0470b9e05f1de7aef5d39f244b713a59,2734,TRUE,3218,484,
89a3ce8bcd896e3d43c2f96b8292fe6f,1062,TRUE,1147,85,
9f4abae81f7fa297217ef86f18ab5825,1889,TRUE,3052,1163,Radiant
a218f621523b6ab6df1505418e6b04f1,1975,TRUE,2194,219,
0e4b18c0cbe404c6d13815a3f542677d,2010,FALSE,3121,1111,Radiant
04e2623cb0af7b24d6b2f8f79f21f4e4,313,FALSE,1644,1331,
13a5f81ba3dac72e7585d9e747c6e3b1,892,TRUE,2187,1295,Radiant
a403e3acde06822c0190aa923c7bdc43,1984,FALSE,2484,500,
3ce43945c5286397c4603c37698dc933,184,TRUE,1247,1063,
4906881f6a83b31015eb1a973a765dba,142,TRUE,1273,1131,Radiant
eab7dddb680f241fc6491437af45551f,1833,FALSE,2495,662,
b7e38aa4e68c26086001efab2b66f26e,92,FALSE,2011,1919,
26deb0eef1db9176d752d1542448274a,2002,TRUE,2487,485,Radiant
eb2dc423aa2fa21f6be767d9921cb27f,1243,TRUE,2022,779,Radiant
cfd4baa78c37ccff71becc9d1c8bada2,736,TRUE,1451,715,Dire
0e68dfdd1d37db586263e23c0c489176,1903,FALSE,2607,704,Dire
53c108f90c6da57a75b8ec0fa27f4cdd,3063,TRUE,3566,503,Radiant
63e6af95286d09db35973ad1abaf4bbe,658,FALSE,2936,2278,Radiant
bef79055c8b595c72d155be44639a20d,1459,FALSE,2024,565,Dire
370cde50887e600d3c23a092d6959c79,1589,TRUE,2214,625,Radiant
2e8d4df0ceac5057ece7ca8984e417f1,1741,FALSE,1955,214,
6ecac0da57a19d275c2198d32237eb4c,779,FALSE,2779,2000,Dire
ddb3e0b5588d8d14721a96dd2c01e475,891,TRUE,2845,1954,Radiant
4b387c7859933f559191dcefd40ac6fb,1391,FALSE,1713,322,
eee717a87a968014dca43713b393f587,688,TRUE,1880,1192,Radiant
4073458d2f5b9d93408de36d2023fb71,1156,FALSE,2131,975,Dire
18d7e6d205fa6be4b4d82ebe52487cef,2336,FALSE,2868,532,
a59fde49c361d8503cea6ac729ae5d8e,2670,FALSE,2877,207,
85ffe79cda2b5a91c831a0805fc2d59f,984,TRUE,2097,1113,Radiant
1a719a7c661be4b56250a44426b43a09,1293,FALSE,1398,105,
b956ee8136c5667589a6f16bb9755566,245,FALSE,1727,1482,
155c863a2a871fa81539b3d7efb9e97f,1628,TRUE,2444,816,Dire
6fc877c0de3d0c1c4b18378817291e03,1621,TRUE,1737,116,
23d72ed889c840761c9f33fdf8f5a2aa,523,TRUE,2339,1816,
e5257034294b0bc591f24877dd67a5ea,1098,TRUE,2671,1573,Radiant
3c5cd24603dfdcd2d4f3cb2d3f56fb11,943,TRUE,3008,2065,Radiant
e085aca7ba8ad4983d4598d048de5332,402,FALSE,1516,1114,Radiant
81da076c1885cf4ff47e74038a53cf63,2172,FALSE,2511,339,
f3fce7f553985c721fdb15a2e66eb889,1951,TRUE,2297,346,
30e6075ca816a8c1219f042c350a9151,2220,TRUE,3253,1033,Dire
ba26466625aa50ed60ac6c06bd8fdb2b,1299,FALSE,1883,584,
10325eae0a5a92bbec7e296c98fc9b00,1730,TRUE,2283,553,
5ecca4320c22bceff82e654c648cd852,1702,FALSE,1764,62,
4d6031750285e3d71f8b03f23fdce7ba,504,TRUE,1303,799,
c65c2a3d8fadab2d757e5439040e06a2,716,TRUE,2151,1435,
3f534b953fce81dfe520c099111eeb14,1565,TRUE,1842,277,
141f01ca3b01dd0979b2b0d7c1ae5838,1047,TRUE,2126,1079,
d0fd27b48eac44113631c8ab3ce6f815,1724,FALSE,2616,892,Dire
711aefef279284331c97ddc1690ed200,785,TRUE,1655,870,
e39d415727a37c450d264bd275762da0,488,TRUE,1960,1472,
fda45a2710f8804fdbe24a3900e9b37c,794,TRUE,1916,1122,
4cfcd843acb9b79384260d3ae7832190,1030,TRUE,2772,1742,Radiant
a2b44949354d828250b425c6242601ec,3331,FALSE,3782,451,Dire
66b035c70e37a757d96c7358924a032a,1331,TRUE,1633,302,Radiant
0ca90b6e76e07dec39a73b6f37dc0c12,1569,FALSE,2246,677,Dire
5d697e7c2874f78a40e3e19641bbb726,417,FALSE,2302,1885,Dire
114012eba83438bfbac4f5f33d72c0ac,3748,TRUE,4140,392,Radiant
cfa954f4f924ef43dbdebc3c37e03bee,1248,FALSE,2087,839,
3a259debdf67ecbdab5e7b7b68fa4162,1589,TRUE,1732,143,
3c27e84db7e445a1776af4377a4fb947,416,TRUE,2441,2025,Dire
45fcd404929a3ce2106920c2346d5ece,2179,FALSE,2234,55,
8fae5fa6a6278289e7a58ef52f58599c,280,TRUE,3573,3293,Radiant
8faba225ac797dbfa659887fb0077e01,720,TRUE,1752,1032,Dire
24b380f05eb0ccdaf88348ce089da670,535,TRUE,1969,1434,Radiant
e73c522479e7b810929e8e0de46a1444,923,FALSE,1638,715,
84e841b9d686691e6eb40c9cca58a0a5,3424,TRUE,3961,537,
5c5b9cff390a3bec46f67b52eaec48a3,283,FALSE,2091,1808,Dire
1c405a3fc2dfc73e8e8e5c07dc9226e8,102,FALSE,1878,1776,Dire
567c915796b6ef640ac924079d326a77,602,FALSE,2769,2167,Dire
804b1df1de1abb5abe1c139137e463ab,1753,TRUE,2217,464,
f512f4d54d3caf0ced5b17f082150796,873,TRUE,2605,1732,Radiant
20f770fda2f5a821c3bfaac3949dd385,196,FALSE,1911,1715,
402c989be906d636dd3593b9ae44b030,341,FALSE,1268,927,
9d53049d39f63312504bb4738971a7bc,611,TRUE,2453,1842,Radiant
c489fdf8f19953a12db5e3b1a5cb5074,1808,TRUE,2189,381,Radiant
1a8640691bea943aba8f690d2ee32e10,79,FALSE,2034,1955,Radiant
97c578663ca181b2ad994ca4975ab91e,2898,TRUE,3181,283,
f3fdfbc2728a684ab17434a6d69a6174,851,TRUE,1975,1124,Radiant
b6bdc9cfabc65efeddb7c7d38d7cef9a,771,FALSE,1083,312,Dire
901f9878d1e1eb2af78fd3cbff040330,3053,FALSE,3332,279,
d047a20646eb3802cc96c01199a38ada,728,FALSE,3357,2629,Dire
34c9728aa214c7c11d872463c324af00,177,TRUE,1961,1784,Radiant
812c85c442f40e1d11f8735f46362165,1980,TRUE,2326,346,Radiant
95b28478c3c1336e98f9187a2444a51c,1805,FALSE,2853,1048,Radiant
8f0f9c3b3e33239c5abce9780a52734d,237,TRUE,3394,3157,Radiant
6e31f6f68b964660a2c0cc5269bf05f0,710,FALSE,2060,1350,Dire
1dac462ed6cbd3ed0797225d5d986e94,795,FALSE,2393,1598,
b0f9958b7522cb2606fc1df09f9d85a2,1204,FALSE,2107,903,Radiant
f5818c5e5b5943fa0bd8ab1641ec2c15,540,TRUE,3632,3092,Radiant
9308503c3f5affdbc11d71b057e9dc49,1160,FALSE,2220,1060,
4ee977395549ee0ded26b345fe0123b7,1217,TRUE,1458,241,
a801fd015fe7079abeb635d56a6b19de,1631,TRUE,2973,1342,Radiant
0ab61a4833a54341ebd4169b7d603000,1505,FALSE,2460,955,Dire
115104222870e4f0c37a453ef61271fd,425,TRUE,2551,2126,Radiant
d9415fb3ff2dc000c2c350ff8b190800,731,FALSE,3023,2292,Dire
53aa1978e499e7022442cf37ce791c2b,668,FALSE,1570,902,
e4a14c672820e2f61f85c7eb1031a2ed,801,TRUE,3561,2760,Radiant
17fdcd3a4ec58a80ac10d60cd2b31998,710,FALSE,1755,1045,Dire
ee1b8c7376d2dd4d44ac936beac00923,2081,TRUE,3099,1018,Dire
69efe1ed3f43e875c56b5f3ec6bb7126,2238,TRUE,2536,298,Radiant
b8a51465705740b1851d159fb28c9871,1135,TRUE,2107,972,Radiant
1e79f633b845897ecabdc9c8d19adfc9,1938,FALSE,2506,568,Dire
bba42e1c4c2e0b8f81fd8e591f831f2e,415,FALSE,1170,755,
456c8ed1e08363b289b1020d8e812bff,533,TRUE,1795,1262,Radiant
57ade8d66b1ae183516d760a9c058729,954,TRUE,1555,601,
32b1343d946fc3d94570f673eed79392,105,FALSE,2351,2246,Dire
7ac320b279ff500e0d7dd02025d780ed,976,FALSE,2004,1028,Dire
22fda769feffbb67d85165fd7a8a7be7,1007,TRUE,2108,1101,Radiant
58c615a41bcd3ce26ebed91c3c0afacf,2613,TRUE,3249,636,Radiant
7035d390e79fc19d20c29195ab29b1aa,265,FALSE,1200,935,Dire
9e96343ee1ad252fe83ba36f6c9a3781,2293,TRUE,3096,803,
a54add612d66a74a0628ba949d6e397d,2077,TRUE,2603,526,Radiant
dcc2544e6959b139d3e1fa54e7516d0a,1860,TRUE,2084,224,
5b13fe5c6cd173fbb1d733cb3ab4bc3e,1716,TRUE,2036,320,
e1e2fd2720a840481ba27bcbc2d77a15,816,FALSE,2330,1514,Dire
ee6e3970ea134ba0a87556ed5e06dea0,745,FALSE,1608,863,Dire
4fd5a1bdc3e7405aca43985a4fae2832,2463,TRUE,2922,459,Radiant
d8b0e93baa38356cd35233fdcb6591fc,2952,TRUE,3624,672,Dire
c88b4c033741b55b8b85b5352c4c400c,1649,FALSE,2380,731,Dire
530106b7eb4b20bac91b48fadbf5cfdb,399,FALSE,1503,1104,
c90153baeecdaef0dcc89f31537c550c,2238,FALSE,2574,336,Dire
cd4cbc8c276dc8eede21f9413d7078c8,1059,TRUE,1660,601,
12aaa908d28cf3301570f9028172f1ee,570,FALSE,1551,981,Dire
3394cb2e578cb06cf66125417391adfb,83,TRUE,1663,1580,Dire
8d07adb93e0aa5e19bb9240fecbc10fd,169,TRUE,2746,2577,Radiant
5cb2aaacc97b1b5f5eaabd27203f138c,1477,TRUE,2096,619,Radiant
84a6ff7d7c00e0df382dce7543122a51,420,TRUE,3628,3208,Dire
dbe21e48854244bcc28858ac3138136e,238,TRUE,3099,2861,Radiant
bf370333b2769e73d731491a0b3c3008,1673,FALSE,2629,956,Dire
4b2b77a5bc70b3599e8b3f04fd844445,576,TRUE,1929,1353,
1d3c7d281d81da5d9d2b71ab56a0f9af,953,TRUE,1195,242,Radiant
0e9b567afc1b74ab760b8392a95a90a4,1664,TRUE,3910,2246,Radiant
58819b2ddc5fb1d429c5fe1c19ec54dc,1880,TRUE,2408,528,
c426083d13e1c30583aa1fb214107e6f,3104,FALSE,3296,192,Dire
c4fa4632a715b7e3594eee5f5125bcee,915,TRUE,2193,1278,Radiant
e7cda68cdd01f2872174a5aa5a86c5c9,1153,TRUE,1668,515,Radiant
2006db1aac6dd325bede5d107c87f3b3,737,FALSE,1224,487,
dd80d108a348160c8e1bd1a6d8e600d4,287,TRUE,1179,892,
14b9992a1c9d839ab2f71573af7de67c,2446,FALSE,2484,38,
e13273b29878c58edc7f8473056fb92c,2664,FALSE,2935,271,Dire
b493694920b43e71f06ab8ccacd6370f,2196,FALSE,2381,185,
bd8cffc73e06abb615b4611f60c75b5a,172,FALSE,3125,2953,Dire
8cc9e664094b7cffb42f17806090eb96,150,FALSE,1715,1565,Dire
309b2b2f7ed62841cee4a14211a971a8,1238,FALSE,3260,2022,Radiant
fddcfede3ce7f7249f8bffd7f6315cc7,560,FALSE,3493,2933,Dire
2638854408593fb042c7b56bef17fa7c,13,FALSE,2761,2748,Dire
7333f63801e949fc658a80975416d2cc,271,FALSE,2099,1828,Radiant
0459c7ec66edf6f02dd62b0b61e3609e,2100,TRUE,2313,213,
b501d185cc480ccb62b8a2579592e30e,1963,FALSE,2003,40,
aab9c4fedc51d1db4c1abd16d9fbbbb7,355,TRUE,1919,1564,Radiant
a6d900de5cc56ff7b8796d70700d63b7,591,FALSE,2741,2150,Dire
1d1891859235faf31cd777d75b04984e,1088,FALSE,1795,707,
365317661abfefa1af665d0fe4a676bf,127,FALSE,3399,3272,Dire
336f667a7f248b45f3d47862263918fd,648,FALSE,3332,2684,Dire
1e5d130d483fbdc7d9b6c3f2db80811a,395,TRUE,1564,1169,
f6b48c8ec8cd893557931ec0cca4b708,765,TRUE,2190,1425,Radiant
52ce7d5f8b95bb7e1233a80647f21c99,1930,TRUE,2855,925,Radiant
02674ef5b6e3156c777491a09a4e5348,2095,FALSE,2964,869,Dire
eae602297a4ca9385ae031cc59df9478,25,TRUE,1775,1750,Radiant
65fc1fd5e2a21ebc6180fc9697552aa3,291,TRUE,2536,2245,Radiant
b8fa7fc3e003aa9e8d79f171feef87fb,146,TRUE,2219,2073,Radiant
d1519f7e825b3201779b6d63e20d1664,1580,TRUE,1869,289,
9753feb6c6b5594111d12567608647f9,1199,FALSE,2136,937,Dire
e22f8e5dba1badc2d66593156a676e83,635,TRUE,3512,2877,Radiant
5dfedb02ceed4c4b3c3c271179316ea4,139,TRUE,2318,2179,
e2c276f6a211d7a7a634e4435f7ffd95,946,FALSE,2318,1372,Dire
896fc2b64a7cff8548d8d365aea148a6,313,FALSE,2892,2579,Radiant
c3ee845fa39c935edbbda6ef81d87d84,975,TRUE,2530,1555,
61290c84e88423eac4d0ed879cb8750b,1417,FALSE,1891,474,Dire
562de5bce40fd0c194bc739d41f6c172,1378,TRUE,1450,72,
abdc34f126c362a7b5685e5b6f466024,1817,FALSE,3845,2028,Dire
1ae97c0006a2d62305cd31527f49ce60,526,TRUE,2075,1549,Radiant
a722b0adcdff8a32ba0ce8be4b6ce6a5,426,TRUE,1687,1261,
1bcc43d55d1a087db713d80b635436f0,1070,FALSE,2570,1500,Dire
91fb332be2420e79feb78084d2b5ef98,412,TRUE,1050,638,
52a77ae9b5d94d7fb58828be363e63d3,818,TRUE,2452,1634,Radiant
104cfdf6f4d815b218d7e9e9583dd330,697,FALSE,2070,1373,Radiant
4798de840a628537a46c0df4a18a08f7,961,FALSE,2628,1667,Dire
533f1a96f12506db71b05f37eb97fa9b,2117,TRUE,2274,157,Radiant
67596d26e9e84252403f8e43457709e4,1886,TRUE,2260,374,
b9518a7b942bcdd03f820e9de3b84653,400,TRUE,1660,1260,Radiant
91548306019629be45749a922c3ccad3,610,TRUE,1732,1122,
0380a7808a8770d39003f8261b98068f,1904,FALSE,2220,316,
bb520bde4039333e1c4c9fbc4d9edb45,1330,FALSE,2173,843,Dire
c735731b2964f7090727e81b4775e4de,912,FALSE,1928,1016,Dire
cda86cd71c8c30b5456dafa713e815f6,3318,FALSE,3737,419,
758bba13a979a5602636cb97d4ddfca8,1341,FALSE,2607,1266,Dire
c02cc68d9d7fbe8e70c580d8dd3b3a13,894,FALSE,955,61,
b79cdfe0d4d0afc88f9f417d671f9566,2549,TRUE,2791,242,
4b604d5ffdb5d3056f3b1ae7a728fa2a,860,TRUE,2156,1296,Radiant
7c8a28254ad5e2cb884856c1462ed467,2241,FALSE,3011,770,
f447c2f8b6afb1b472d570a52dfbee52,2053,FALSE,2991,938,Dire
bcbafd39aedc8c67681c1cb904938fb6,430,TRUE,3596,3166,Dire
803c323dbeb312fadc23d4f1f9b806b3,850,TRUE,909,59,
bd490c7e2757b83195fab1b4687d86af,1502,TRUE,2631,1129,Radiant
613a2f7a2f5008114f39ad1fa5750138,2798,TRUE,2895,97,
e3ea170f950dc6955bc55ec06ae2187c,2187,FALSE,2442,255,
b56f58e14d798e641a57fad172654ea0,291,FALSE,2500,2209,Dire
af51ced0e990e9d65e643202870a41ce,1424,TRUE,3691,2267,Radiant
9a99a946217eb2b255bf6d4c56934767,1134,TRUE,1920,786,Radiant
7589f5047e4561ceb2c456455f6477b5,1324,TRUE,1428,104,
f1816a99e11ae8ae16c3996ac793c9bf,1391,FALSE,2692,1301,Radiant
ef49269f33ad57c4000a927f213b3260,2705,FALSE,2917,212,
ce5ddb4684146364bd48da0ca120ebc9,662,TRUE,1185,523,Radiant
4393ba9b17808c04d31555df97ef5890,42,TRUE,2873,2831,Radiant
7d8c21d3817a44a9ff1869d13422449a,2483,TRUE,3142,659,Radiant
7697e2db3164cb5185faa28cdf92b9ab,1381,FALSE,2593,1212,Radiant
ae7982222084b3154bf12c0d42517495,1646,TRUE,1695,49,
d7b31fff015ecb70f6108817cca82ba6,1166,TRUE,2798,1632,Radiant
f3a1c5831685592e6370caae6775a72f,1953,TRUE,2129,176,
43807b554a9eb4e74d13d5d63d7c79cc,132,FALSE,1382,1250,
6d4c5871beaaaaf30043fffecda55eae,2878,TRUE,3153,275,
3edae868203aaf218f8c9bfe3ae4bd9a,274,FALSE,3223,2949,Radiant
921917ff66b25096a6dcdc8111cae46d,1829,FALSE,2005,176,
82bf74b818665239c213758f44a45831,947,TRUE,1114,167,
19503ce849941ed5972de736ab0a5d49,991,FALSE,2055,1064,Dire
455895d25000511f5524723e38cd3d4a,1215,TRUE,1869,654,Radiant
5f75af1c8975fa75ffa30a7c3338399e,1995,TRUE,2493,498,Dire
539f00a004437ff574b07f96379392cc,148,FALSE,1915,1767,Dire
501464a1c5edba56cc27bbbdef899e66,579,TRUE,1588,1009,Radiant
9c82391cae8f3be819fbbd347033b435,621,TRUE,1791,1170,
d4f34659fda2f8821900402bad8a8a9a,999,TRUE,2092,1093,Radiant
6f914bd4c53ddcb0467ffe1b8b927ea9,1275,FALSE,1617,342,
9555801ecd25ebbc06955d446af94d71,375,TRUE,2077,1702,
a5b18af49fa5937cb74c186b42e0183c,221,TRUE,1619,1398,Radiant
2896c6b859454bbc6a92b30c3e49e7a8,1372,TRUE,1998,626,Radiant
d41cd93e7b643b5a5660d247a181332e,694,TRUE,1905,1211,
792f21947972ccedccd855900b9430c2,2059,TRUE,2554,495,Dire
faa0585691f181bcb37a73af216e8c79,2353,FALSE,2481,128,Dire
c9c1ce5852fae92c004c5b88080e8b5b,1385,TRUE,2144,759,Radiant
52fe874e1cd7a46b819c3fcd7800ce4f,1361,TRUE,2232,871,Radiant
b171867ffbb34724c7b2c3a3c8d06379,434,TRUE,2549,2115,Radiant
8291e8e7bb5a6e51326dfacc232fdc3a,1502,TRUE,1999,497,
b4cbf911628572daac32d9e184fd1f98,305,TRUE,1894,1589,
62f070bdc8d21c8ddffed1b646aa98af,1728,FALSE,2708,980,
162fbe44180a7388559a0c337179b7a4,200,FALSE,1506,1306,
039a5821a83784073ef53bab06b29959,1178,FALSE,2005,827,
260251f68b80b3f3ca48ac442dae18de,161,FALSE,2501,2340,Dire
044b7f44e56ad5cb3813b5cccee2998f,927,TRUE,1030,103,
c5b3f35c5f02da4c264fce2a032ae59b,674,TRUE,2140,1466,
23c4fe1672109450309d226aa53816ac,867,TRUE,2773,1906,Dire
f0ea74e3ba175bf273258a4e98ab96eb,1474,FALSE,1665,191,
3b13dd1f80efc64ae2f51318e88584e7,32,FALSE,3126,3094,Dire
79af7376b67c2cbe4ce3063b9fa61bb4,794,TRUE,1470,676,
05da446d383c4b72b428162aae684347,1146,FALSE,2068,922,Radiant
667eaa5e15e99a437fe3a2388bc7a315,832,TRUE,2908,2076,Radiant
b7d4f11a4494d875fc8bbd3a2949f0af,1619,FALSE,3276,1657,Dire
4b3ab3c3b2ee0caa084a5dd6e8947d9a,2074,FALSE,2899,825,Dire
632c3cb8f43bb9ab9e59ff0a45c61ceb,1770,TRUE,1801,31,
3a2e5de1610a93d1c65798706829640f,2214,TRUE,2802,588,Radiant
cf90c68db5cb8aa059f14ef084047385,682,FALSE,1316,634,
5479a3a67ade4c6adec2a99fe9d73209,723,TRUE,1328,605,Radiant
eaaea70aaa0168593f2988492d3068bd,684,FALSE,2040,1356,
21d44dde0f92a07bddf70aa9f204fbcb,790,TRUE,1688,898,
0da15336c521aefcf35aee9ac4406560,1048,FALSE,2205,1157,Dire
61b818056eba864c7aafdc2cbd2a92ca,281,FALSE,1322,1041,Dire
5d8a2b5c5a577dc4341cb348ebb1f2e6,876,TRUE,2093,1217,Dire
10b2e539f8f1b5b66a5782ffde2e9c01,1026,TRUE,1870,844,Radiant
83819b9f28ebbff759c8e0810cc2d937,834,FALSE,2237,1403,Radiant
681cace9e3db798267a7d5e8328f01b4,1603,FALSE,2315,712,Dire
2cadff0dbb727aab976b0f0d697f5cdb,2161,TRUE,2850,689,
0073902fbfe26fd1e2bade7252f6fcb8,1155,FALSE,1813,658,Dire
e0f29e4723f04390a6d0bf7204d125da,1726,TRUE,2123,397,Radiant
1e9e7a575ea5ebf194366e45df28efeb,1191,TRUE,2043,852,
d65f3b77cc23ca9ae09a6d59bb7f1f83,1621,FALSE,1766,145,
eb6e54aadfa5a701905ad087485b96fe,911,FALSE,1489,578,
f2d7b87da815ad18634f0f438b389931,1179,TRUE,2662,1483,Radiant
b322010ec10e4a54865c13a01b882cab,2207,TRUE,2566,359,Dire
4d9979f5c91ab45e0a713910ecf42bbc,1265,FALSE,1704,439,Dire
a12035a658c31d534286fb4960e15131,1376,FALSE,2078,702,
2e2ebcefed202c0856738fc45aa07b3b,2618,FALSE,2898,280,
eeafec5d9767265a834aafe021cac714,2068,TRUE,2350,282,Radiant
7b45403678ca34ce48dc86a4f7d45693,1310,TRUE,2827,1517,Radiant
a5f3c742100ca29e6abc40826403982d,311,TRUE,3149,2838,Dire
df3f0678324d0401a49ac66b1a14165e,842,FALSE,1454,612,Radiant
db5a056272f9c88d66d13345e67d426c,2666,FALSE,2849,183,
282b847117b1dc5109338fa04e247fa7,3187,TRUE,3273,86,
5ccaae53646d7ab20c2e140712907583,670,FALSE,1866,1196,Dire
ae9ab682c90ba619125a806b09fe8769,478,FALSE,2814,2336,Dire
dcb8090e838007d1b51971d55fbe81b1,1141,FALSE,2296,1155,Dire
32f21c5baf4752ee575496a888483287,710,TRUE,2160,1450,Radiant
d8af7090ef22eb21fb0ed60ae06e2b4d,45,TRUE,1598,1553,Radiant
3d82dc01361875ecf345c46c4b6c4313,2731,FALSE,2913,182,
e6dd8b50f71cff2ff722bd5090759ffe,164,TRUE,1647,1483,
4a842d6f23f9ff158825b9a945f7a411,431,FALSE,2219,1788,Dire
f3544ff7b52d7b926f924a39f26721a8,1226,FALSE,2376,1150,Dire
d3eb5785405b0ccbc3a39afdbb8ef15f,376,FALSE,2508,2132,Dire
bd1421d0e7d037ce96e488202042a480,752,TRUE,2369,1617,Radiant
60e7d9bf0023cdaf19ee2e60bddcb36f,2895,FALSE,3647,752,Dire
9c2861b336a28db0605318d9d59bb51e,1815,FALSE,1918,103,
105b4f4225acff6cfc9a329097703b3d,577,FALSE,943,366,
1a9577de661ddd15b82e40d146e7ff9a,380,FALSE,2821,2441,Dire
cd655743de0364e5f3b61255c593b188,2517,FALSE,2669,152,
753a549f6c8191dd8b9adbab4d521a8a,566,TRUE,2154,1588,Radiant
7cae45ee278043072629d90e94754b52,329,TRUE,1310,981,Radiant
26ddcbf7b13dba3f89301c7e611358f9,386,FALSE,1955,1569,Dire
bd06adb94de57283d803799046320d31,507,TRUE,1892,1385,
69adaeb0d9af4667bc9a64767628bb20,1125,TRUE,1847,722,
489b123b5eaad4987d3c7540c566d830,1150,FALSE,2549,1399,
5fa261ff6aca5dab09c9cc09a9c6ee8e,240,TRUE,2648,2408,Dire
0fe98a11fc02dc43a33012f90a52d048,1022,TRUE,1772,750,Radiant
c65f2fdd054f2b2be5fdde4b8e1bf4f4,2469,FALSE,2912,443,Dire
6a50f868ba9d315c4ff2b4e132c823ae,123,FALSE,2702,2579,Radiant
a22a0c49df3bf88e84854484f843f7ba,804,TRUE,1430,626,
e3e7d83e6c2a8d4f1992afae1240b2ab,1314,FALSE,2238,924,Radiant
cb1804ad2b7768cf1d182eb0c2bba5b2,898,TRUE,2116,1218,Radiant
701bb0b9fe3521297d2041875f4cbc54,2007,TRUE,2203,196,Radiant
d76a1a7df6d797b728ac77b5b1e8c3c3,1294,TRUE,2662,1368,Dire
82e939882b454222329b92dcae7a18f0,53,TRUE,2689,2636,Radiant
ab6cf8eef6a30d4fca042a44de701696,1609,TRUE,2326,717,Dire
c40b733b2bcbafd42dd8ba219872a19a,2390,TRUE,2872,482,Radiant
77e490001116530ba3e231752eade11e,396,TRUE,2398,2002,Radiant
53a2ff1203e23435c0bb0b8bd3573d20,151,FALSE,2081,1930,Dire
274e9f342e66bef8959fe8e95c65f7d6,825,FALSE,1794,969,Dire
afe97ebee0a3c9541e4cfb773b955940,85,TRUE,2771,2686,
a9a04f72916868cc7a1dacb49d3c3cb9,758,FALSE,2468,1710,Dire
e6344935602fc665b338677aa7218c86,1512,TRUE,1883,371,
9fdb5e939df944faa4bd7484f8cd8cd7,1769,FALSE,1921,152,
085021b5c7983f4babe100c8d0d0041f,804,TRUE,1912,1108,Radiant
14934f371eabc2f1acd6816e27253156,1807,FALSE,2546,739,Dire
f3434f265bc5a30342513870ecc05f39,566,FALSE,3241,2675,Dire
1da9883c138979b51606977493057b1f,749,FALSE,2310,1561,
aaf71e52988b94c95e1eee6277952438,369,FALSE,2434,2065,Dire
3dd4a097981835a9b95b19e40b915bb6,1951,TRUE,2688,737,Radiant
815edbebc3bb6f6169e84df75edd9ffb,2734,FALSE,2834,100,
c464f23644651e3bb19aca83e6ef15c2,1387,TRUE,1949,562,Radiant
90ec7ee3dc803a48106d8fa0280ec05c,1802,TRUE,2103,301,
d525e2ce19c921550cab14288ca7df8b,162,FALSE,2195,2033,Dire
da4444e880d58b20480fb72227eb09b8,2202,FALSE,2533,331,
1529d0b959d3339b04ef8c4fbf719fc8,928,FALSE,3004,2076,Radiant
fbd88563a8e4de023136db51f2344db6,117,TRUE,1938,1821,
50e6602c94443fd45b329de8735b4181,1456,TRUE,2401,945,Radiant
692184d3438addc2782c5d056fc4e4a9,1111,TRUE,2079,968,
c35f783a6b847e54258f86c8883c3357,1399,FALSE,3278,1879,Dire
56519d0928631b45ea7436e09c2d2fe5,1218,TRUE,2143,925,Radiant
6008bd3efd83b860c102a28cd46a6f06,2407,FALSE,2564,157,
4cb419860f06b33fa8f41904295431b2,2153,TRUE,3512,1359,Radiant
7e35233605559d8a112cd2a624be2275,1900,TRUE,2594,694,Radiant
7a5cd6369e5640acd8225f606f3b071f,24,FALSE,2189,2165,
02b7f7fe1977e207b77cbf02f0017bc6,256,TRUE,1621,1365,Radiant
81b8b88b541634232ed82e53b7c2857b,1141,TRUE,1739,598,
94fecf3c8478a0a84797eb5caa8da72a,1475,FALSE,1664,189,Dire
4cf9f50021992d6567c2198bfb9c8896,1632,FALSE,1875,243,
22f77f6f15fa2d64d7f054a91f9a5fc8,805,FALSE,1623,818,
a8a775e84ebcf9d5dbc674a3c0c43f4b,2736,FALSE,3713,977,Dire
907c534eeb7d0a385b990ec58b557402,900,TRUE,2943,2043,Dire
ea070659e5a596b63954145ac8d15bd3,2601,TRUE,2861,260,Radiant
59cf1b53a774221d0237d230d840e29e,20,TRUE,2685,2665,Dire
eb418181824d74b9bffcc6eeceef0acc,1528,FALSE,2839,1311,
4b20b6ec50cab21123392d0673bcf4db,1725,TRUE,2125,400,
0538e107cb429313e16e549041b55364,1482,TRUE,2050,568,Radiant
7ad2b76f487f82a288d2cf6a10f52877,1668,FALSE,1995,327,Dire
3a5f967ccef768c9a6207693de4dfaef,1781,TRUE,2112,331,Radiant
e7b92b3004ff525386751c1e0ed0f3cf,1453,TRUE,2909,1456,Dire
53baa4e00b73aeaf4079b98c9c9996c2,1313,FALSE,1799,486,Dire
a5d333912ac2b9978bdd288faa9b4f0b,1251,TRUE,1407,156,
5a4c61fa445b4317f9892c82751b920f,269,FALSE,1632,1363,Dire
029d4203a020f1d14c2beb2dcf02076a,513,TRUE,2762,2249,Dire
067dedd3725ed99ad47c00897d13df17,1385,TRUE,2091,706,Radiant
f8edeb8dee13165d5757fc361e1b09b8,596,FALSE,1620,1024,
deab00df785f927db9191861b922a772,642,FALSE,1974,1332,Dire
5fcb2282332413e626063adba13765a9,2271,FALSE,2601,330,Dire
897be2137c6fcdc7042bc3b36b7e6d04,69,FALSE,2941,2872,Dire
4479879ce1b3106df29d0fbc48e8d226,2461,TRUE,3089,628,Radiant
0a1844bea233c43c382985b14ea7ef5c,2254,TRUE,3267,1013,Radiant
6acd5b1f170a5bae50566f773631a4c9,1341,FALSE,1622,281,
37a65a094c190100cbfc4ed916528199,643,TRUE,1149,506,
b9ebe9a667645de39b54da2e3a4848bb,932,TRUE,1336,404,
03bb4ea61645820fb3bafaa68dd2f90a,2038,FALSE,2973,935,Dire
3ede34b1cd355c7ecffe21a171993eff,2182,TRUE,2612,430,
b1e51b0cff3be79726b87b9a1ce37c13,1957,FALSE,2057,100,
c5e4790c8fb2351a2f7a6b73cc991798,66,FALSE,1561,1495,Dire
b9dc60bcc6b4d4fd90aa1189b3934f8a,651,TRUE,2006,1355,Radiant
b7bc0108993de8144ffae0e2378e4c7b,647,FALSE,3568,2921,Dire
9f9b2aa9d765a80f18c4b1b2af55a825,580,TRUE,1020,440,Radiant
29b1de9d20aa01e03bb246069fcf247a,1064,TRUE,2064,1000,Radiant
a46e517857e04e42735efcbe2d23be8c,250,FALSE,2076,1826,Dire
6c056415527228b95ec6a5fd189cb6df,607,FALSE,2326,1719,Dire
8d796f9b82f844aa24f8daa12d016bf5,2113,FALSE,2221,108,
ebe55cd41684d885c57d23f9cacf56c2,394,TRUE,2393,1999,Radiant
68784974ac8a1d07e164facbab169c5c,1305,FALSE,2294,989,Radiant
6cbdc71910102b406f75c80d6c86cb0e,968,FALSE,2160,1192,Dire
f2c92964ef24359faf4880bda23cd9f9,765,TRUE,2532,1767,Radiant
baa3e58f24826e286730b5f31bee97b6,439,FALSE,2011,1572,Dire
bc1a41a7bf6ea7dcf939c9eeaaa49aef,2279,TRUE,2611,332,
dbd4722d672dc648114b0da0480ca6b4,219,TRUE,1289,1070,
fd2c01444d5abe82352b905ebaebbbe5,1927,FALSE,2492,565,Dire
859529b2bf0085433c5749a94516e305,1543,FALSE,2696,1153,Dire
79d04022191199026a7baa6a636ef9df,937,FALSE,2072,1135,
da45948421a1302b425debcd89bd8a36,564,TRUE,1125,561,Radiant
3e35e98934151ca96e9bce2490c0946a,15,TRUE,2800,2785,Dire
e616272edbae583eb06173e22f706ca6,401,FALSE,1881,1480,Dire
68e5e31819c9409d00800708038a1038,610,FALSE,1814,1204,
ea7ce3707098c9849386101dfc2a9fa3,355,TRUE,4594,4239,Dire
22324a2542af5806001e36a332305fd5,874,FALSE,1426,552,
c7511b730409fdcfb3132a0f2f3b6f73,2037,FALSE,3238,1201,Radiant
0906d9fe97698ed7ac0e6b033d15a439,379,TRUE,1607,1228,Radiant
cb0072b4c4b6682afda257493f1abd7d,1087,FALSE,4080,2993,Radiant
a50b8729ee4896707a619e8664e26db0,300,FALSE,2638,2338,Dire
2318296ac8508c7747bed5fa4336b39b,197,FALSE,2513,2316,Dire
06ee94795510c175637c22e6c13b4d05,1094,TRUE,1628,534,
8a46f3b2635a891a3b9b7b376b7e57aa,348,FALSE,1616,1268,
70a5c22abfc8ebcf2d7a6ba02a5188f8,1482,FALSE,2004,522,
afad682a06ec01d6d84842c6c5606a2b,520,TRUE,1915,1395,
70f1858cf1889cbada545773cd0b885e,1044,TRUE,2044,1000,Radiant
b07e108d1e71d395f26d7051ce32bb3e,614,FALSE,1981,1367,
8ce88971bb7c969cb67a8cdf81b4f5fc,657,TRUE,2726,2069,Dire
e6c9800cb4b1b72ba26b703c3999794b,1565,FALSE,2258,693,Dire
2fedea057a1a92584918d478d101b594,1915,TRUE,2494,579,Radiant
5b1c865d7df8fc1762eb420d966c2377,525,FALSE,2130,1605,Dire
746eab1d13481c6b5c5ee61814ecf879,120,FALSE,1281,1161,Dire
ee21599fcd0e211ebc244104bd52d12f,638,FALSE,2573,1935,Dire
32eb15f37ce4b91ef6f7f93c6cf7e060,36,FALSE,2642,2606,Dire
eba569905b88d47f673bac8946115644,479,TRUE,1223,744,Radiant
48bdb0c43c37367b4b9ae9813c01cb83,1574,FALSE,1909,335,Dire
ff50eeafc1c8dc32193c619e6d887af4,1761,TRUE,2130,369,Radiant
cc8af980c24c4f150ac357172c6d9d0b,817,TRUE,2279,1462,
5f1a680dec32bb2072604e498d6c3473,1782,FALSE,2307,525,Dire
0b53a3f50245a01d1ca1d5f47ce172d3,184,TRUE,2235,2051,
89d608f19f14f694a4051034f9d2e805,2751,FALSE,3181,430,Dire
027c73804359d14e1546c87ef92da23f,3613,TRUE,4506,893,Dire
e9cecda9a0c69ee5e0563b1f7d84deb4,1001,TRUE,1948,947,Radiant
f0591f01d5da8ec68e42a3b58cc598bf,2810,FALSE,3188,378,
142dda58571c9397539d29d2b3400cea,2052,TRUE,2428,376,
26c22762aa48e0127b8f9e3c2d25673f,1528,TRUE,2438,910,Radiant
97207d7c4a863b6c356a89a8eaa07940,967,TRUE,1859,892,Radiant
63a45932e4ed526c61bc0acd288e98c5,1536,FALSE,1859,323,
9b94fbb55365d523c735318d9692ecf0,1708,TRUE,2332,624,Radiant
bc51671e3384b363ecc38918259bb150,1952,FALSE,2171,219,
ad207fd5455eb7d2fde9d86e20286531,578,TRUE,2101,1523,Radiant
38eb7412949c3fe9444bc47c16e22950,1547,TRUE,2804,1257,Radiant
b5af64368b6714fc60ba92a33b32b7e2,1056,TRUE,2265,1209,
540d98b1a5fc0ffa535bcf275f7b7b21,2817,FALSE,3498,681,Dire
363a8b95fbb638e143341e9ee1c3d6ac,162,FALSE,3082,2920,Dire
61e35f4b435c2b9373f8541633826f21,896,FALSE,2759,1863,Dire
24d31e59e50f84ccc943c0b4eddf972b,1834,TRUE,2028,194,
b4fd5b95b9b278259a6111c06fdb5fe3,735,TRUE,1998,1263,Radiant
96d5f1a8cf61df0ed974f231c5188c85,1449,FALSE,2541,1092,Radiant
9dcf8213c2d7c564dd1859de390ac39a,1238,TRUE,2624,1386,Radiant
58ea83696eaa414d07b7ca5049a075de,901,FALSE,2217,1316,Radiant
d62407d162d611e01ab92174b4d88b61,253,TRUE,1852,1599,Radiant
902a3209a046800f2f2a30dff2bec30f,1472,TRUE,2290,818,
950baf3249dd76064d2d4e82102b4114,1657,FALSE,2362,705,
0e81e1db4e2858d2a0fdcb10417ef58f,1911,FALSE,2089,178,Dire
dc29cf0603398b428143c9f0d231e401,1698,FALSE,2671,973,Dire
5dbaf1c40a6d4e2a74917a802c528e6d,1221,FALSE,1845,624,
102ab5ef7ef0ae41724c02e994b00248,98,FALSE,1845,1747,Dire
222e459c061dd7eeeb888674b33fae36,171,TRUE,1854,1683,Radiant
876ef6f45917a02a1e03e8b0ece90a89,323,FALSE,1729,1406,
58b6949c870bfe4f8cdb13ba0136d8c1,2223,TRUE,2450,227,Radiant
3a6e0c338e280d691376fa466aa0f95d,1547,FALSE,2325,778,Dire
654532b5bf7b73335619b96c9a2f8905,1266,FALSE,1758,492,
8f439d6deccaa537cd9e2d9940ef2874,309,TRUE,1041,732,
76b4d5f8cbb9438d62ed3abce9b8c562,1209,TRUE,2595,1386,Radiant
0b21f8e657e0d6f190840e91e7310e4f,1848,FALSE,3733,1885,Dire
f024cb8d2b1dedc92bbed77176dca88e,1259,TRUE,1654,395,Radiant
13862c96465f2486ef6fe4ef5bdc3e23,345,TRUE,1877,1532,Radiant
d2c334036cde5c81c4139be1d78ae51e,1748,FALSE,1913,165,
7fdbcb1344b7b9835acdba21d21c4fd5,245,TRUE,2106,1861,Radiant
bec2966e6da663e3118fd9a1df5527c8,1461,TRUE,2713,1252,
c64d81080e44010c2072abc3e4f668dc,1158,TRUE,1802,644,Radiant
33d59b3105d143dc8e534171987cc90a,687,TRUE,1459,772,
257ad8aeb772966f9e3bd79e1b55ae3f,1695,FALSE,2147,452,
24af6729e7fa189f10c92c6165cff784,938,FALSE,2278,1340,Dire
1158db1c2fdb22a54920545bd4d8554b,1367,FALSE,1918,551,Dire
1eb0f1c1d363a4b6fe9005e2639d90dc,555,FALSE,2484,1929,
7761d46b2460bf4972ee4a3e8a871fd1,998,TRUE,2470,1472,Radiant
7ea730ed1fc6f43d68dbb2f0b9113aa5,723,FALSE,1439,716,
b77c5948255cf606b2057091ad6f9983,971,TRUE,2095,1124,Radiant
576bb5b4dfa64bd476d64ed7a40c14a7,1119,TRUE,2136,1017,
3410a7b2ac10afb2bf8afc33f3e48381,224,TRUE,2071,1847,Radiant
fd229eb5482cddc48afe757ca6f06dc5,824,TRUE,2353,1529,Dire
0517aadd4b57a0ea39e339d72b66fac3,1655,TRUE,2555,900,
bda827ae0acd0f0abcbaf2d37c141683,474,TRUE,975,501,
a1daf4febca9f0bcc078a267e0369833,1124,FALSE,2233,1109,
91eec650961e21b2a10393ffe635dce8,1138,TRUE,1548,410,
46dd78e453a6f6323b68349844a27435,792,TRUE,2262,1470,Radiant
3cea49cdf843dfcb32859fa12bb47a22,1121,FALSE,1883,762,
d6fb08a230f9e31933bdccf8ca521330,2151,TRUE,2303,152,
9247f3889226b576d09651328def48c4,1472,FALSE,3048,1576,Radiant
2253146a2ffba499348563da039524b9,898,TRUE,2223,1325,Radiant
6e570b8f633f622eeaebd3cc8d1039de,786,FALSE,4297,3511,Radiant
c9c5263de378a393b979f68e2ef0e52f,1894,FALSE,2962,1068,Dire
6182bbb2aa3455ba032090d85d7d0238,748,FALSE,2534,1786,Dire
17215ada146a127d603a634c4e6632c0,312,FALSE,2980,2668,Dire
ecca8ca55e72ae7c578ae7cf9865b14f,1840,FALSE,2227,387,
55ebdea5e494fceab43ef66de3755078,1995,TRUE,2495,500,Radiant
4ce2dd79db3ccf22ad3d459d78e2f3b6,2644,FALSE,3144,500,Dire
faf7a44c1d311821919ba5b65bd68195,2071,FALSE,2963,892,Dire
cc72fd8d4acd2b0052b1f03082feb544,1529,FALSE,2214,685,Dire
4dd39e89d96bf14778c09305dd1ec39e,271,FALSE,3104,2833,Dire
eb14303143f31b9c8e665c0ad7ac7297,1248,FALSE,3702,2454,Dire
a1ed2dd0f4f7be7ff53bc0db0c889376,280,TRUE,2097,1817,Dire
55cd428afe659c3a2eab954ea41c4eed,1721,FALSE,2871,1150,
09e0cbc1495cca92bcbc447652ffb2c9,1395,TRUE,1745,350,
20673eacfa44952e40f60b3edc77cd1a,3064,FALSE,3207,143,
c4c02af9088e5cf01770437e0c62f9be,1748,FALSE,3053,1305,Dire
4c303b5006e88775a9331fcd71743e50,17,TRUE,4004,3987,Dire
6745e6f98aaca904747ed1e1d25bfb2b,2772,FALSE,3144,372,
857f4bf53bc59e54a7370b6abda00eb3,91,TRUE,1908,1817,Radiant
2bea554d57a19b1cfac92728f581cbb9,583,FALSE,1905,1322,Dire
3788b186522a391351c21a80a1cf3aeb,463,FALSE,2453,1990,Dire
6925b703696bddafef186a0dff0b33c0,1219,TRUE,2041,822,
fa35a322611f8b68acc180d6e71f413a,298,FALSE,1759,1461,Dire
f90339db613908f709d7a6744dfefe31,896,TRUE,2816,1920,
0574312a5804db82e98fbfaf2e40e5b5,558,TRUE,1560,1002,Radiant
c8ea4b88e5a4d3ab7763815c8927d50f,1698,FALSE,2445,747,Dire
3645e6d7a169e4dd1f29de941738977a,1406,TRUE,3080,1674,Dire
5e3c0ef9b3b7f71824add2f662ff256b,1120,TRUE,2087,967,Radiant
45201798a994ccd637074f6ac1f01f82,1166,TRUE,1352,186,
dd618b300d3a4d24a7bf27672334b5b8,1691,TRUE,2582,891,Radiant
12543b6d52f23a9e32594e7814bf5f7b,905,TRUE,2119,1214,Radiant
b50c5b2b58a7db861b8e12c67d71b84b,971,TRUE,1592,621,Radiant
a24233c82332312a1bcd010bc2ef458e,2255,FALSE,2518,263,
d15d3bf31f6c1c0c1620bc156f7c58d2,2528,TRUE,3596,1068,Radiant
88fff32b3191a1d8174f16feef58037b,717,FALSE,2001,1284,Dire
7945653ae166590310a3156dfe0d8d77,1144,FALSE,3546,2402,Radiant
c8737f74da28e8dd48b7d91e232e6479,2475,FALSE,2674,199,
5e18903d1e94806f6b66e1c77c62b65e,130,FALSE,1963,1833,
79d9cdc6851247199306ae01e5288435,1522,FALSE,2217,695,Dire
943bae53b2d55b213aad13a0e251c4cd,1800,FALSE,2792,992,Dire
c1da74f9a98a937d29b43098975b3b09,349,TRUE,2382,2033,Radiant
70cecdff92f97fe95212fdd81e192c14,2371,TRUE,2412,41,
839a96667c8a2b44ae5cf485aa134a3d,792,FALSE,2720,1928,Radiant
44ba793f6f961814308ce370f236aee6,725,FALSE,2832,2107,Radiant
1cca347d6e01043314f96d264685d3ce,663,FALSE,1408,745,
85e15a974d8cae15ed1f8af37b87e1bd,353,FALSE,2529,2176,Dire
9e214a3149031ff0099349593ca23c68,2383,FALSE,2604,221,Dire
9617d3932eb491feeb508dcdd165d047,1775,FALSE,2994,1219,Dire
e188c2000aa0b60d1ea5e10525e6b76c,2441,TRUE,3212,771,Dire
9d8771304e52d7d51621519ecc49e5a2,69,FALSE,2029,1960,Radiant
b7bdd1ae49e5a0d3326c86f37081db84,2526,FALSE,3175,649,
3faa1d788e5ec9c6cbdcbe42d15d8f8c,2954,FALSE,3450,496,
d310ee53d67a21ec19b5f22535363af2,1802,TRUE,2001,199,
5fd5e2e2f69ee1ad3bf77ad4e283ac4f,179,TRUE,3068,2889,Radiant
0a537f9bf8bc45dc0dbd9d72ea3983d3,43,TRUE,2264,2221,Radiant
f8b27702ccbbed3cf20702515678c18c,725,FALSE,2058,1333,
c2af171b956a960b71d039bd6c08954d,2035,FALSE,2830,795,Dire
9310717e5bc2cf2ea2fc0364dc769001,334,FALSE,2335,2001,Radiant
9b805cbf1eb9df05917f90cd393f5a1d,1272,TRUE,1491,219,Radiant
261489523357b35ed205249050a944f1,1038,TRUE,1588,550,Radiant
2b1fe1ea09caec5d65a9c74b34b2d820,1487,FALSE,1615,128,
22ddca23a84994ba044afb7022d1a554,1754,FALSE,2631,877,Dire
9c4d61af5816af2c20ada76922129fc1,1130,FALSE,2195,1065,Dire
2af5582d9c517ae0ddf266b01e4f2691,1798,FALSE,1966,168,
2f4c43326793fd1eb94cb121382e19c3,2180,TRUE,2622,442,Radiant
0cde142d4c2a69ffe508bf37394ac759,1632,FALSE,2239,607,Dire
967cec6f7b9f080fce4400dfa0501e1e,967,FALSE,2694,1727,Dire
3a6dd64f7b8f12f8cc0bfe8e314d104b,2629,TRUE,2969,340,
d5c3eedc1130cccb6c36d52578856759,818,TRUE,2640,1822,Dire
c409ddf285bc9dec3605af98cc05b41b,2654,TRUE,2909,255,Radiant
79ba011cc1e64c9570550e9df024a4ae,1648,FALSE,1941,293,
0597bf7a5b7961dac3e87958e9c3f714,669,TRUE,2557,1888,Radiant
835f379c93321b48eee5cd5212d21dfc,1162,TRUE,1551,389,
d35fc398cee58e9789817e91ac9a1778,1686,FALSE,1943,257,
6911307fe2e1a2be558cc190d105b539,1126,FALSE,2391,1265,Dire
17b248582bdbbe6258e3d26fc03c3470,3136,TRUE,3976,840,Dire
99bc57850b42b6ef07fcbb658c35bb3f,759,FALSE,1913,1154,Dire
7c4239505f8b81c1cae1678c3dd1b530,17,FALSE,2795,2778,Dire
da20edb521566efb5ff8925ec042a268,491,FALSE,1417,926,
0d0e452a793791048623a4e765e3a738,330,FALSE,3081,2751,Dire
a044c9364e864fd13d8423f19d0f8447,1005,FALSE,2279,1274,Dire
90ad33eb610b860948439e44b2187c5c,857,FALSE,4374,3517,Radiant
19f7633d8c27f128b4f6a552673386e0,59,FALSE,1405,1346,Dire
58ef69af78fb1f9de91226ee7ffbef66,2830,TRUE,3367,537,Radiant
6358ac5b6cc887e3da71040373d293b8,38,FALSE,2055,2017,
47b1de3b76215b47af1761a19bec4127,1900,FALSE,2033,133,
7407d00117654a2ea0e1672286d45b6a,810,TRUE,2404,1594,
9c161f350222f58a594f83e72d2aa8de,354,FALSE,2710,2356,Radiant
4d3461ae0f1f98d1503beae5cb91cac5,174,TRUE,1711,1537,
0b0c2dd7cef3eb679a72351813dfe820,1557,TRUE,2264,707,Dire
38ada47371b3dac120bfc76f262b76b3,962,TRUE,1875,913,Radiant
24ceaa33e80c2bc2616cb3a5f60752f5,1120,FALSE,1503,383,
a557aa3a39fe602ae15e4f92fbdf58ac,1869,FALSE,3308,1439,Dire
2dffc0c4f270c400f230076ed7e8ba91,334,TRUE,2907,2573,Dire
d12db1d0e408652eb01c74489e72647a,2944,FALSE,3111,167,Dire
91f54451a3237d518a003afefc9e42b1,1005,TRUE,1543,538,Radiant
3867945cf2d638f305b99a80c4cfb6c6,1171,TRUE,2417,1246,Radiant
86f03506af9d18237f2240621211e421,1687,TRUE,1813,126,
22bff81563696a58e5b7c0befcd139f9,1812,TRUE,2276,464,
1a2f42471789e9108d053be623ee41cd,152,FALSE,2788,2636,
ecffec4476ef1aa3709be7083e314ed8,3042,TRUE,3977,935,Radiant
98cd09aa47fdf2a62a5aa83824c82358,744,FALSE,1994,1250,
35d1e2a70cb558f2a56b70161d1e2a3c,46,FALSE,1892,1846,Radiant
96d99188c8d2056fdbf9a90c514c96da,1599,TRUE,2069,470,
f1a9b80b5c20734fb0ee0cac0d21c54c,2597,FALSE,3509,912,Radiant
1aad8dff9420fd045c5d6e94caf560cf,1021,FALSE,3847,2826,Dire
73dd48d11fc496d3d803df7b63622fd4,2735,TRUE,3102,367,Dire
19349f64a5ac62be9952035c900c791f,780,TRUE,3646,2866,Radiant
c9c4022f270a4cd9b6ade4afaa3e3aff,75,FALSE,2844,2769,Dire
01c4ead8286a877cc7105452840349ce,1310,FALSE,1506,196,
469876d4df32148b074d1f3155fba93c,1235,FALSE,1936,701,
ee99d2f0bd93efa5bab232e507f3d919,879,TRUE,1894,1015,Radiant
88f356e50381b486b6197e857174eb7c,23,TRUE,3274,3251,Radiant
3be82b30b6cb0bf6ec50785205e7de7b,1464,TRUE,1963,499,Radiant
6253c84824c6ebf39860a5cdde08172f,77,FALSE,3532,3455,Radiant
d4b28c61d125f44d8c5b7fdee5ffae34,1356,FALSE,2656,1300,Dire
a2534db3dcbd87d1d1e7b5a4d2b5d6d2,1573,FALSE,1909,336,
71351ef7b5b66d3a757ff6dcf787ed33,1867,FALSE,2568,701,Dire
a7065c4ffc838fb94364903568b6af84,1383,TRUE,2693,1310,Radiant
e9687164841a6f449b8e8e6c50b4cdf0,1003,FALSE,1387,384,
1a774ac3973e549cb985211b303cbb78,1702,TRUE,1861,159,
744ae23c63258b9be2747bb9a864355c,6,FALSE,2315,2309,Dire
152507554800244b10a9082ef4dd0158,2236,TRUE,3350,1114,Dire
8bc635764eae6dfa5fa08a3d97d1d30a,1029,FALSE,1462,433,Dire
a5563e8362a6c01a4505814c2e7eb3a0,2149,TRUE,3501,1352,Dire
3edfdb6a47efe457223ed6d40b72a3b6,1402,FALSE,1893,491,
c08cc285b037bb6f889454dc2ae612e0,1756,FALSE,1887,131,
508e82e1aafa15d27116954c0e3717d8,1515,TRUE,2097,582,
dc639f4473f1665e01d984047bd3b0ec,667,TRUE,2600,1933,Dire
0917350550a2df73d049d0c133608740,1481,FALSE,2989,1508,Radiant
88d6c8f7076cbe01756cb0718615eb6c,1502,TRUE,2067,565,Radiant
a357e403b3af99757de44178c5d1ccf4,996,FALSE,1493,497,Dire
49a42d9166b59714094d2038a45d43a6,1654,TRUE,1789,135,
caff5730044c0e51795a0b1226c288d0,1587,TRUE,2165,578,Radiant
bf66d2b416d99449e5e37d9bbed29c67,2216,FALSE,2429,213,
3890f3ecc97240cba3fea52e0fa5efff,535,TRUE,2488,1953,Radiant
2bc4958c0e941469c6feb00cd13ff96b,1573,FALSE,2586,1013,Dire
7fc9394cee9d4da62599060e4cffe45e,81,TRUE,2067,1986,Radiant
789a97c46a8aee4c93f3ec3ed4feee06,767,TRUE,2365,1598,Dire
cffa1ca76d769905ab3a833a7ea11e10,460,FALSE,3145,2685,Radiant
15ab5201f90407d4d1fd4db65127ba2c,303,TRUE,1829,1526,Radiant
170242ee7c50191ede19806e32b5149a,2886,FALSE,3409,523,Radiant
29f6c41addb0fdff4ae42f151507f20f,484,TRUE,2251,1767,Dire
8b4ea9a5c8b1c35338300e2f469c1fbb,2795,FALSE,3406,611,
a78bda043c2cf0f8654e63856009abe4,2611,TRUE,2685,74,
98e4eecc0f0fd123b4f239c68c8cf5f5,1626,FALSE,1909,283,
6555d1b961bfdb88caeac70dd65798b8,1221,TRUE,2317,1096,Dire
1ebf2db4c2ea916e740fb6718cabfc38,1459,FALSE,3119,1660,Radiant
da6fd1a383443d491d61721401e6ae18,2807,TRUE,3137,330,
66421da552b54fe27dc15e59fcee5204,669,TRUE,1885,1216,Radiant
e6e250286d38bf6fc84d9096a7949917,949,FALSE,2588,1639,
cc7ecb299413999689007f47ce5fb43f,1731,FALSE,2029,298,
c8c8d30839c9c39e5605233dd1444f61,2142,TRUE,2198,56,
a269c0b4bc45ff3aa25e4d5b02f655ac,2269,FALSE,2940,671,Dire
2c10b17fc2d45a406fd10cd30ffbac39,1211,TRUE,1991,780,Dire
b9280889dd8ac84f5c0f18f31aece5dc,2408,TRUE,3088,680,
b4183df031f58df47e27506a7b0a0066,668,FALSE,1476,808,
2cd269977119c4507d84ab5ad1e3a0e2,1874,TRUE,3588,1714,Dire
427937693ab7702b47ff1b0c64f6a978,577,TRUE,4334,3757,Radiant
6dbd9bc7c3b76960cce31ec1456169f5,1029,FALSE,2313,1284,Dire
ec9490e88c3e791a2e9a9d250b7c0512,1562,FALSE,2393,831,
a191ed73fc1072fd835e3d51b544395c,767,FALSE,1047,280,
ab0b2a0d071a25f2ad1c42e425a31f2a,1079,FALSE,1166,87,
b988ab352e7dfbe6d2d2c9fb08a60835,432,TRUE,2043,1611,Radiant
fc0eb070fd3184d98aa6356d8b265c49,893,FALSE,2110,1217,
dc395f793257872b601ccc5f1c56cfec,41,TRUE,2050,2009,Radiant
1917cac58a96b23618d75721af7923c0,1182,TRUE,1731,549,
5d961476988d4b3b8bd3d2dd22019215,2090,FALSE,3019,929,Dire
5ffd4771580df709b1337312b9eebbeb,717,TRUE,2482,1765,Radiant
bb25bff8b2806fc7a563e313aeed8506,1886,TRUE,2185,299,
61d3c46a47f001a2dbf85745da654509,2260,TRUE,2758,498,Radiant
0350bd2612c0aab1a2ffebc8b1380438,512,TRUE,989,477,
32cf3f9d06f87374f666a3afea5e9cd0,1179,TRUE,2295,1116,Dire
0430fd2f5d6ec312ef95931f7767de3a,1389,TRUE,2518,1129,Radiant
3daffdc5fd60ec5ec08b656b90a87419,60,TRUE,2367,2307,Radiant
dd7eb5018098ea06a29a69dc9b53b3d8,1416,FALSE,1921,505,
5d351389018272441cdac8df5cd2e7c5,2771,TRUE,2864,93,Radiant
0738b30039cd2e015a2b8df565091387,1495,TRUE,2693,1198,Radiant
4eef467f201c9ab9f2713ddf62dd23de,2145,FALSE,2642,497,Radiant
9eb7e19ae047df3be736910d6d809995,308,TRUE,2936,2628,Radiant
9a9c143d95c60188b3b8c2d586e89f3c,117,FALSE,2003,1886,Dire
33cf6ecae93c1177426c8fbe685c271d,977,TRUE,1078,101,
c80c3a22213fe0668e3479dda574d61b,1014,TRUE,1304,290,
9d756df459bc541f8ec65345dc3d40ee,1611,FALSE,1678,67,
1fe2117e4eec987659b87a78d4702428,1317,TRUE,2013,696,Radiant
00d85020cc137fee9614afd0ea0a766c,1277,TRUE,3377,2100,Radiant
e651d78d0e5cc534cbbd8c264929b8f6,3161,TRUE,3289,128,
a68dc05ab39bd4dd085ae6582cdedc7f,486,FALSE,2011,1525,
9228abb127f682359a27987f3b5f3ebf,1291,FALSE,1902,611,
3865282d334082cbacadf5b92d940254,1276,FALSE,2384,1108,Dire
cc8b20dcaea43ca8adeeb47246143653,1264,FALSE,2283,1019,Dire
38c82e34e8c5a0022a19470f72d75fdd,116,FALSE,3153,3037,Dire
3e0a0f836d57cfda71c5d3911ef620ca,1903,TRUE,3679,1776,Dire
1463f53a1197c692e96979352877fb4c,454,TRUE,2580,2126,Radiant
943e3b4ba67ff4a93874b27efbe1b169,1030,TRUE,1724,694,
45d07014443ff16c1a14c87c374afdf9,2344,TRUE,2826,482,Radiant
a596fba70034c7ada5d8ac93e47d4ba9,1072,FALSE,2362,1290,Dire
62b50361c8ff9e25c897b1ccb3653349,137,TRUE,1816,1679,Radiant
cf869be4f210341de4e2cbe5303246ce,187,TRUE,1607,1420,Radiant
efcb1bb850f268f24bd5757a39e3dc9e,1865,TRUE,2431,566,Dire
4c5f2e8a9fc55d7035ea4ae8d53f9278,1276,FALSE,2208,932,Dire
8a3ab1098465fdb4f46b74260f40d5fd,1896,FALSE,2542,646,Dire
511281a09cf3b59c29c81c7f22c0ccf9,894,TRUE,2807,1913,Radiant
84dd7d003c2137e58fd6276f5013b68e,4572,TRUE,5134,562,
0f1f84e2085958198ed78c2329587244,1069,TRUE,1537,468,Radiant
7cefbba30c826fd71b7e2d5fb1ae0e76,1949,FALSE,2392,443,
6b1daf7ca51ba03a092040779f383b4e,1721,FALSE,2178,457,
3db955ad13ff37dd2763f6f9c1bf2dbd,1271,TRUE,1602,331,
921250f4a2bad97d9e7de2d9dcdb6402,1444,FALSE,2180,736,Dire
280eb59233b50d83951e2f898bb596ce,1054,TRUE,1406,352,
4bdefc38ba759bbabded9b34c1273b1b,117,FALSE,1997,1880,Dire
072bd5878ef5fe8e413d7b8c41afd198,1099,TRUE,2452,1353,Radiant
9799575e0f6eb1bb2c8cc04759117164,1638,FALSE,1789,151,
515ccbb6cea7bac4d734a23408293b82,1941,TRUE,4322,2381,Dire
722598d23b47f2428230291c398340fe,702,TRUE,2160,1458,Dire
6f94d5b1fdbabe4334caf20756436bbd,1028,TRUE,2520,1492,Radiant
4a631a82b16b4cfbb6b6d622f594578c,290,FALSE,1846,1556,
138e5998d12499729cb53cd2d58e278f,486,TRUE,1712,1226,Radiant
a7282ac6aa87cfecb39354296bf2e7f4,1204,FALSE,3194,1990,Radiant
030a266d0b70a35f9b9d7568c84bb456,390,TRUE,990,600,
bcc12a965e4d50bf33040953a8199698,1894,TRUE,3003,1109,Radiant
c1674cfaeeb4932813d824d9995160a4,1118,TRUE,2043,925,Dire
af62d4b485e2b841dfe3b9d74cf321d0,1552,FALSE,1884,332,
5a1ab142abb96db3a6d808cbe7983635,1097,FALSE,2030,933,Radiant
5ce8111e137a3bfcf81d2ea2a05c1275,2095,FALSE,2499,404,
6f3d304d39aebc474560fe567b8362bf,791,TRUE,1761,970,
ef8c87d4060f753e75e62268514af301,2046,FALSE,2568,522,Dire
91becb7bab6759953e96e14b989c4b1a,39,TRUE,1400,1361,
37da8d97cef37bda7f2c32a114bdaecd,614,FALSE,2911,2297,Dire
21438795018b960a77c66a39a3fc95f0,1650,TRUE,2997,1347,Dire
4c49a700a53a07c31f6dc391a147db43,1585,FALSE,2228,643,Radiant
8340f7abfdc483ff32c33fb668814ea6,1144,FALSE,1597,453,
aa0261c35a535f0dd0a258372d4d9526,924,TRUE,2259,1335,Radiant
0a4fee911d6497a708461e4d7bc70862,2574,TRUE,3632,1058,Radiant
79ee912cc163a2d3a7492e1243afd1bb,1791,FALSE,2939,1148,Radiant
6d886984963bff9343774f06bd5082d2,2246,FALSE,2542,296,
9ef28c6657eed15f43794b265dd8950e,3279,FALSE,3460,181,
2a9e0007984f14b7ecb62b4ec5cc2906,1153,TRUE,1606,453,
11b68e8d9163408c5e33dd86361bef2b,821,TRUE,1316,495,Dire
8750de08a63f0216b895b690b0023494,989,TRUE,2926,1937,Dire
fc3213184bb42235e5bab87d5218a6dc,1244,TRUE,2479,1235,Radiant
4131445a3213ebba29f6b84b51468ef8,1248,TRUE,2464,1216,
9b62332c4633ab6bb7316af7d69e57a4,823,TRUE,1958,1135,
4537ecca7624e3a6219f00db769d2d6f,1487,TRUE,2173,686,Radiant
3e72bd906dd1562e2189a6dfe90808cf,228,FALSE,2362,2134,Dire
3837538ed3af78bd5f8b5dc47884ecc4,1848,FALSE,2089,241,Dire
ef6b9afc7c92478ed1f9ef13f7186346,161,FALSE,1672,1511,
d67244deeff5c1308418ed697f069cfe,1662,TRUE,3013,1351,Dire
f19d3319a9f75a63e9cf358f8c4949e8,1252,FALSE,2813,1561,Radiant
387392708f3de469eaaa1a2c115efc2f,899,FALSE,1389,490,
f9209efdb1591427e627a770256e183a,1519,FALSE,2602,1083,Dire
7ff7c3942ef77491bc589d3fa5affb0a,578,TRUE,2367,1789,Radiant
47b57151b1a52d6bdc58f3e1f1d99d25,922,FALSE,3001,2079,Dire
3dd580bdcaff83e04f06509351857d02,795,FALSE,3250,2455,Dire
3fe8b39f3ec8eaf1d0a6f4a5c6a04064,686,FALSE,1409,723,Dire
1fb935677905491be1ca1922d8185cca,1988,FALSE,2111,123,
b985cb6805f18ccf8e07c57d556158f9,3858,TRUE,4227,369,Radiant
31b1e00af67a845a34a89181a59ab469,1592,TRUE,2326,734,Radiant
26d9f9948b5423f00824cbf97f11c7f4,288,TRUE,1494,1206,Radiant
3e805c2d703dae620ae950b1a93ff336,2106,FALSE,2565,459,Radiant
7b4f3fc563a25a6d4587b31e9900cf52,395,FALSE,1131,736,Radiant
4723c823401902ee3b1f07625d4d54e2,1703,FALSE,2399,696,Dire
2a2d3cf5acef41a21160cd313c81870f,229,FALSE,2339,2110,Dire
5ab6a534116352c808ccc0ae70db3445,1162,TRUE,1503,341,
d9ec768574d19770ea7d2a6744e283ba,28,TRUE,1565,1537,Radiant
d1b3a102d62d26e6b7d558ea1940db48,1231,FALSE,1999,768,Dire
7f47b16c22b1a70008eeef6f51b129d5,1435,TRUE,3254,1819,Dire
46e2f7588fcaf6ecfd395f58f46b96ca,1565,TRUE,2195,630,
2c57acdc868a7d736beeba2dee2a3a40,118,FALSE,2930,2812,Radiant
59c76d370f65e2cf577e079a3f5bf8c8,671,FALSE,3034,2363,Dire
73b16ed1e72613c3b44b1115f8630764,1114,FALSE,3364,2250,Radiant
dba85fa2fe1e6bc0c036c600003bd4f9,2017,TRUE,2127,110,
c7d4813b3babf713b9a1e17755cb31f5,2083,TRUE,2303,220,
88a4febc0120a5695e359def2944156b,461,TRUE,2220,1759,Radiant
b80f6b63eb40491144cf8c65053ad9df,439,TRUE,2509,2070,
9bc44d0968ae8efc4c95f5deb43c38c5,2171,FALSE,2642,471,Dire
d2a1c9ca33bea4e734fbd81574ee4b51,1202,FALSE,2448,1246,Dire
c41db3a1bb90e2be12ae394dc2a0fcca,940,FALSE,1724,784,
d12767767498541ab3742ccbcdb1e257,1328,FALSE,2061,733,Dire
aeb92cb1835b39bcc799d5f2e20a5374,1855,FALSE,3086,1231,Dire
82f9b99f41144674eaa958487c9d711a,1787,TRUE,2263,476,Radiant
582b32db24fa09c0a17c8c686c33ec7f,93,TRUE,1846,1753,
57af25d442604071e10bb25767e8cad9,669,FALSE,1082,413,
f9d551135cdb3171ce2e3a90f9e0ad7c,411,FALSE,2151,1740,Dire
25dbb406613320b438de5bf914de08d5,3266,TRUE,3453,187,
c46680cf7bb0b91e4b4589a021d86488,584,FALSE,2509,1925,Dire
a10f2f8b2bd1709fd47d4cb748fde8fc,400,TRUE,1330,930,
c9d2af4c63e7559931c69ebc21079fe4,382,TRUE,2550,2168,
5c8c00b54c2c6d801a8ec3f414c5415d,366,FALSE,2232,1866,
e239a8c03ab117a620f8c645f3ded3f7,1343,TRUE,1807,464,Radiant
314037b832b70593811cf254f2665c31,1642,FALSE,2578,936,Dire
59678a80c3238403b0c4ae82a18553de,1012,TRUE,2596,1584,Radiant
2a299817bbd6ce4a4f8d9065b599beca,926,FALSE,3433,2507,Radiant
c7bfeadccdc951453e81f55216f4367d,2658,FALSE,2774,116,
261bb6487fff5d0aa0b1d705b6f08b28,433,FALSE,2330,1897,Dire
b07b7b0122485374f529c8f901648bba,2681,FALSE,2775,94,Dire
5da8664e651d739ea06778556cb6d199,1062,FALSE,3246,2184,
e73bb7d47dd122e4442e91c3c7caab98,86,TRUE,2355,2269,
1e438038446b3ba07e189bd3f3284071,2691,TRUE,3588,897,Radiant
2a2f23ede0a219bfef924ed3bf7e2abd,990,FALSE,2112,1122,Dire
04552ef7dd0db83427365e97b5a987fb,570,TRUE,1001,431,
574d11ca9208c56593ad257b274e03c9,1744,TRUE,2506,762,Dire
63cad567a3ecf2b98e0974e07b4316d4,313,FALSE,1924,1611,Dire
6375e1754f1a76be4ab95ca53690a6c4,1064,TRUE,1224,160,
cba943cbe35ade5d9f07b462c8813d1b,2748,FALSE,2992,244,
54e38d8d16d32511aad1198b35702e4f,2897,FALSE,3369,472,
a4058eaa2c5b44452deaac6f768b4fe6,90,FALSE,2051,1961,Dire
ca0707cee1dbbc4da6b9e78f208212ec,1396,FALSE,2132,736,Dire
6dab522e7695081d28348d87bae0f60b,950,TRUE,2739,1789,Radiant
c0ceb3ff310002f7ceddbe038a7aa0e0,1718,FALSE,2757,1039,Dire
542ac1fef2eedb52866b3ee58219b8b0,645,FALSE,2520,1875,Dire
3b7ade680f8afd4c388b8a5c6cbe096c,784,FALSE,973,189,
73def00d666ca81b654c79e4d133a63c,1130,FALSE,2710,1580,Radiant
3f102721a1513a98021a044997824eee,215,FALSE,2690,2475,Dire
039d9fe36ad04ffe241d5bf230e13a9a,2864,TRUE,3872,1008,Radiant
25ddb98a1641c3e594f66daa6563adee,899,TRUE,2519,1620,
0a72ff539f0518645d88a79884414860,1963,TRUE,2461,498,
3b60526fa9b121cd3f639612c05fbeac,215,FALSE,2816,2601,Dire
8d0b9c9e91f81f0ec051e8f2e38eb407,1638,FALSE,1715,77,
1977f929fde76f3a58d4f94e52a033ae,899,TRUE,963,64,
f203c1b827e59a30a4de3cda42ce1498,310,TRUE,1683,1373,Radiant
a2940c70cd57c88593e36ba936551314,2122,TRUE,2714,592,Dire
30b378688a5d51b1b9022e5edf9521ef,962,FALSE,2879,1917,Dire
2aff9a57c83546f66d6693bba0d672bf,460,TRUE,1180,720,Dire
1f947d8bbd005d06cfbb666b6e6a5959,2436,FALSE,2958,522,Dire
53a850a5f137fcbd769e394754e978e1,1279,TRUE,1931,652,Radiant
0afca81d951bcc93f90bfa44f68aca80,2586,TRUE,3447,861,
a1c68824307a57adaab063139d4921a6,718,TRUE,2404,1686,Radiant
70ee2e6cde6a3dc742a711fb2c3964eb,192,TRUE,2285,2093,Radiant
ee8d8e8273f580efaefb50a54b1d0f24,2515,TRUE,3572,1057,Dire
7d6703eb25e164b99fcaa13d8db30536,848,TRUE,2403,1555,Radiant
ad374a5185f6c016cce274b1e3c9fdd9,1986,TRUE,2272,286,Radiant
e665761946d0d149f2bf2daec3824de4,2908,FALSE,4126,1218,Dire
0da85ba6c9960d2315915b0b0c89fe2e,1055,FALSE,1977,922,Radiant
7a3e0d21b45a251315473e06cda5e2c5,1605,TRUE,2096,491,
77e41f8f414446e9e58ca2e557b309aa,1097,TRUE,1881,784,
cf0a7a081748d4512221eed751119245,1737,FALSE,2346,609,Radiant
03329f74d3d040e17f1122a6389fda68,2290,FALSE,3445,1155,Radiant
74c1880aa9ed8ca623213caeeb6019d0,221,TRUE,2877,2656,Radiant
3c7a2935892dcc30cfc0b6783c152ae7,670,FALSE,1611,941,
09f22bd90e9c4ac76b8c651cf48e958f,25,FALSE,1415,1390,
24aaaa26003cae78663eff12267a4450,406,FALSE,1253,847,Dire
bb3ec3b4bc9ff77120afd5a55c2fdc33,783,TRUE,2162,1379,Radiant
219ed12b0fdcf3a355e9f19e324ab8a2,14,FALSE,2364,2350,Dire
0b1f25ad2f5983d8d51e591c31e1be94,3045,TRUE,3327,282,
36ab32cb72b72ae9a39c84ee86612368,659,FALSE,1143,484,Radiant
f6ab9bf13a3e7fa4b7809d14f9af701f,204,TRUE,2376,2172,Radiant
22bed6aeaa53d5d37e8181a70020501d,1272,FALSE,2087,815,Radiant
41e419cd23424c83efec747385f65702,915,TRUE,1929,1014,Radiant
191767ce2c792dc278cb5b21846fa45b,378,TRUE,2289,1911,Radiant
9f477a0a8b8e71331c8b4bc1c995d8e5,1730,FALSE,3494,1764,Radiant
fc90fc389d88479b0a66398fdafc07f8,2279,FALSE,3073,794,
5acc1bf6ff0694a8ccda19b58a42fe20,1443,TRUE,2665,1222,Radiant
c78a7681b3ac541569155e55c7fab6b8,1355,TRUE,3070,1715,
9c73685fa526923362e7bcc7eb901155,1735,FALSE,2136,401,
834bf775394b885995061e8abb1658a4,617,TRUE,3222,2605,Dire
c6aa35e0b3044b15d9caa6da16be4ca8,2454,TRUE,3084,630,Radiant
21b219971a728e1308e8ee9bf6d59b24,2147,FALSE,2607,460,
7bbec98a09f43f1bba031b7493fcc132,1545,FALSE,2614,1069,Dire
c9888aaf547747272082860bacc03658,111,FALSE,2775,2664,Radiant
b2cbbaa1c9e5ef46f9f66f12a622cfa8,444,TRUE,1950,1506,
328d55bc01622874e37d6b03513a16cc,732,FALSE,2804,2072,Dire
6573b4240f9a5b40b445474b6b470d62,877,TRUE,2750,1873,Radiant
6879bb04c519376603a64cc2d9718b4b,1506,TRUE,1956,450,
7afcf305bf43bbb6a6e43f443a17c166,1721,FALSE,2313,592,Radiant
656d84dc450945f1a0d42b733e6d8c57,153,FALSE,3016,2863,Radiant
12b29820485e45720c0cb444bd1dcd02,372,FALSE,1692,1320,Dire
43ca59baca3ae8a07206dcaab0f9ccd0,252,TRUE,3173,2921,Dire
ecdffd8fd8029e898a2a9333cf7e1050,1309,FALSE,1846,537,
0d17d3ec0ec46029a9b11b09fbb2348e,377,FALSE,3299,2922,Radiant
6b66dae2811482ca3d60d62bdc720579,151,TRUE,1296,1145,
a343c61df6f1d6975a0134bf5ce0d84b,1180,TRUE,1372,192,
97c40d33d46b457dffa748ce265ee64e,2659,TRUE,3048,389,Dire
7fa4296b261b4a133e3c26891bbc2c41,2546,TRUE,2964,418,Radiant
7a2be1dd185e14c596931a969a31c1ad,30,FALSE,2894,2864,Radiant
17ae84416e24eb21bf2beac5198549c8,1606,TRUE,1721,115,
b759264b09d0bff80084fdf0de635501,805,FALSE,3991,3186,Radiant
12d7e5c2aa52a5c7f63a08508ec7e1e3,600,TRUE,1224,624,Radiant
6412420611eb039e74e2e42b6e01848d,204,FALSE,2238,2034,
821e5218775089c9e77eef2b5355b8a5,1355,TRUE,1839,484,
76ce54ec525e8ef3c56d6dc664c523c4,44,FALSE,2311,2267,
41a4040ea74516da3b4718d198fe8a19,1057,TRUE,2119,1062,Radiant
dd565104124382e50029b42741c0051d,141,TRUE,2876,2735,Radiant
ef6e0bafe788751785c66b401a20b56e,1860,TRUE,2118,258,
c29ebbd3eb7f489923c10bb002b64cff,2254,TRUE,3223,969,Radiant
de3c9b5945d52f031de5b248e75c1fbd,1623,TRUE,1753,130,
462658004d9a40d16149ad313f900fdb,3457,TRUE,3535,78,
d91d8ba057807bd732f136093e16c249,306,FALSE,2045,1739,
569bbf5c4b7f2181be55ef5a2647b9e7,208,TRUE,2208,2000,Radiant
0608633914b5eb12f07b33f0018e330f,1653,TRUE,2697,1044,Dire
3368b0d743dfe50bccaef8eeb509bf83,1359,FALSE,1920,561,Dire
b38c37ff86ab05fc9bafffe0bda6b724,532,FALSE,2365,1833,
ff1fe75c4016f074ff248724ffd34313,1896,FALSE,2165,269,
10f2158cd42099369e2bfa74432f59c3,1975,FALSE,3051,1076,Dire
54f6f28d6e8c0f8ba60bfd02b5895f52,456,FALSE,2214,1758,Radiant
1af947af5b15ebc7aa9bb4942450f749,1701,TRUE,1841,140,
738c274847cb97ccc4ebdd2bf8859293,1820,TRUE,1929,109,
a05997dd6967c53e06d241d2a224ceee,2286,FALSE,3432,1146,Dire
aea4b42f7400ae14a9b9ac97cce949bf,635,FALSE,2349,1714,Dire
5c9d61aa37860a3f70217348ef782162,917,FALSE,974,57,
adc85e0bee9913d378a5c5b1a808682b,409,TRUE,1818,1409,Radiant
9e6cd9130e0eb04e834582e03cef5f2b,549,FALSE,1061,512,
13fb04cef2057842f26f9ba8bdd7cd28,715,TRUE,2026,1311,Radiant
8d1af66fae9a74934c27c67e9800b97b,785,TRUE,2152,1367,Radiant
2628dadcd969c4b5eb474e08d74b7933,211,TRUE,2063,1852,Radiant
fe01f3eab0682fbd63d4314701ebb321,1405,TRUE,2541,1136,Radiant
6303a374977f42ac2543c45d403c9663,435,FALSE,3374,2939,Radiant
6ff2d1e96dbad4187b1ace2dd67e206b,846,FALSE,2882,2036,Dire
4832add683a031c4fe34abcf32e21d39,1737,TRUE,2787,1050,Radiant
2216f58780f5f4fd074fadbf073c6953,1214,TRUE,2339,1125,Radiant
b956251182f901dc6147dfe8bcf3822d,1903,FALSE,2847,944,Radiant
9affd1bc71c2d14c62e105edb5c82348,1618,FALSE,2147,529,Dire
64b88fb534e63fdb1d8954e6d218df94,850,FALSE,1024,174,
26b5e9d20356ca248d2e336f08989e75,378,FALSE,1934,1556,Dire
fa597b79fe9140c8e84ee619296e4e31,2549,FALSE,2801,252,Dire
f28aafbc43e80ca39b50f955fa844642,1435,FALSE,2763,1328,Dire
159f90d02b8777edc829d371dba8850c,949,TRUE,2637,1688,Dire
126a9d42ad459514e25158cd782cdd2a,1810,TRUE,2222,412,
442f1fbd228b7e3d35d09416ac5725f5,661,FALSE,1166,505,Dire
c482f14625b0a595a3903677b9cad4bc,1057,FALSE,2782,1725,Dire
a280f22c071f67a2f1195b3c29205867,466,FALSE,1633,1167,Radiant
f9c117e8bc3ff0d87a9ff071ce05134c,2096,FALSE,2635,539,Dire
bf700f005c6f98f0325191bdd9f9e531,873,FALSE,2081,1208,Dire
78681ffa0dd4594c6d64b7a65c9504e5,1399,FALSE,1918,519,Dire
107549fb1feac3ead14cb6e2e9acc2d7,1173,TRUE,2079,906,Radiant
0f0aaea24877f26d805f34ebbef7d181,49,FALSE,2984,2935,Radiant
13b4b35ebf79cad915decbe2dfb4ac2c,914,TRUE,2643,1729,Radiant
b03bc494d7eeb4ded3d23806e711ebc5,861,TRUE,1880,1019,
5e335bfd69ad9c8987a7210f957c4f16,1432,TRUE,1887,455,Radiant
ceed00af78fd7b6b57b3e7514c097764,891,TRUE,2565,1674,Dire
72be2ff414be9f88eb18a9b3c7467986,429,FALSE,2131,1702,Dire
b32b52de4112c454ff05f763a01bed62,54,TRUE,2283,2229,Dire
fa69e19ea0491e23c49d5d9ccb51abcc,15,FALSE,2460,2445,
c28028de395ea8953ad3de654861a8f1,605,FALSE,2825,2220,Dire
0f3b9a2a9cdfb6823a144ad64557141e,537,FALSE,2017,1480,Dire
17bf00b6314f11ecb261fb676f7ea59b,485,FALSE,2340,1855,Dire
0ec834b750929c2177ca9f6f18658f2b,150,TRUE,2037,1887,Radiant
ce8e3c140a65540c352157ace8d2bdd9,1209,FALSE,1451,242,
6b14c828329f9321255f739c56a56b63,884,FALSE,2856,1972,Dire
4c50b09f495ccaeed0b994e6edd3c2fb,388,FALSE,1636,1248,
47feadd7cd165feda9e2cadd32d262c0,654,TRUE,2472,1818,Radiant
f4a2d043060f5ee0c75eedb760a85eb8,1181,FALSE,2713,1532,Radiant
106eaaef5f4af1971445e7121608fa3d,604,FALSE,2392,1788,Radiant
7722b79d86a99a42308d795466e7d2b5,2381,FALSE,2537,156,Dire
3ddc8fb9bede04686e556396b98de128,2226,TRUE,4028,1802,Dire
9de29b40f489f4566faa97f75a3a4bc5,1473,FALSE,1641,168,
b4d26832f3260fa926a298009157e12c,2383,FALSE,2916,533,Radiant
87872e82eb2a66b27f754d987fa31326,2589,FALSE,2992,403,Dire
60be639523679af79c4812561d85228e,3261,FALSE,4057,796,Dire
8eeb0bc31b05016acfe05a0a3521788d,2665,TRUE,4046,1381,Dire
74709567f25b1cc697788a420fbc63f0,515,FALSE,2781,2266,
66ff8aaf027a8bda5b243c221f99998a,138,TRUE,2456,2318,Dire
e8ea6ffe0ca9c69af1257f7716712abd,544,TRUE,1205,661,
09cfc23289c9fbabd8a0cbc7d27a23f8,2261,FALSE,2363,102,
3c607361902e94028d3cab4cdc4d4487,1189,TRUE,1642,453,Radiant
25d39dce06d8b769f6a7a5e059f3c6a7,2119,TRUE,2219,100,
000c4b8cb4b083a6cf04c665187e4b30,1386,TRUE,1760,374,Radiant
0fc301eca56637039fe090c04fdffac0,14,FALSE,2491,2477,Dire
f62d3986a54e5b962ce59635d7f2f7a4,2160,TRUE,2533,373,Radiant
7ac1cbb7d5bd9e814d1f808b01fe2365,682,TRUE,1929,1247,Radiant
259ebc3da9a196f45b42e32f94c620d4,411,FALSE,1570,1159,
e604db9cc273f6e8c266c9987d80998e,199,FALSE,2609,2410,Radiant
4022a9fa89dd79b47fbf0831c47e3988,2185,FALSE,2265,80,
eab1c96b01417778c6835a92641b2573,467,TRUE,2940,2473,Radiant
b2229962d8cd82d9ccd92cb78f0f7f20,36,TRUE,1026,990,
106688a4d74e3b18e7648d21e1152fb2,2226,TRUE,2751,525,Radiant
f10129460e90e2a5aca9b7d65d25f757,1639,FALSE,2677,1038,Radiant
f6349168fb29b32839353dbcfb09a83e,1996,TRUE,2166,170,
a039379d8ed3111277d4d5b188858b3c,616,TRUE,2865,2249,Dire
af37d114a3d18eb6e79854c72db1c3af,43,TRUE,1546,1503,
bf656492aef5d42ee42f40470d5f3e8d,585,FALSE,1511,926,
2a0d0e513eafcb6095db34800b00d6cf,434,FALSE,1450,1016,Dire
0570125f736af1e2e96883cedf7bf2b7,713,FALSE,1973,1260,Dire
386df10fa157cac702576f61b9a131b3,683,TRUE,2235,1552,Dire
ab49f5bcb8bb0987b5e80d828107d95b,210,TRUE,1153,943,
f804c5d6526480da728e64026426db29,346,TRUE,1558,1212,
c2b37e1a48cf15b273a3d9f1da99d9b4,529,FALSE,2388,1859,Dire
eb02cbe225bd8e5a52f17f3783a407f7,1118,FALSE,1913,795,Dire
56512244dd01fc705a429c1d7fdc472b,1469,FALSE,3424,1955,Dire
c39add3ac10a957486d88a07d0d408dd,168,FALSE,2698,2530,Radiant
83298888acb43463394bbedd2398145e,278,TRUE,3046,2768,Radiant
30bcdafea93977aea375f368e7e6519f,275,FALSE,1994,1719,
071dac94100e5afcc7e9380f0a4193e8,1000,TRUE,1161,161,
b9d5093e54ef6c9ccc9fbdcfb556fa5a,1242,FALSE,1890,648,Dire
089a659781ab6d6116c63507d737c382,458,FALSE,3264,2806,Dire
9e388bb284e3081d4e9d72a7d82d87e2,1029,TRUE,2364,1335,Radiant
50d3024fcf968b02a0d844a200eaac4e,808,TRUE,2090,1282,Radiant
684c42a2ce50abdc6b01942395c26580,653,FALSE,1861,1208,
07478046e573bdb07ae5f4f723a172db,3438,TRUE,3780,342,
2fe648b37440a36fb423595aae7eb998,95,TRUE,1392,1297,
96821fdffc96538536902eb31407a3cd,1225,TRUE,2459,1234,Dire
64e9e4847a1198a05748c225032ef6e3,1595,FALSE,1915,320,
6a0c9ce116bd1b5562805bf60e53566a,669,FALSE,1666,997,
18a6e9de4f197e790b167d93b57579a4,889,TRUE,1436,547,
e16c28c31c907fad57612c6dbf647112,2224,FALSE,2532,308,
c0eadbb70c09e5586680c2c4ba4123a3,2206,FALSE,2463,257,
56f3830b635709cc0aad33c8cb63ee1e,1136,FALSE,1729,593,
6d94d34efd3bbb6d49c5b72edb2af5b7,509,FALSE,2517,2008,Radiant
f8300743b45626b13dbca5a45f0c9895,1930,TRUE,2757,827,Radiant
ea28a901b72d8dee7824d98fc876b933,1691,FALSE,2526,835,Dire
8e2cc0d0b0940b4024211a90a8bd6b2b,608,TRUE,3259,2651,Radiant
ffd4c6a9b443c76c3a05d02c75fd9f0b,1996,TRUE,2215,219,
8e0c95d18145a4ab357e4550fa217d51,1270,TRUE,1741,471,Radiant
b70c4ad3ad86c25a26f1d143c0b8bcc3,442,TRUE,1933,1491,Radiant
5886d7cde19ccf710e73926d6eb1ca82,2220,FALSE,2277,57,
e37b09ef423a7a2dbc0c37e886e97bef,2023,TRUE,2602,579,Radiant
ab94c67b4aff21581251f1dbbe3de84a,428,FALSE,1213,785,Radiant
fecb32e758a548f1673eab820d1d7a24,1400,TRUE,3527,2127,Radiant
4ab377524e0aee4e1da67815ab27cad0,680,TRUE,2126,1446,Radiant
60aa2cc01edfd267a6e572fd4be0bc41,380,FALSE,1566,1186,Dire
d55b6ff7be2fe0061ba3b2456651d1a2,4,TRUE,1788,1784,
1ff2e422e2620ef2e4c7f5e0386effc9,256,FALSE,3018,2762,Dire
4f16411693e4b679941d316c6d8f145b,936,TRUE,2163,1227,Radiant
4cbc14c55ab3f6547edb4b42b12829ec,101,FALSE,2222,2121,Dire
a733f7d657f0e4150ed55711433a3dbf,933,FALSE,1887,954,Dire
8a01917f2d3868b323635f7616a15b93,91,TRUE,2457,2366,Radiant
172b67f089cd5270099d06d6a11d0f04,1542,TRUE,1649,107,
3514b8b84e741497095dec473f501daf,209,FALSE,1412,1203,Dire
cb439dd3f33973699ec817f423f6ea9a,1820,FALSE,2604,784,
5c2cb2a174aa1360b9e42c3ea239dd05,2590,FALSE,2827,237,
7b2c56ac7ada87262366da663adc6fde,1806,TRUE,2282,476,Dire
5106ad95e65974c743800a806ec03c9e,2626,TRUE,3002,376,
340272d593540167ac196f2d59b80555,702,FALSE,1256,554,
9d93ee85059ddacaa7d253f8b576d782,1593,TRUE,1985,392,
7895304a22a08e0406ca6408f6365c5e,1464,FALSE,1904,440,Dire
b4677e9da129c57633afd80ccdbde764,1389,FALSE,2399,1010,
4ab553b577e8651063fbabdce9ca0446,839,TRUE,2547,1708,Radiant
79d8d9e5db8efe42b671dc70ac5dec4d,112,TRUE,1240,1128,
c68ef186b78e1aa2d05540e3ef60b14a,1851,FALSE,2229,378,Dire
affe82a763e52289d15e3a894f30a679,826,FALSE,917,91,
b3fa2ff59cc23eb24140a646c5885066,1883,FALSE,3593,1710,Dire
46bef1bd9ddad5661c5fe670efc985c9,1291,TRUE,3320,2029,Radiant
460a9330dd50fe9bddb046334989e65d,539,TRUE,1615,1076,Radiant
6885ae7af7486a6b33ce7d5d47b9a29a,663,TRUE,2010,1347,
1f1004b872984704bb0d7018d06bebb3,3415,TRUE,3828,413,
f1e07abcca7d20d31c3a4a7c64a6ca7f,313,FALSE,2403,2090,Dire
d81fa546d0055d602800de7d69c37d34,2143,FALSE,3133,990,
f17f2f4302b4ada92dc00032a1e0e65d,2825,TRUE,3069,244,
c5775b9fbbad15ed9f5c49eb83215977,26,FALSE,1431,1405,
cd8e031830bfbe4907bbdcb43b146a43,2691,FALSE,3394,703,Dire
667624c305314750985e402be02f4e61,136,FALSE,2832,2696,Dire
7a7e334a401b8a15799c2c825ceacf2c,787,TRUE,2049,1262,
b588f5e1f1d111da26fa3fa4e17eb843,1527,TRUE,1570,43,
fd2d45ea1e3ddde087d15a53dbec98ce,5,FALSE,2892,2887,Radiant
bef49729c3def441d6f849ae454e4f88,690,TRUE,1562,872,Radiant
b7bc3928dcfe7ae63004add24bebd291,2078,FALSE,2904,826,
5ad5559628980540fcfca684b19d3142,1557,FALSE,2785,1228,Dire
8a8f10ac34089f1ebd1bcf60b26ec203,1845,TRUE,2318,473,
43aaeac9c87a152a3105baabaf336743,1274,FALSE,3358,2084,Radiant
7323968f505d04686f0303f39b067a4f,2024,FALSE,2376,352,Dire
f939c2c1ec7a42afb0eda643000979a1,1590,FALSE,2314,724,Dire
09c6d1b642816d5228cc2003e19cc5d0,344,TRUE,2119,1775,Radiant
0c80494e687f87809030c230f56ecba2,19,FALSE,2281,2262,Dire
9b24b8b62adb4f2e09c5c7ad23f6a957,281,TRUE,1689,1408,Radiant
83d74219439984de295fa0084f230fd6,1243,TRUE,1676,433,
44b254507d8f4580451b9464b792632e,1149,TRUE,2645,1496,Radiant
bac213d90613831517a7049dea1e36d6,1790,FALSE,2448,658,Radiant
acd157ddc801607431b3125fbd29f7ef,849,TRUE,1535,686,
b21bba9bd03f4c0d503648f298869bde,2251,FALSE,2963,712,Dire
d3f70130e26530e107573908826a4546,1902,FALSE,2224,322,
962cdde17e7befd0e8479cfc4c15d1cb,2545,TRUE,2923,378,Radiant
7f8e423201ef697dddd4f29ec8e530ba,1738,FALSE,2102,364,Dire
745a4c566db5492cf91135ab4af853e8,693,FALSE,2512,1819,Dire
b2bf395e87317baac9c76ae977d40ec8,1486,FALSE,3217,1731,Dire
575917dd34043d674076ec2bb3d7dc35,2428,FALSE,3230,802,Dire
dd773fac1ef85a1aeeb8f552c9700dd0,1553,FALSE,3075,1522,Radiant
d388fff352fac166712e8dbc0fa39d7b,660,TRUE,1536,876,Radiant
fc8558d63b6e7eba4e766b067f5a5214,884,FALSE,1531,647,
f4dc9814f0f30215c24d6a47a92f32c9,998,FALSE,3935,2937,Radiant
07ee2f4e72316d417dc55fc981df1603,921,FALSE,2727,1806,Radiant
2562511befdb7c32885eccdabe052c9f,764,TRUE,1897,1133,Dire
ec218c11c8aa98ce696ba7770b45392e,662,FALSE,2473,1811,Dire
71d6addc74b5055f17fa2b9d9058749b,1430,FALSE,1829,399,
d4b3abed0a74c7e080319b9f545aceb3,1934,FALSE,2188,254,Dire
733558d3ef3c54714aa92b6e7d47947f,1948,FALSE,2152,204,
8cf5a4e574b1aaf3dbb8263554bf0fdf,364,FALSE,2179,1815,
4d9a583fb28bea53c146622306fe4205,142,TRUE,1115,973,
b359fc8eaba4d7aab9744a94b509c1bc,280,TRUE,1750,1470,
daf802a83d4f685cefeb7ad5b58255c6,1840,TRUE,3559,1719,Radiant
55ff61916ce7af34e965ef8b2e0dea6d,210,FALSE,1605,1395,Dire
76f1c280d440ae85226e88d181fbf7ed,1975,TRUE,2882,907,Radiant
f39ac2828a34dfa0b1654b8a91d632e1,963,FALSE,2533,1570,Dire
77604689450145f64103432f8b83a4f5,2035,TRUE,2545,510,
ae804eeeb2298334b4cda9d63e47038a,680,FALSE,3081,2401,Dire
057a3aeb6af6c8b7d25b39a0dc748574,71,TRUE,1895,1824,
5f2852e49fa557d162e78e0676e88be5,787,FALSE,2227,1440,Dire
5054b46134d68369813ef9125256718c,927,TRUE,1647,720,
b02e0a69bdf5ca1e68aabc9288f62424,2268,TRUE,2777,509,Radiant
94c7742c54350661a978dce7702e8653,1835,TRUE,2130,295,
c4c621b5d00e5ba365274a0459177c6f,62,FALSE,1909,1847,Radiant
e5d500217572a21fe5f84c6ebf220371,658,FALSE,2925,2267,Dire
253a1c0f183c54d77aca8905bb8d175a,666,FALSE,2702,2036,Dire
ee6403f0dbcfbaa7c1df5c5038b1d324,2828,FALSE,4007,1179,
1aacaddaf3430837dec555af7556d90f,206,TRUE,1199,993,
ca50c0f8eba2a23b00643fbe0234ed64,2827,FALSE,2991,164,
732078745485d46bb08d98d5fa9c84ee,670,TRUE,2216,1546,Radiant
9f11bb0ce686558c0e31ed7a53363dea,496,TRUE,2466,1970,Radiant
010a2e72ec7efca559a24c8822b668f8,1423,FALSE,2511,1088,Dire
22392c693dbcbd1383944e05ec105b22,3259,TRUE,3341,82,
80b9742bc8ed1e366974bd10889ef8d3,1675,FALSE,2969,1294,Radiant
d979167b4893446e92223c8560297e0b,1542,FALSE,2587,1045,Dire
d175877f609d3d34b6dc7cb4b8307b00,2560,FALSE,3363,803,Radiant
bc472c681014100b231d920577545277,4,FALSE,2629,2625,Dire
8e3e1916c4678cc6717fea44ed2f3bd6,412,TRUE,2953,2541,Radiant
2d87d6b5bc3e81b5ff0ba634fcad7b9e,107,TRUE,1270,1163,
545db65aa23247ab652b1837bc5f0688,630,FALSE,2507,1877,
7119fbf99abd2c64db8194a63b7746e8,640,FALSE,1369,729,Dire
0d34e4a526a4daa80d87bd77b06fb3e6,997,TRUE,1995,998,Radiant
899103c3b128f1def21604d5b00a3b7b,113,FALSE,2353,2240,Radiant
432acb0d8d495e155b12af8ff7902a67,427,FALSE,2377,1950,Dire
09cf70df30ef87ef6cbacf06ea36d43d,309,FALSE,2429,2120,Dire
e6c9791250cec7ceaa1ec53735080e1e,1448,TRUE,1977,529,
7b2cc1a3058e4de166a4d49398ca3030,370,TRUE,3124,2754,Dire
52620257113b1c6ee93391a661d39271,1732,FALSE,2842,1110,Dire
1cbbc8389f558ea31153e31d7f6b999e,614,TRUE,2527,1913,Dire
3b6c78491d2e4aba9692f1227e10fdd8,623,TRUE,2083,1460,
0ad762849f74befae6f598ad45e982ad,1056,TRUE,2218,1162,Dire
dd2a314b5d067d35629a822df40eea2e,428,TRUE,1535,1107,
52cff610fcb9acdcd63e251302b17590,314,FALSE,2395,2081,Dire
5c32c3b4b2a619eaee4a2bbee340dc0e,698,FALSE,3028,2330,Dire
bb7c65b5f26abf699a48c42844d40981,1592,FALSE,1717,125,
eef4aa3b7a83a96c2b57c7c1a11ff7fa,1271,FALSE,2113,842,Dire
5b5e6caafb36243f0a05a0a9a172f9f0,1645,TRUE,2122,477,
af8a6a51e96d7a8d693e3d5b0a89abe6,1946,TRUE,2558,612,
0aa10b43e97e1203920b49e669be788c,1447,TRUE,1510,63,
727fb6b4c430cb3b1ef49824cda721f9,2044,FALSE,2614,570,
211257e10f8710f72ae196c71494b984,425,TRUE,1655,1230,Radiant
7c092abca08ba6f9471e1a6753d675c2,1102,FALSE,2213,1111,Dire
8f6078fb8a20739f13cf1a03e439b04d,3875,TRUE,4084,209,
9f8dad7bb3b263a63928f7a2c4a0b78e,108,TRUE,3116,3008,
b196cd1e62c40e5b07dca3ca90deabef,63,TRUE,1798,1735,
aa9fa0f687680d8366980f2e3513f605,709,TRUE,2444,1735,Radiant
6113b001e2ab20bd166e9da5da88998e,1520,TRUE,2246,726,Radiant
6be6be59070ca31d9d10226f471e2783,1457,FALSE,2456,999,Dire
004f258cb0aec3c2612ec04ab4544d6a,13,FALSE,1800,1787,
d4f59d67a9da6ad0f7bd9f93f33bda9c,267,TRUE,2225,1958,Radiant
c8b25dde34a646a7f27f71505c30892b,559,FALSE,2191,1632,Dire
4d74473e88b3ac7ed4ef987bf9080d04,447,FALSE,1378,931,Dire
44dd4273b6b9a92864426d60bde09087,359,FALSE,3136,2777,Radiant
a616d69ef2881337cad4d479b6eea686,1216,TRUE,3122,1906,Dire
17f82bc8527518418fdda9239d12c50c,1409,FALSE,1900,491,
cce73bfa408fb2b33db6565364b23ad9,1496,FALSE,2498,1002,Dire
9b15aa34115956bb5ef68d0be1c20ee9,1517,TRUE,2202,685,Radiant
cef0795c882c68ec17dedc5f903c5048,2010,FALSE,2121,111,
e86004559ef1a26115a25ab8f3724222,1869,FALSE,2754,885,Radiant
8a172f86da2b0a896944c38cd349139c,289,FALSE,2120,1831,Dire
3b4ab162eadfba91ddd4cfb3361c78b8,2798,TRUE,2848,50,
fa00b39429a544de5eeda073a8c7d735,1273,FALSE,2634,1361,Dire
31268c7c97ca10919562f4c71d5c29f8,498,FALSE,3192,2694,Dire
e0c113d0b27a9b3817b1b2e5f559a50f,306,FALSE,2966,2660,Radiant
dfa579e336f289d7e5ec3921a7572350,2882,FALSE,2920,38,
4891b69c2631eb2165d23c2cdaa9c45a,1318,TRUE,2327,1009,
d73be4849e7216edab4d503216d2c6a4,604,TRUE,3124,2520,Radiant
94820bf6bdbed3352e83dee5312a891b,342,TRUE,1538,1196,Dire
188a6b04c984cc8af0ab411e6956134c,785,FALSE,1279,494,
ea60fe607b4a0b7a44ba2aa37fe263c3,762,FALSE,2483,1721,Dire
2b8ceae22094ff89635a94350ef53769,478,TRUE,953,475,
ca2fcc45248c3ce84413eb2e8faffebd,1217,TRUE,2482,1265,
dd72b6b5cc681728e3ae71defb8c2013,1076,FALSE,2477,1401,Dire
80f579a863e9a0c483a20faa0b22cd66,55,FALSE,1668,1613,
27ee759575b9af16557377f3265af6a8,516,FALSE,1439,923,
b2936c797e07161185da4245680ac213,406,TRUE,2349,1943,Radiant
776928100c6aaa0d42a133681435a914,1806,TRUE,2366,560,Radiant
da3306d945295c315ddea8e31bbc0f59,148,TRUE,2100,1952,Radiant
9b19c898a0874f0e9a2a08a401ad4d30,1096,FALSE,2319,1223,
dd28d5c0ed6b791500b499bb62ff5867,875,TRUE,2657,1782,Radiant
e7083b58c2092d1b4286684d02c01253,1576,FALSE,2090,514,
fad91066d335d4c169c837e9ddab6d07,976,FALSE,2681,1705,Dire
fde604e6ef3ddb53a140ca047391b77e,2840,TRUE,2889,49,
1ecf43ac04db2f4328af4c52eaa938a9,2385,FALSE,2504,119,
be5ea66d4b594b77d184b50fc475cb9c,184,FALSE,2149,1965,Dire
d61958b93239f57ebc9153124fc0d21a,45,FALSE,1626,1581,
b1bc8d7074de904fa3c63e3974aa0d0e,988,FALSE,1203,215,
5038db9cfd7ab9862e834474dbe857f9,906,FALSE,2980,2074,Radiant
abc299b649323d51a7b423fbbaf49298,755,TRUE,2571,1816,Dire
8414a5d316d4e8340df990d309396f17,2097,FALSE,2393,296,
0b7dec1f3cc55ceef8a6f2278550b634,1794,FALSE,3056,1262,Radiant
78843a2122c47237a62f7b0e7c8ad8f4,1653,TRUE,2315,662,
7b6952c6d89f9c7d9a9259e274b75719,613,TRUE,1625,1012,Radiant
85fd469eb2166d24718d47169535875a,1373,FALSE,2531,1158,Dire
e5b10fa5568afe67c9227339afbe1f39,155,FALSE,2594,2439,
cfc21b58c3310e78f23469ab3b50c15a,1919,TRUE,3195,1276,Radiant
ff96cf344e15a8e81fe14ae905250b35,1008,FALSE,1432,424,Dire
76d8ed8f61a7c32c5ccfba1e0c06545f,996,TRUE,1886,890,
57ce8cc1a29b427e84e13a42032af56f,1242,FALSE,2782,1540,Dire
0332a0734e2ad1e300fb9e1a1adb3dee,1089,FALSE,2334,1245,Dire
b41752d1d59c03c9759357b5aa1700c1,354,TRUE,1860,1506,
1eca5714d54d7da718df0f9b0c00e5ec,1361,FALSE,1924,563,
69eb6bf2edf9368783585721b47e006c,1464,FALSE,1599,135,
42f94fd2b59ff0080cc16b16624f6ca8,499,FALSE,2006,1507,
61564b06902dd588bd0538ed96928c52,1412,TRUE,2269,857,Radiant
d5214fff850ac31f26baff018ed5370d,283,FALSE,2056,1773,Dire
75cdaa7798e4adab6f42352aaee5684b,718,TRUE,1485,767,
815e291cb61f68f841a93f4050b8b277,808,TRUE,2377,1569,Dire
7102e59a2129fac8e9ffccdc9dc360e1,961,TRUE,2571,1610,Radiant
d9ff37f400df3bf26ba75edd92370664,368,TRUE,1942,1574,Radiant
76824984633469d3092169d68f30d2ef,442,TRUE,2252,1810,Radiant
22ebaf1fd5b253d39e07b17ea0ff2497,531,FALSE,2933,2402,Radiant
63580558d19928d9067f763f65fda86d,331,TRUE,3546,3215,Dire
1213591fb7e58f7d70822d56724a932a,323,TRUE,2491,2168,Radiant
9c12569bd38ceeb6069b86304fe1eea8,58,TRUE,2318,2260,Radiant
6f7425d5c0fd3400a9042052769d9df7,2609,FALSE,2779,170,
a962fe5fb6e476b7328c04c60ea5b80d,1056,TRUE,1553,497,
68203a74ff1d728ab05eee53fbceec94,1409,TRUE,1861,452,Radiant
a683052a399c5b2abeb041d3d1629cb9,2403,FALSE,2596,193,
38dd31b6429700750823325ab2d4f121,1110,TRUE,2055,945,Radiant
da847c6580eb1c6a87de3cc657ce19b2,1622,TRUE,2069,447,Radiant
528ad03ec5005b15bfa65d6431cbafc5,972,TRUE,1569,597,
edb2e83d9ce3101533d2f0123552ea4f,2363,FALSE,2491,128,
3d0c23a9c7285a4d97712603737dd65d,1301,FALSE,3160,1859,Dire
881a66289009ac7863b9c906abbf3e8b,900,FALSE,2602,1702,Dire
7b8ca32145a131be53e6349d685ce53a,1434,TRUE,1479,45,
64f2d0b4cbcbd11bad3c879d969b2450,1429,TRUE,4302,2873,Radiant
cc40e452ba0954f02f53f0ddb43156e8,1074,TRUE,1603,529,Radiant
a77fa3a18d19c77f509ab0f17105400d,384,TRUE,2129,1745,
243e007dc0736f230759b821d3c74e99,2437,TRUE,2515,78,
0f92724d1d5e24b95f702924f2161785,1086,FALSE,2318,1232,
05e46b179ca4098fe5ec5dc19a4ae6a8,498,FALSE,2248,1750,Dire
1433f450d083ddb32f4153879eca0930,478,FALSE,3618,3140,Radiant
463cdee4c9b685ba66a5cf58609f50f5,2833,FALSE,3374,541,
f8176da474050741dd4b6d83c301af63,2517,FALSE,3087,570,Dire
69766c68b05f7267ba58599426f62e1b,504,TRUE,2098,1594,Radiant
d9cff18d92f04697d0c901a9c3b72fd0,440,TRUE,1722,1282,Radiant
0f8048162d727b9ef8ea77084bb1005c,439,TRUE,3075,2636,Radiant
97f6a55b27cb086775ba36ad6760df33,304,FALSE,3529,3225,Radiant
ca158218b6339bc711050d302d9c52e7,3301,TRUE,4195,894,Dire
e19dd0e3b433caf38f440a93349e92f8,2683,TRUE,4020,1337,Dire
8a7e853b67715c1be4d12e72422bb320,1421,FALSE,1532,111,
982f839bd47986cb8174e20341e86c1e,2034,TRUE,2856,822,
9fde7ff8956603ca9695021bdea26aa6,1736,TRUE,1817,81,
8eb650bca51c0e57f8a31d7db19866b6,213,TRUE,1788,1575,Dire
b6f4a0e6541d067a7c3c2f2fc74f3e47,385,TRUE,1135,750,Radiant
3c72e8de33cfa7f1369a2a46780e0e57,1489,TRUE,2436,947,Radiant
b185e379ffc346e59ec6dbdbfa68c3c6,864,TRUE,2188,1324,Radiant
998c7f3037306c500b4cfcb45224776a,1006,TRUE,1990,984,
d932e8da75dc7ba9b773c3412be4b767,1704,TRUE,2319,615,Radiant
28bf8c645654c457c8fa2b845da0fc03,849,FALSE,2738,1889,Dire
75e9cfeaff2ceaa6d903f0cc2466cc9e,371,FALSE,2105,1734,Dire
6728fd2dd4dd8fbea2e19387e19a6e1e,1478,FALSE,2467,989,Dire
9a598c12c9102a184229310dbb4a365d,1808,FALSE,2599,791,
d80746a43d74ba5c6fe5399b3cd99103,349,FALSE,2153,1804,Dire
d281d7e2214ea59acfd2f906be43440c,691,TRUE,2277,1586,Radiant
182cd4a3a281a354a5b028b41b4359e1,1043,TRUE,2298,1255,Radiant
6be2825e0ef2af23dd3628b3e36b337b,1057,FALSE,2386,1329,Radiant
15ace4328db84eca002f478dd7f65450,461,TRUE,2840,2379,Dire
51242b5f670e419cc469a73390b69248,1839,TRUE,2215,376,Radiant
c212209381b74241904a0bc79f397dbe,1253,FALSE,2034,781,
49812a9086300eeb664ad7a495cf405b,1546,FALSE,2129,583,
535157518d1f089fefc8907ad5db1218,955,TRUE,2538,1583,
e770125871d879ee639a7cecec9e8483,1362,TRUE,2709,1347,Radiant
b87aae7af4c2ee75f1ca0af632bed486,903,FALSE,1872,969,
48fa3073551ab3337d7b34eaface0c3b,1487,TRUE,2916,1429,Dire
bc58b0aa7a150a817bb9106709f28f01,2831,FALSE,2978,147,
8862d9bc4a1f5b612492eb8b9d5260f4,565,TRUE,1146,581,
ad473e1456b1380337e2c65087aaafb1,1893,FALSE,2473,580,Dire
68f66d2fddf94cd368a91bb865707348,2780,FALSE,3229,449,Radiant
0427d297464b64f77de4a14bcdf4b363,1908,FALSE,2753,845,Dire
7d387136122324d6384f7ea2977565ac,493,FALSE,2163,1670,Dire
444d0f7c697ff8eb3761288bc97729e2,762,TRUE,2076,1314,Radiant
c19d004353612c022a4065c7583f3a05,291,FALSE,1134,843,
67e1bd08e9c503ca2eb45fff4045ca17,500,FALSE,1987,1487,
65e1feded81f99bd0d0a8cbd14f6e1f5,1970,FALSE,2119,149,Dire
5f9e71f7b2e7e6c4ad9f46386f8e4b1d,605,FALSE,1676,1071,Dire
ef18b694c59be9401b3c08bbefffee6a,21,TRUE,1926,1905,
df435060ec45eb403c26f436f05f8ef2,750,TRUE,3113,2363,Radiant
2bf0d3c76f85a680d2ab7dcdb77f7cd1,158,TRUE,2438,2280,Radiant
e9bfe9a263e563155d9ae4fae3971e10,906,TRUE,2776,1870,Radiant
51b8eb1ee98c2af834e671a509913171,693,TRUE,2190,1497,Radiant
579fe6ce704769e71a076b9aa237fe61,1066,FALSE,1467,401,Dire
468d7c1988af84ef0dc79384651096aa,929,TRUE,2837,1908,
a5f9dfa27831d8da2b1298a1d9b094d7,1122,TRUE,1885,763,Radiant
292df8f67db6f86e8509a3d52ebed451,1160,TRUE,1691,531,Radiant
042eb5350bf97e647b57d3b0c9fba4f9,258,FALSE,1956,1698,Dire
a1e551d7627e43d5fe2c6f39a75e5ed9,769,TRUE,2615,1846,
ac5b8c46f555c0a9de279619ff9d995d,1137,FALSE,2138,1001,Dire
69b6c4e6b61f75c229162e765d957854,129,FALSE,3268,3139,Dire
94046dcbe3a4c2841bf1f5ad4ef6ba1c,780,FALSE,1940,1160,Dire
86a2a2d099b01011e9e5c70054646072,1413,TRUE,3345,1932,Radiant
5362db7d76e14d592feb359d47559ce9,1038,TRUE,1712,674,Radiant
7674066cb121730a216c4218eb9cd4e7,938,FALSE,3017,2079,Radiant
0b71be203adbb968b1a3c3c08b1eaece,2287,FALSE,2984,697,
180b51f1e7a3532db55b341112f7560a,2181,TRUE,2731,550,
7f7fd79688a4e2bcadb5eac0e9df0cfa,188,FALSE,2093,1905,Dire
ae8c5298964555ef03720c24bc41ee35,3041,FALSE,3920,879,Radiant
d2eac1413f62dd5d718e938ec3b69b8d,433,FALSE,3667,3234,Radiant
8f1921e00ae3b4e3bff7341d3c0b2a14,730,FALSE,2364,1634,Radiant
add05e874b3540facee11eb34c4ab505,1439,FALSE,1946,507,
3cde28d430786b8a2eef66cfd980efd4,1222,TRUE,1678,456,Radiant
3d8d05f06ce0929abde1575cb373a4eb,3522,TRUE,3639,117,Radiant
648ce10a00288458b2c8b35ec88134cf,1696,TRUE,2433,737,Radiant
49eda2ec31cf91adb08fa67344964777,1641,FALSE,2761,1120,Dire
976a860c6d021d7d950f630aba8dfad3,426,FALSE,1999,1573,Dire
2e6a23f884d13fbdc7982dda16addb58,868,TRUE,1853,985,Radiant
09b8d3ed0a6ed2f5651da00f6dc92b73,1926,TRUE,3554,1628,Radiant
fa8ffd01cc5d1a158cc9bb8cec4df7b8,1188,FALSE,2350,1162,
3a2a55b85e7c0c979876d7f07063e64b,2530,FALSE,3166,636,Dire
2f7ce2cbe37bbb2ad161fa08b785c2b6,1066,TRUE,1956,890,Radiant
7ff18153917926e2fffcae3af105a00a,527,TRUE,4182,3655,Radiant
2d5613abdd56e5a7be2df4f323337387,4,FALSE,2637,2633,
615b430f8cc652e46db2b02022994156,424,TRUE,1649,1225,Radiant
49675b600fb448bc2668702a0a7cfd81,1674,FALSE,3172,1498,Dire
d13f5ab7225f25216632219e5954ef4e,2046,FALSE,2091,45,
89b138152ef9430d9edac5c1faa0c372,1306,TRUE,1896,590,
8c164dabc705c3bf2d91de6e3377980d,154,TRUE,1555,1401,
ce86af0e8c7b88468bfb26888bdf761b,362,TRUE,1185,823,
92c8e5e0fbc1f364e25c2efb02802268,125,TRUE,2357,2232,Radiant
f94b0dcfb5b41d2fa531256dc25db047,530,FALSE,2057,1527,Dire
7d2a94a6fa645d4b4772966b27eba306,1484,TRUE,2780,1296,Radiant
9f41227ce42f5b412f32dc9737b259fb,1587,FALSE,1718,131,Dire
ba48e9d0961c22c0a98f0bc668303a42,133,FALSE,3348,3215,Radiant
5c6a4653ae068e06b00910adc80fe9f9,821,TRUE,1484,663,Radiant
ec20dbffe5fe71bd78e51d78cba4d599,199,TRUE,1582,1383,
6eb76d7b7511eb4fdb75f95d5033c23c,154,TRUE,3530,3376,Radiant
7d0c0d0ba383193d61a37a161a0bee07,1701,FALSE,1839,138,
54edd738b4084b1c69477266a9d253e1,1276,FALSE,2562,1286,Dire
9e7669a7350c17bd79f1c8fe09bf465c,1727,FALSE,1860,133,
9f34c2ff5128be8977200331ca3fc55c,2901,TRUE,2964,63,
4cc5706ad59b3ab696f737db1111c772,1294,FALSE,3084,1790,Dire
a529db0649f34cb4394a9b7135fc92cb,1428,FALSE,2087,659,Radiant
4c2fb5355546485980e943e37279e0eb,1784,FALSE,2482,698,
14816ca0f995cdf219e2293695103f7e,1595,TRUE,1896,301,Radiant
8d1b5e828d5fccb346260fba8d7d974b,2380,FALSE,2609,229,
e8438ed449cd765f57ce9554e95e963c,1382,TRUE,2851,1469,Dire
47389bb13d16f1aa3c22bfe10a39a001,246,FALSE,3405,3159,Radiant
2b8237f3930796a119e6acb5f29d1993,365,TRUE,1196,831,
8b3772cfcd4c5ba6b9b0963c834d0586,2822,TRUE,3524,702,Radiant
047bdd9d8359f5127b34b3790811c9fb,211,TRUE,1796,1585,Radiant
067641cc7232e7d7a42ae10f9d48e7c9,92,TRUE,1957,1865,Radiant
bb1bbcd4eed794267eb44d9ae6fa90ec,2418,FALSE,2891,473,Dire
ae54f5d133ef5a7a435790d57660395e,1877,TRUE,2448,571,
40a14aa36d9f5b6f7a4133de8772d676,37,FALSE,1314,1277,Radiant
6ddb3c74ee25c84383267578e5f697bd,2122,FALSE,2557,435,
cb81bf6f31844970489632afc9dc45cb,515,FALSE,2298,1783,
29009a8602583cce03fce14b1c76a737,2363,TRUE,3450,1087,Dire
52a7aa78f1914f3fed0fa102de92d547,967,TRUE,1617,650,Radiant
fc79e4da5a18a04204696cd7b7528b07,2681,TRUE,2899,218,Dire
e72d620bf92383e26e222b613c838cf8,921,FALSE,1813,892,Dire
b189127bf97df7e6b3a341e8835bcdab,1822,FALSE,2690,868,Dire
37b82d627d1727407b5e97d3531a5f87,844,FALSE,1593,749,
e5546579a090206ef1b0a833c99a6ff3,2357,TRUE,2702,345,Radiant
3b060b9e4977fccf9b9239443adc4001,11,FALSE,2600,2589,
a8f594f6904efa7ca6fc01a0363c9373,974,FALSE,2208,1234,Dire
56098c5a2c6b1c2e90e6b2b75caf14af,1115,TRUE,1783,668,Radiant
04d0af8cca5255fe55caa7ceee4e5e86,1094,FALSE,2626,1532,Dire
4918d1a9803fadcf8c379bb355b11506,1350,FALSE,1613,263,
0658f38b90a7fc7a057b4acf824d7db4,448,TRUE,1889,1441,
7a540a7b12218e81b55ee33bb7c5bde2,72,TRUE,2091,2019,Radiant
5a29972c0ee306600dd340be4be3b7a9,615,FALSE,1733,1118,Dire
a441149fe165f0f957ea2bb967ea4b21,58,TRUE,2197,2139,Radiant
3953af7a62ecb1d13e79ad7c4140b211,215,FALSE,1960,1745,
c7e1222aceb67526e261e26aefcc8483,1506,FALSE,2054,548,
d4d1309e55b24ff60536f6a464f57222,1866,TRUE,1960,94,
51a2202e94ecf949620d5f17b1422b63,433,TRUE,2395,1962,
52a71be44f59f1837253f3e46daed2a1,1740,TRUE,2280,540,Radiant
abde54ca5828278396965f0a7da2db02,1317,TRUE,2884,1567,Radiant
d829c8ebd5170e312990411f8f8ab49d,1217,TRUE,2287,1070,Radiant
e376553040127967b4fa1a88b793c009,664,FALSE,1453,789,Dire
960678d381b5f7e5d0690a7a5c4f80c5,260,TRUE,2018,1758,
d0c3f54fc7bd83c769958d9fc045c52d,347,TRUE,1026,679,Radiant
c895be7b46a750628cc97d0db37bfd06,2059,TRUE,3188,1129,Radiant
fef79476baf021a4bea7b9d455c4d51e,617,TRUE,1881,1264,Radiant
b6e37d7b295a425e895e118f422deed0,1804,TRUE,2053,249,Radiant
6cb5b6298a3a6d226ad6e03930badff6,2143,TRUE,2681,538,Radiant
2dcc2dbb277f41362f6465b0aa3c27c3,1302,FALSE,2345,1043,Dire
0cb9cb5dfec7397e091d6916940017bd,514,TRUE,1886,1372,Radiant
4017f6c1e14785be6ff0f19119085a6f,1689,TRUE,2440,751,Radiant
1137917d7edec128bd158a2cdc2b1eb8,2524,FALSE,2709,185,Radiant
00ead41bfbcad54f7551410c37b77ea9,742,FALSE,1198,456,Dire
f61a50de84a5b13072a2dceed9d1cca3,1288,FALSE,1945,657,Dire
0e516cf0072d2fb5e95aeb1c84b88da6,1322,FALSE,1582,260,
a295242420e7abe990c3ddea0e9f2a2a,375,FALSE,3208,2833,Dire
01f3be72087e6c5f5fc36ba2cbc00540,1524,FALSE,2262,738,Radiant
9db4fc3806ed5421474415aa60d380e0,391,FALSE,3064,2673,Dire
c161897c74ff18a77b8b8d2e73e70a9f,1410,TRUE,1932,522,
af55b4fef1ecf07acd64fc372b79fd6a,897,FALSE,1686,789,Dire
986f3be61f7856a87cfdb4f4c6a41f8f,1507,FALSE,2702,1195,Radiant
586724307635a47b3ed4caf9234680cc,1770,TRUE,2281,511,
6197e51432c82a59b57b4038afcecc96,58,TRUE,1607,1549,
815805b2b3cc650b403d6acf452302e9,972,TRUE,1657,685,
069902d3441d6e3a8077361dfe395316,157,TRUE,1346,1189,Radiant
0e91128cd21496db2419189909ae59e8,2019,TRUE,2226,207,
32971d1a4b7b2dde7c9e9a75c6a1d6b9,1366,TRUE,2956,1590,Dire
ba5ea2b6f95e724d8f8c79b766ff6b6f,1466,TRUE,2282,816,
cd3534a1284da56decdc52694c12b738,1969,TRUE,2199,230,
eadea32f40cbbcbfb5bfaf30813876c8,2376,FALSE,3038,662,Dire
bfddea1c4182abb24208a0e3c7101c0b,1343,TRUE,1438,95,
a46d1fc2055bfcb80b2b80e338660ebc,12,TRUE,1379,1367,
233e0952d5d113eee9f19de8094d608b,67,TRUE,1644,1577,Radiant
97a487b81e68c40a3a8d255216c86deb,2704,FALSE,3048,344,Dire
7551d5706da7edb80b331022c1294798,1348,TRUE,1708,360,
2a75b14cd9e77b72ba4b156c5a2983f5,1005,TRUE,1441,436,
b737b3e5188362baef74ed88c9d1677f,924,FALSE,3593,2669,Radiant
f9a62ea6287f57275eccd23fb3bfda25,1303,TRUE,2478,1175,Radiant
f55a4aa5a148120e593b2546aac3ad2e,1622,FALSE,2255,633,Dire
9397e63e3fd11a7929c9ab367acf94a5,133,FALSE,2035,1902,Dire
55241a6bad7a71a637199a2d3029f3e6,508,TRUE,1910,1402,Radiant
e525b0a9627d0d0ca99d07ccc8c0e161,1832,FALSE,2164,332,
7bb49c75a051cd79adfda960a07877f2,666,TRUE,2239,1573,Radiant
9ab5b53edb6fce4caf4916d09d680cd3,2162,FALSE,2844,682,Dire
aead8f3d5e20ac65d5b225d205770acb,773,FALSE,1224,451,
e8a4e2ca4687d93afd2d8036036f86cf,483,FALSE,1823,1340,Dire
6299b3ef21f7a89111471c376e08ebfb,862,TRUE,3526,2664,Radiant
b619a8b137b09e01218064c213037c7c,1352,FALSE,2745,1393,Dire
2e89ddf1edd995468b4e357de3f0cada,806,TRUE,1685,879,
8cd497cfd279221a605b89a77b201c97,99,TRUE,2490,2391,Radiant
d85c2f4d494a0c8299138613436fd79a,1346,TRUE,1490,144,
83fd7065531aa8147d7f4c9f6b3823b2,2128,TRUE,2368,240,Radiant
d74f98cfc309e5a519a6f43f4300febc,401,FALSE,2818,2417,Dire
fe634ffb28de624ae3504880496af719,439,FALSE,2869,2430,Radiant
d0ec2729bf91b24a285a9d9b4cb5f860,257,TRUE,2401,2144,Dire
25c92d15d055a7b4c62be988ffdf3b8a,1454,TRUE,2252,798,
8a936e03d182ff509aa24e2c6a0a5f6e,2541,FALSE,3080,539,Dire
877deebe806ba3f6b53b80b07b57874f,2104,FALSE,2266,162,
5265f43bfc4bdcf96420aa8c300b4a0c,422,FALSE,2950,2528,Dire
af02c0b7a302eadc543325e2949c6b8e,323,FALSE,1794,1471,Dire
c89ed9a238acb045647de15c58f0ab8a,1795,TRUE,1858,63,
53032092edb973c470bb933e8d87e65e,1973,FALSE,2759,786,
ea897c7600409c816cad2172d886b009,2036,TRUE,3047,1011,Radiant
42526b4a839152adce09bf041b991843,1063,TRUE,2082,1019,Radiant
4422819bd9367bf9cedb28a73860adf3,945,FALSE,1993,1048,Dire
f17d1659c2b06d9f0f2da4c567f60440,2703,TRUE,2864,161,
1861269ccdc5dfe851e06c6ebbc2196f,91,FALSE,2158,2067,Dire
a2e3d4f2f013984758ceced7045838ea,906,TRUE,1082,176,
e2011f1f5bd011d4da29793122af1f1d,272,TRUE,2792,2520,Radiant
5863e7a977c4b87ce1c6e8e449a1cd26,1401,FALSE,2404,1003,Dire
762feced88b22ca8ef274761074e1a07,587,FALSE,2322,1735,Dire
24182144c34305e327b3395124de06fc,1066,FALSE,2088,1022,
9f992f180966dc2a8e0d6d1bda3dc664,1943,TRUE,2912,969,Radiant
e366e6505166825f8c91ed0c58c9d115,2266,FALSE,3001,735,Dire
bec09243883ae10eae55568006c1ef70,352,FALSE,2588,2236,Dire
bc49b8b7a50704d2a1dbc6bac282cad3,2007,TRUE,2517,510,
3614aba93004c888a86a4b2a909a2382,2054,TRUE,2560,506,
ad846394e5a1d43881b58d305f13b5e1,845,FALSE,1077,232,
acbcc70f17ceb413a4f74d88afe1b836,64,FALSE,2593,2529,Radiant
3947f5c7853c1714a8a90323ef1118d2,860,TRUE,1918,1058,Radiant
c392a8fcb1dce4ac956de28ebb4ad70e,1532,TRUE,2988,1456,Dire
f0c8da268985d249d897de202a223c98,1245,TRUE,2557,1312,Radiant
9d85ee5dd50fc54d25f4208a05e3f0cb,2215,FALSE,2562,347,
4d538c52d1ac7806df6d50fa19abf1ce,721,FALSE,1579,858,Dire
8f21d00e187d47a918a306a918906038,2792,TRUE,3155,363,Radiant
d2ca1d41acd73d5093f840a07769bf6d,1168,TRUE,1561,393,
7a4f2329728e5855d97af49a46a75d38,1554,TRUE,2114,560,Dire
c8ebfac65345af599c4f318473866fe0,228,TRUE,1635,1407,Radiant
01088536ed4412353a2fab9c808484d6,2135,FALSE,2845,710,
62cd6511a1179c58bca314bcfd9c3271,950,TRUE,1698,748,
53b9f8425491b84e944c16a25fd3f386,2331,FALSE,2708,377,Radiant
00ad40d4406ba6666c184c8b2c80ceb0,47,TRUE,2222,2175,Radiant
1e5dfa4f0485e260675cb1d6d1a6a1fb,1023,FALSE,1680,657,Dire
db7050396622d08c6e8a5d6aeedf5f44,1664,FALSE,2090,426,Dire
dd59d29fd2d539d96f8e7907db62e83d,182,FALSE,2548,2366,
f426490789593683dc86f7b2b4edd460,1352,FALSE,1947,595,Dire
b17ff8b8a1b60f72f181640233044c1d,736,FALSE,2820,2084,Dire
f2edb30830653a08e9ee741f41c98c1e,1985,TRUE,2330,345,Radiant
d24a6ad4c77b0e391c3469133aaa61ad,101,TRUE,1571,1470,
9616f79d8e9d8de40c6c8aa26ee97cf2,569,FALSE,2845,2276,Dire
63942ce14933b839a154f24583aef310,230,FALSE,2180,1950,Dire
eda7885aa0612137aa9ef79c2b171502,1469,FALSE,1877,408,
932509db7aedac244afa1ff39494be55,1186,TRUE,1815,629,
48baf96e5b3ffffc716d97768cf0d61a,618,TRUE,2991,2373,Radiant
ad34d72ee33daa11bb0f82e8b4381932,1309,FALSE,1496,187,Dire
2997ac4ba3f54e1b5c2d383c7f1fb3b1,2417,FALSE,2771,354,
b9de90776523810dc8dbbc6f3ed9a586,160,TRUE,978,818,Dire
e660aec5ad3b2dc244ea201a232a291d,1069,FALSE,1873,804,
0a5e52814ef8d1815a96f62e52ea6023,241,TRUE,1886,1645,
0ab362bb559f1e4c8bf47302ac1a7122,1151,TRUE,2274,1123,
0ac0c4697cc4b0f599de8b7576aa6bad,339,FALSE,1237,898,Dire
0e2e3bdaf446be048e1d8501fc58fcb1,1573,FALSE,2389,816,Dire
dc0caeee163e6308c317443e689afe4e,1071,FALSE,2265,1194,Dire
2e4750a3bdf94c3ba936177fb6d18916,1017,TRUE,1944,927,Radiant
8a224c996ff8b620df825321ddfce4f3,402,TRUE,1708,1306,Radiant
ee597a15114d6b454aaa8c127b326f4d,1709,FALSE,1888,179,
fbcdef1ce486ed47ac4244bf7ac7dc5c,780,TRUE,2150,1370,Radiant
6342eb890299b07a70b10da07e2bd4e1,379,FALSE,1401,1022,Dire
5e949a5b1ad6a91334d0e3ca604228f2,1359,TRUE,2669,1310,Radiant
2e81f5ba5ffe5422009b5de286066428,442,TRUE,1956,1514,Radiant
bf24f59ceea2c10ca9c1ce2ddc056489,970,TRUE,1613,643,
b6473244d238b065ba13e96002201796,1706,FALSE,1788,82,
315049ea5d2c89a4571e68a1f09e5b71,1281,FALSE,4251,2970,Dire
e495eafaa22a57406875c8a184249390,207,TRUE,2074,1867,Radiant
1c2b0a090abae5bf42b69aed2d7e0094,1335,FALSE,3176,1841,Dire
d92b30204f073dd50ead94fc89256827,1461,FALSE,1861,400,Dire
3f5d369f4f9a99056a009b9078f1caad,447,FALSE,2144,1697,Dire
0e937cf0d83d46c7ee06106063ac9f2a,1482,TRUE,1720,238,Radiant
ae40e0db2156b4ab6c229acd4f3e5384,944,TRUE,1887,943,
18e8d8a15496e3fa68e858034d2efa51,2374,TRUE,2807,433,Radiant
b7e69a59a639a365f76e78b2dbabac3c,2392,FALSE,2461,69,
b1668e98ec7f16534a3922cf165d771d,1735,TRUE,2531,796,Radiant
e27e2d7aae6e3148a816fdf9b0af28ff,1136,FALSE,2504,1368,
5a168431319d11b58885a1ed96189956,1972,TRUE,3592,1620,Radiant
d64e4f2fb0c79ecc54281f3f45686e0d,1564,FALSE,1755,191,
6357e3df3dc227fcc214799f7e6c3088,1509,FALSE,2542,1033,Dire
a695c00c9de6e369cd61815172b7bc6d,1277,FALSE,2035,758,Dire
1790006e36394d9f82c97092b497e792,1909,FALSE,2388,479,Dire
74f71cdc96438ddc744c503914b4a708,167,FALSE,3182,3015,Dire
a90b646193d8510ab0dc68e0c468730a,1241,TRUE,1608,367,
950b00cb22c69713624b19ecc222e79c,742,TRUE,1871,1129,
f1723c13232ef7c1aca0936804172423,1658,TRUE,2495,837,Radiant
31932980953e60324dcfd0aab4bc9e70,674,TRUE,1360,686,Radiant
22d39d2f1be4fee26cca7a18a13135ee,3005,TRUE,3049,44,
d899f61f7172155a1129c87d6551004f,576,TRUE,947,371,
862a5ffaba3890ac47dff67ae3b12931,1727,FALSE,2922,1195,Dire
69fba09164d82c323f554127dcddc36d,854,TRUE,1761,907,Radiant
b4f106f4ed76702dc3534efdbd8dda1c,1269,FALSE,2060,791,Dire
412fa456d241dc685f004db039a4507b,1023,TRUE,1627,604,Radiant
07056264b8857e420dcd310ba8139f6f,3499,TRUE,3580,81,
c9e8bbd77282c9722d7a21f07862dd88,570,TRUE,1016,446,
f19a34632a1b9d92876da05af56782a1,1655,FALSE,1922,267,
cec55670cc5f4376375f74625bcf85ed,149,FALSE,1857,1708,
f114f0345abdd375518535f664938259,2476,FALSE,2662,186,
474e9c84afd9a65d3234561da2df1fe5,728,FALSE,3099,2371,Dire
0153fc2f934a86d8a60e07a9f648be83,585,TRUE,1590,1005,
6c41507bfc245717dbea1cf828ae515f,1557,FALSE,2059,502,Dire
fc79c8e863301561e22960f84262e3c5,766,TRUE,3111,2345,Radiant
e0deaba4884b7e217bdcadcf14f94429,53,FALSE,2400,2347,Radiant
d38a600d65348886a872964b9a6e996c,526,TRUE,2501,1975,Radiant
f44acc9428334ba13b7068550b72e59e,1895,TRUE,1996,101,
337fdd64d924b8bd563c3376735f1fe6,743,TRUE,2503,1760,Radiant
dba9e611d79c15a61b9849a8f6e28d6c,1643,FALSE,1873,230,
672772ca432d967eab24d9d70a55cd5c,524,TRUE,2321,1797,Radiant
ee493b5f0dd2807d77abc82d532e5a9e,1451,FALSE,3244,1793,Radiant
a625e01aee447dd65ed9e849cd231d93,39,FALSE,1385,1346,Dire
d1011cf23bbd8ddfc752c9a4ebecb1e7,1666,TRUE,2874,1208,Radiant
1c508710ac9528363be4b90aec2e531f,291,TRUE,1977,1686,Radiant
fca7dbcca0b96936d4ac2df3ed0801c5,75,TRUE,1375,1300,Radiant
748aeacc0e1fa74802cc720ea3a46095,241,FALSE,2939,2698,Dire
7213f4f39c23d0239910ba7d82ccb14f,79,TRUE,1764,1685,Radiant
d82b4552c47b3ea48566f8dbdf98ef5f,1242,TRUE,2544,1302,Radiant
54085a57552e0fb6cc421a146bf1c9f4,1309,TRUE,2116,807,Radiant
d105bcc0049eaa21f8944fdfe50196be,467,FALSE,1826,1359,Dire
1be3963d1d266d93062d96722d059eda,1260,FALSE,2004,744,Dire
b955042ca82bce70cc28f43625aca6c1,524,TRUE,2326,1802,Dire
e1ce2829991359b0d43661564039f72f,2546,FALSE,2629,83,
8136a93be4b97f8f6f795fd8604e84b5,1221,FALSE,2245,1024,Radiant
bf03cb7e2bd7d0031077a84b24407b4d,1199,FALSE,2555,1356,Radiant
5e58eaef3d9e79ac4dbd6c38ced6b587,1653,FALSE,2850,1197,
3e16392eee717f08a20a27d785e3e2c3,1050,FALSE,1913,863,
85ba8c6c31f8e00b143d7f133af6b3d6,103,TRUE,3518,3415,Dire
17a590d4096eb4129ba6c67f75112cf7,2281,FALSE,2509,228,
2cc69538716bee42025d3fd3483fbf00,212,FALSE,1562,1350,
1498bdf6f8500fd64eef0bab4a312cec,1506,FALSE,2956,1450,Dire
65d721b26e5b08f3c52aa85e8cfc01b8,1055,TRUE,2545,1490,Dire
a94a6e00596a34de95b58f5c5473ea87,1212,TRUE,2640,1428,Dire
a8023b8afaf9e90ea4044d80c1ae746f,940,TRUE,1751,811,Dire
4e40cbdcec43241e5a88d8e1e884f7fe,848,FALSE,1905,1057,Dire
35ee7d92ec49502ad320bc9477db813e,1691,FALSE,3375,1684,Dire
7d646331e6693910a156228648e3576d,3175,TRUE,4348,1173,Dire
d32ee2c5116e301bf67edaf8f6995b66,1200,TRUE,2368,1168,Radiant
dd1017d90bd6a0625e1de9965ed7091e,1380,TRUE,2714,1334,Radiant
3beb3e7c1fae7c93dc7981f9d5795945,228,FALSE,2084,1856,Dire
258c71bb797adde2979a662304c7bc86,1105,FALSE,1529,424,Dire
6b70380d0c296dace131aebb880513eb,547,TRUE,2973,2426,Radiant
dc1f6c021d8fe70c3c773f54a274ec14,1060,TRUE,4209,3149,Dire
e521ecfddf0ce783f264fd035e42b9b3,1002,FALSE,2028,1026,Dire
ec2f153c50917be16a80d4691ff0e365,904,FALSE,1903,999,Dire
f4c3153c41e5124046a09a677d6f67c2,1177,FALSE,1512,335,Dire
5c5e3a4b70fb7ec4be822ccee6287685,1667,FALSE,1864,197,
0752da30387dd4c90a003bf2d29cd2c6,25,FALSE,3109,3084,Dire
aa84db73e54dd455cc934bf615dd7754,2582,FALSE,3438,856,Radiant
958193058666d9a20081dc1a6b84d384,1165,FALSE,2546,1381,Dire
151c77aef4238f7377bcf931af048c29,834,FALSE,1789,955,Dire
1bf9c809854451e2254500d7395dd409,218,TRUE,2261,2043,
60fc6f0f1b1ec0deb130d56f7b70cb47,1376,TRUE,1456,80,
7f5772d8685540b9a24fe4816df2c402,1279,FALSE,4163,2884,Dire
948da2fed1db9d8e9ccbde187d463af5,2238,TRUE,2428,190,
a61442ff3011570004d3e5c22e65b0e1,553,FALSE,2027,1474,
7070965333658bc482df47b869ddc7fa,424,FALSE,2162,1738,Dire
852f4089e9987f9c6fca9872ae469322,742,FALSE,2435,1693,Radiant
1e21c4eed99dec71fd1694f04a6a7c79,1408,FALSE,2192,784,Dire
263970b386ed96ae83ba7c6cfacdb52b,1107,TRUE,1920,813,Radiant
e1ab79dd95af1780c7eddcdfc290914a,840,FALSE,3980,3140,Radiant
e163f7af445a1432cf75a4992666c54e,1194,FALSE,1523,329,
d5ca6cbbab87bc92c829d5493f248986,565,FALSE,2693,2128,Radiant
012d4a31b9a0accc2a6c87a91c680410,1703,FALSE,2548,845,Dire
398c5b7da108053a7e1def6603a8ae00,1505,TRUE,2864,1359,Radiant
db7ad95effbf52a6cd81fc78964ab150,2557,TRUE,2816,259,Radiant
809abbec2796d1d40f51d81c3897c725,209,FALSE,1527,1318,Dire
32f89a5473f68ece6039bae2a4de96b2,623,TRUE,2043,1420,Radiant
4d15a0fabc8f2351d7cc1cf98e76146b,414,TRUE,1188,774,Radiant
59ea89e442e91ad3a89b6f38b8f4213a,60,TRUE,1860,1800,Radiant
4070daad9bf07d522997ba23cfd3fd92,13,TRUE,2264,2251,Radiant
ec8eda5767e405c917101c4cd214509c,713,TRUE,1740,1027,Radiant
f018cb53453531b54dc59b38637bb3fc,1607,FALSE,2393,786,Dire
6236f3acc3bad396061aeb464ccc370a,2009,TRUE,2617,608,
9a8f57b689c74c696445e2b12426c83d,1629,TRUE,2301,672,Radiant
fba12ed263c222544ad712231f407427,856,FALSE,3126,2270,Dire
73820f8cfd42c2f2fffe5d2d1f8b373d,1454,FALSE,1506,52,
a8f56a6b2192fead229b6397b9ebbb61,1509,FALSE,2244,735,Dire
e8b9af7b4d186606b29c4f28ed06ffca,786,TRUE,2615,1829,Radiant
545e53a3fbf5b2cc3deabd2e2aae5012,615,FALSE,2373,1758,Dire
2b6533a1f4b04322f5391e6b3ef35b71,429,FALSE,2041,1612,Dire
cd02a95cc983352030c3f72c6cb8428d,2507,FALSE,2791,284,Radiant
7d12e6aa3ecc1995c9e0a14b31c16560,1276,TRUE,1315,39,
edd90371a5e8d615af0e7d6c7c1da741,558,FALSE,2828,2270,Dire
cbb729ef793a7bf99fe37313279f9bd7,523,FALSE,1484,961,Dire
28819005fb235587cc60e1c3c2fbab6e,2217,FALSE,2505,288,Dire
d7a41ff4e7a726177feb76d89eaf3906,633,TRUE,3506,2873,Dire
5cd8ee37522faa05cd0f8aef1f440da7,104,FALSE,1337,1233,
500ecf44260844993c5fb3d252717dfa,859,TRUE,1836,977,
1aca653969a062648e911bc74a6c4eeb,282,TRUE,1351,1069,
411e2488b696b3d3eed0b5ea0bfa2889,853,TRUE,2041,1188,Radiant
14334167c5365ca98cf68290f640b54b,1266,TRUE,1462,196,
ce336d51ae5dcda021da2c6b736dde62,1306,FALSE,2188,882,Dire
88eaf2ae83951787461ea65f8dafbed9,387,TRUE,1543,1156,
bdd9ea0a8189ab0ff4d45678134d4802,1624,FALSE,2877,1253,Dire
7823eea85307968500dcd694f3284a12,1520,FALSE,2833,1313,Radiant
6d060f84f2bed3a2302b15021a9ccdac,908,FALSE,2535,1627,Dire
d98bc580067d9a9e4d92c0e118018bd4,1964,FALSE,2597,633,Dire
3a03a7b3fef3935a079a3e6f1a28dc70,731,FALSE,2664,1933,Radiant
8d6d281bab9a82319dcd9486a46cfff8,899,TRUE,1727,828,
3970a57a43ae661d9a9a63dfea5c3539,396,TRUE,1076,680,
ae7db916a7eeee9d3c4bd47d25e78a37,71,FALSE,3128,3057,Dire
ddde9a0ba882ec30b373adf3db850813,1998,TRUE,4218,2220,Radiant
25e11e188fc58e14e5c656de55b2eb73,710,FALSE,1225,515,Dire
b94a6c3975f93834b76268d49353e085,223,TRUE,2309,2086,Radiant
472228ff13edb7f8140a8c835c7761d4,1238,FALSE,2824,1586,Dire
122d531d7c8b457aa3fc447d2046b785,2795,FALSE,3095,300,
d177b81849d3f807f2ae436e95013dc5,1882,TRUE,2511,629,Radiant
ce97abdd051e048717d386280eb36941,1807,FALSE,1863,56,
3fe79d92ec96d08864de52f52e1499d1,920,TRUE,1402,482,
bcdc9d66ea4a6e5cf28a33f1353999b4,450,TRUE,2098,1648,Radiant
9a023b9bca687fc4c32d5178c7856430,355,TRUE,2463,2108,Radiant
59aa62001df62cabb7862603c4534f50,759,TRUE,2803,2044,Radiant
d2e780cb408bb587876ce9402797d805,40,TRUE,1960,1920,
8a9e636c75bc11c04ca46d6004086c68,1315,TRUE,2048,733,Radiant
27ffc6300757b67e6057b28f874942f5,1230,FALSE,2284,1054,Dire
598449df25b1eb312a5ee75aab7f1f86,1845,FALSE,2545,700,Dire
acabb612205076c9bdc100be69df6afe,1706,FALSE,2659,953,
0372037e6b16c7f68afa73b0f6681e84,1078,FALSE,1733,655,
6b4c52bc750b2688b16250f63801fc62,467,FALSE,2668,2201,Dire
8236fd9d2a7563fbe8341b980f310699,693,FALSE,2286,1593,
d5938eee8329f9657b8e0ddfd2351743,2359,TRUE,2764,405,
b0c4b70952582d27477419553fcf5c2c,1110,TRUE,3560,2450,Dire
9cc9e2cd3a4e8108400654bfc25024a5,3543,FALSE,3595,52,
e789613dd6cc80843678162eb21e68be,1836,TRUE,2004,168,
68a021b4a4d154e155132d93e82a1bfd,517,TRUE,2184,1667,Radiant
078bd5038d67e4c25883f9a8e8bfd7c1,1524,TRUE,1559,35,
4d3eb16831201822d8aed495953894bf,656,FALSE,1979,1323,Radiant
0f68da0c50f84c7ce429f7df408d85fd,1343,TRUE,1772,429,
ae545b01f614fd1556472971da9c26dd,892,FALSE,3872,2980,Radiant
b948bb2106d79e04ef89527b3a06a82e,129,FALSE,2162,2033,Dire
4fa849cb45be763cf6c77c24be28533c,453,TRUE,1611,1158,Dire
b4dfc0e7f5a67ef006f267fa73b8a1ed,263,TRUE,2187,1924,Radiant
a57e8db499d8b161043a3237088bd944,877,FALSE,2091,1214,
733e3b0132587c93e5f21a0be5c17c94,2257,FALSE,2508,251,
fd3382168e711f3913a7f7f4573ee047,2249,FALSE,2412,163,
048c80e7fdd7696cf0a8632d2c0f81b3,638,FALSE,2445,1807,Dire
de5d486af11490f7ea415a3bd385c038,215,TRUE,1535,1320,Radiant
c76ab568b39fd6773d9d78ef76d770dc,1284,FALSE,2347,1063,Radiant
3ab9a5749503cecc3400ffca20fe2080,1885,FALSE,2162,277,Dire
5182249ac34ca6d40e426942c277434e,906,FALSE,1845,939,
059dd94b07ee4ab54bea8417dd597621,33,TRUE,1854,1821,
4cacdc3453c48ade7d94b665abb3a490,1419,FALSE,2163,744,
9ac6710db9a495008755b30291c55ab5,830,TRUE,1914,1084,Radiant
ddd41a837c9822ca6e9f275db86a1fc1,1920,TRUE,2788,868,
6be4a3bec9f739bdbebd6df1e8bcb308,572,FALSE,1923,1351,Dire
ff1fc94075a8e5457588a44f7f30b7a8,138,FALSE,1610,1472,
dd43098b6fcf5a27c5e5e9bcda917f5f,1958,FALSE,4130,2172,Radiant
328dd45b6e587d7e1dcc24d30762f9ad,1652,FALSE,2080,428,Dire
0b4cf483f857055d294237bfee2bd77e,2293,FALSE,2443,150,
5e325222916bf0be07f96542bf2510de,310,FALSE,962,652,
dc6b13a9fcc0b7932a571b1646a9e3fe,853,TRUE,1602,749,Radiant
210e32871c94c3dae8b9f07953733d1e,668,TRUE,2513,1845,Radiant
3334836d7d3299bd72be4000703cbd21,2055,TRUE,3997,1942,Dire
ecacaaad2bcddfa5fe2ec8b981a240ce,2414,TRUE,2755,341,Radiant
31ef6b96fc42d837ed6cd7ef83d27772,1788,FALSE,2032,244,
e6d0d6f03ecddee7d58ed91e9db64ed1,133,FALSE,1588,1455,
28d96844c42d66a60af61a35604b9a9e,1268,FALSE,1530,262,
76b131ed21f84242752767de4448cd63,1969,FALSE,2934,965,Radiant
e388981ff41ddbde2bdd4d1db405c70e,1931,FALSE,2547,616,Dire
9592304f920583b7d13f9e7316daac89,2388,FALSE,2681,293,
9555a9971ed7402e6596eeb15f9d429b,2086,TRUE,2452,366,Radiant
373e1fd198ca89f583fab2117b1c1ffc,1926,FALSE,2904,978,Dire
c4d990f6268e8354e254a3f341a9de30,227,FALSE,2241,2014,Dire
5499d9d2566ed0035ad5531487658a67,1939,TRUE,2871,932,Radiant
052cd891f6620a57796c1b8dac7afe9f,844,TRUE,2360,1516,Dire
cbc261a3b6c69ca5d962f65bbd63496d,554,TRUE,2047,1493,
706b284f90ebeac3192b42dcee3b2076,1768,FALSE,1878,110,
77b2299c94a10e114239db5e86800a5f,2268,FALSE,3021,753,Dire
e6fd7a1ffd07c6e0f51ea024883fbb64,1486,TRUE,2531,1045,Radiant
9ba2319cf78199e70afa489798004310,1212,FALSE,2789,1577,Dire
3a2fa773369cdae969d86540d20ec5b2,831,FALSE,2044,1213,Dire
f90372d474837e65a2eae9a54d50a634,2114,FALSE,2379,265,
c2309d5bef53fcb96be9c59d908bcbee,81,TRUE,3193,3112,Dire
b1633bc503c93effbd625b22865f0355,14,FALSE,1184,1170,
ec5f8daf64020fd2219d5a4eecc608e3,972,FALSE,1859,887,
d45c1d30f1512c26d2e30802a3cdb71a,573,TRUE,1939,1366,
f992b644acc0d1bdb65d911ef1601fc2,1244,FALSE,2658,1414,Radiant
e0ad2d35a7013f94475a1012fc887b8b,974,FALSE,2159,1185,Dire
025605d2503647e0c64cea7b5cb9eab1,1906,TRUE,2689,783,Dire
3d780136def98f72ea1a1820fbae1a10,624,FALSE,3260,2636,Dire
c06c44e4935b11e862314182ac1da044,1921,TRUE,2846,925,Dire
78928298cf317a96c140fb401754938e,143,FALSE,1645,1502,
482ea40666685e392c5b0a566fc0ed00,378,FALSE,2679,2301,Radiant
427920ea946b4b7fbeb3bbe766eda1cb,823,TRUE,2134,1311,Radiant
31850be47444317e48e0da4dfa377c33,1719,FALSE,2754,1035,Dire
e2c1f34f8c81ce3a32ef87debffe9a70,1320,FALSE,2779,1459,Dire
db3974e88170a084300088ab76a8c2e9,828,TRUE,1629,801,
0ad339634858575466e3976af30ee441,1402,FALSE,1915,513,
07f3ada0b9f4bf7c1635b8ca7257e55f,1022,TRUE,1723,701,
d49a798f75629e5ad31150a98cd459cf,1045,FALSE,1269,224,
49818d9be79b5dca2a9f86e96132eba1,626,TRUE,1488,862,
1043fc411f09026685234ba742d647c7,1573,FALSE,2225,652,Dire
e933d13f7fa615ba93d484b06e4769b9,1200,FALSE,3233,2033,Radiant
f8bc1108d4968b481ad10be57f9a7ad1,1512,FALSE,1824,312,
5aac3e88b5666fa47d56a1e7a6637523,242,TRUE,1109,867,
c9cb0e198b112c4f5563260cab5f8106,1040,TRUE,1659,619,
96913abc415e736a1fdd0267ed1068db,610,FALSE,2620,2010,Dire
2d79d40122f320a967bae62320531597,870,FALSE,1488,618,Dire
84301a559d9ddadfafcaa2353769595d,64,TRUE,1957,1893,Radiant
8fe33a7c087083fb261d20460d77ddd7,1980,FALSE,2624,644,Dire
057d8e3fe1f861f32319bc79126653a8,272,FALSE,2882,2610,Dire
52bbc23503917718816dbcb881378b4f,761,TRUE,1799,1038,
79681167e50ea0689cccda30a7c987fb,621,TRUE,1555,934,
9a35453994770a314f1eed16592f33b2,508,FALSE,2304,1796,Dire
bbdc84f98756a390e6cff0229324fc01,620,TRUE,2299,1679,Dire
e1cc0d3e1b97a7d3058d4817a9a14bca,1041,FALSE,2427,1386,Dire
1835b9e4d5e2dfbd0ab6bbcb326a529c,742,TRUE,1997,1255,Radiant
3ce42810ba35932902d98082d2b0a33c,1529,TRUE,2157,628,Radiant
caa5917451ea6eaac704e3b0336e71e7,298,FALSE,2448,2150,Dire
9a33ba88ba289b74145e0f54cd61511f,1517,TRUE,1645,128,
88380b169570f2ca664b54f6b1a226fb,1665,TRUE,1871,206,
722eef1e977d8f134e9f714bee1b09b5,240,TRUE,1507,1267,Radiant
0e6a53cf0836c13a424089f82d95563a,1420,TRUE,2207,787,Radiant
da140ada5ac741a44f6f37a2657addae,1724,TRUE,2000,276,
fce369fb2fc522290aa8b51644c567e5,1546,TRUE,2393,847,Dire
ab983e8b8c63edbc6f94f840f638d5e4,1975,FALSE,2475,500,
c119601c3c4e13d5c767d9610937c25e,406,TRUE,1561,1155,
79ae0b729d7e31af75b4d441cac3ea9f,2333,TRUE,2412,79,Radiant
6e262422677e9e303fb35e4d17abca74,1550,FALSE,1878,328,
23d6abff9c6336cb0a1d13874ff3ce20,1362,FALSE,2020,658,
d78152c7d5e2af924ca953d1b8e879fb,2051,FALSE,2655,604,
3637358c88e16f4b509d008f557c724e,443,FALSE,1322,879,
3fe54431bc9c0b872a97d5b93b2ee96a,149,FALSE,2069,1920,
49bce7ffdb6d228d3711293bf5558230,395,FALSE,1135,740,
b10b9b30a6f59198b27acc7349aada13,1028,FALSE,3546,2518,Radiant
79d7fcd6dc7dc0f6180f7b8563d14828,2116,FALSE,2357,241,
ab4c8d755ad474aa757246dac434735f,421,TRUE,1734,1313,Radiant
7605d3864cdb610ca2e247d314155b47,777,FALSE,2247,1470,Dire
db32e25f065504e474ab44fb0411ea68,576,TRUE,1667,1091,
0b672a2575f1add2965379ae0df61e08,525,FALSE,2751,2226,Dire
a83990eee829707897631a8a53df24dd,730,TRUE,1290,560,
bbc30fb46bc4cc42a7c9235949b32483,1120,TRUE,1199,79,
8b4ddff03da75be99ffb72ad090e9beb,142,FALSE,907,765,
1dfdd0f14d7f0c42a3324efa585b034a,658,FALSE,1403,745,Dire
eb6413c4801045addafe61f0538a7ce8,473,TRUE,2473,2000,Dire
e6432ff0d234ecdbe12dc34670604c3a,469,FALSE,1845,1376,Dire
bcb6f3dc651450d1e893aed9166c0a45,1649,TRUE,2372,723,
18a00ab26dd174841dad57c850dfb505,2144,FALSE,2199,55,
ff8f5a677edd6c650dda3ae0b207ea7e,1058,TRUE,1608,550,
a70105b5d0097a4e0bac45cff2520f12,2274,FALSE,2618,344,Dire
aec5bf32af8ae222a5eb92591b23343b,1240,FALSE,2830,1590,Radiant
802b981e8b74d9b4b71510effe1d479e,1592,TRUE,2294,702,Radiant
3943def594791cb8833084df3ecfc29c,1216,TRUE,1533,317,
523d073fd19ad446647d76cb0ef04436,541,TRUE,1778,1237,Radiant
0665d625b040a25d00636048d1922045,1522,TRUE,1844,322,
07a36a056bb2c6f0d61672fa9dfa0ad2,105,TRUE,2436,2331,Dire
9c503f471b914320f00f5c854b3c6e5c,1521,TRUE,2132,611,Radiant
76f24da784ce6ea3bf645248304d00d4,584,TRUE,2530,1946,Radiant
120425745f31547434f4b34f37223eaa,1718,TRUE,2068,350,
c2ca99ab63990899b81de15ccd8144a2,1531,TRUE,2290,759,Radiant
4493c8b36eb30d6e53a4d3f6cb44865e,1072,TRUE,1993,921,Dire
83701f473055e5c9288fbe09fa47586d,1960,TRUE,2838,878,Dire
cdf3978f8ae92dff27bd85a6b03ba2a0,2440,TRUE,2833,393,
797fb49147b210302168f90f83dfbcbe,1378,TRUE,2578,1200,Dire
8868f43d39c3407d8b5f8ac5b6c28c62,448,TRUE,1934,1486,Dire
a808fac0379d28a1646ffe294a7103e8,15,FALSE,2179,2164,Dire
d4063143b2a626cf45d472edf096a8c3,1092,TRUE,2030,938,Radiant
fcfdb3c8712ee4d40c3de0b7994766fa,1699,TRUE,2685,986,
78c5789ed53fc9c80575edc9be2fc751,227,FALSE,2024,1797,Dire
218b3cee4af30f5a9844cf42056a15f7,1586,FALSE,2817,1231,Dire
26856fd980dc0d6f1f91ba50afdefdec,808,TRUE,2380,1572,Radiant
755e6373521acc0ea6d6ff503ddd9019,1628,TRUE,2809,1181,Radiant
f4ff52656b955873a6f84a0c1ca12c50,227,TRUE,1584,1357,Radiant
dd0305b460375e0971b2a54bfde86e1c,835,TRUE,2394,1559,
eb3dd9e9f47a108f2d739b7ee8fc7a25,695,TRUE,2427,1732,Dire
c7a45507ca92507b8973853b5968a826,467,TRUE,2607,2140,
f9ec8aa4be2bfb4c4847d7fd05f40b4a,1815,FALSE,3620,1805,Dire
7ac90f7ab92a290a7ebc13747c009fba,1576,FALSE,1948,372,Dire
853a7b061b56c69a20ec5692cb12fb1a,2105,FALSE,2211,106,
8e78031763cf3526ea84d54e43084604,796,FALSE,1367,571,
9b840c0065634321985c4ecda264035b,600,FALSE,1363,763,Dire
1f66e860ddc274ddd2812aee780405a4,1636,TRUE,2127,491,
af29275164993a3d4fea5e7bd49500c5,885,FALSE,2569,1684,Radiant
2d832b30d068d0a4c5c687d915d35f3a,428,FALSE,3234,2806,Radiant
22a02d728db30fbf176cbea953d8eeb7,298,TRUE,2211,1913,Dire
baa062ff9249af87ba3c1a1b9eb1e754,1898,TRUE,2717,819,Dire
2be24aa082decb8cd1bdc2478196f335,1895,TRUE,2175,280,
a245187391f8afb192a5a9e83a5caa46,2771,TRUE,5209,2438,Dire
6252c6fbb655edbb577b581f9fc0702c,1272,TRUE,2432,1160,Radiant
21965b4b5cf2a25f9a78b1c673299676,1498,FALSE,2322,824,Dire
6e47e4dceb8a98252f3a59f112af0b76,653,TRUE,2766,2113,Radiant
74956f64a9fc10a1d19992337c9e5c23,1038,FALSE,1878,840,Dire
001a0010fbdff61042aa3dc81b949903,1099,FALSE,3348,2249,Radiant
6e9f58b6e1ea87c435aa75dbe55dc5f4,1989,TRUE,2143,154,Radiant
278ac1f0cd9bcc44bbb85796948aba8c,1805,FALSE,2422,617,Dire
58a64210c21cd819fbbeaffa5a7fcfbb,876,FALSE,2247,1371,Dire
eee7e55c4fe5989a8f13082e84753784,1046,TRUE,1624,578,
16ddcad7c3e3c8c2111ce19f112fb2d4,2531,FALSE,2849,318,Dire
85767986b40479565183285219af4b28,1271,TRUE,1865,594,Radiant
54aabd1a8ce3e11b92ae82af6b3a5c40,1361,TRUE,4222,2861,Radiant
0413621e54a884f1b6fb024d58994fc7,1109,FALSE,1947,838,Dire
a01ef1953abc60535d722bc5d63f3fa4,1983,TRUE,2040,57,
648d2f9cebbae6405e4edd871d4ee322,631,TRUE,2672,2041,Radiant
f1b6dadc32c799c42daca79f5a1f1219,1754,FALSE,2186,432,Dire
76726f251663d891dd01ff04af501027,61,FALSE,2006,1945,
ae59bc5ffb6b5c000fcf60bd09c9894b,230,FALSE,2257,2027,Dire
a2f59763b2661415da94c8974c9dae14,247,FALSE,3327,3080,Radiant
a84b121759b0df92df32824cb9f7ef83,30,TRUE,909,879,Radiant
8b6e430c796e072ac6c0759237aafe7a,1017,TRUE,1354,337,Radiant
332b21b6a9d82038b0d7c93d87a89ba8,165,TRUE,2288,2123,Dire
24966179b6aa92d94ee06363dc2d9476,862,FALSE,1507,645,Dire
95f4e216601435df64b3f01b1a5fa7f3,631,FALSE,3060,2429,Dire
0304f77e7d444a9122355553b701e723,813,FALSE,1336,523,Dire
4de0d381505d8f2219f1e06921eaf082,1935,FALSE,3878,1943,Dire
5e89e55852ae6aca1b6b548ca9ae3a9e,264,TRUE,2052,1788,Radiant
aa2d501fe751a6daf81b90fae9e67373,162,TRUE,2671,2509,Radiant
12aaa423b5366e98073de1af6e3dedba,776,TRUE,2515,1739,Radiant
860027b8b9b7d8e9da15f717a5523308,1568,TRUE,1748,180,
8dcde1329e78044b2c684950c1d7b030,925,TRUE,2424,1499,Dire
46a0febd8872f1f905ba7cca66dcc2c1,434,FALSE,1622,1188,
e409e6b970914c1235efbbeafdddf476,2445,TRUE,3523,1078,Radiant
49aab77b99daa9c78ba66b41569af698,807,TRUE,2001,1194,Radiant
c3c01d8a1130893daf1da6d2d471fc76,2656,TRUE,2922,266,
1b3946b8f6bd80914bba3df7a1df1f49,701,TRUE,2343,1642,Radiant
d9a8325a23a3b37e1d81860fff3de026,886,FALSE,3197,2311,Radiant
1bac2c21755e1d726efdee2922199141,1178,FALSE,1994,816,Dire
7f1b3758d9342d97e82a8dd23ea9054c,595,FALSE,2940,2345,Radiant
0a76b2d6254260573ca6b7ab38c3d8a2,294,FALSE,1590,1296,
7702dffe6ef1b69c91348b78bd4e1a70,1515,TRUE,1622,107,
bf4b21b9c8672152b32b9999cea613d4,390,FALSE,1669,1279,Dire
12d435106fe0b89308c3738d142b98e6,3405,FALSE,3452,47,
aca07dc73156bc009e413c311427a412,1593,TRUE,2792,1199,Radiant
fcac19e51852df5f6b23dd53b8cea7bf,1679,TRUE,2549,870,Radiant
b8cdec2ec41734dd0a30911c77362af8,600,TRUE,1493,893,Radiant
3a274cd6bf3efed9b5988f736e91e038,1483,FALSE,2636,1153,Dire
a95dd3bff523240eeb11f2e604984508,641,FALSE,1438,797,
12a74dcdab3051e58015687a9f02cd98,29,TRUE,1965,1936,
4043afc50a398895ac2d6167301ee4bf,184,FALSE,1315,1131,Dire
de08044eb3beee310da2df218f8d6a71,763,FALSE,3195,2432,Dire
7b64a6819f405510ff5fd066fdf0c474,1439,TRUE,1651,212,
657379fdf7efbbbee64133957804bfcf,745,TRUE,2675,1930,Radiant
5796dfc20055f34d0cf556c649acef40,448,FALSE,3137,2689,Radiant
6a5a73dde9d142a4d73bba8d5ba6bd8c,532,FALSE,2077,1545,Dire
62582fca030c9cd54482241315c01e57,1305,TRUE,1744,439,Radiant
b995359faa5165f07e681a5e2c3a9461,465,FALSE,3001,2536,Radiant
ec11c043e0debf2623d847e27da59a40,930,TRUE,2890,1960,Dire
786b48c4e619f9fdffe9b43eca86c46f,1478,FALSE,2353,875,Dire
c4415cdf0b23a73bd74177ddb3fb57d7,1107,TRUE,1948,841,Radiant
a3d0bbad11e91bbaac1bdce86e5ded9c,612,TRUE,2444,1832,Dire
52a6727d57045daf29597455a1ea191c,1156,FALSE,1588,432,
8b06848ad0ffff48aebe4f5a98a26387,1225,TRUE,2804,1579,Radiant
062f6508b203dce18cfcbd2cc22ec6ba,232,TRUE,1462,1230,Dire
a92b05607f5b90dd83ba69b8b72f85ef,1976,TRUE,2628,652,
3e45e53704344545a77437a35d84d701,1693,FALSE,2387,694,
9aec51a46836c4e46d4e2f5d16f0eecd,2033,FALSE,3401,1368,Dire
67861f84ef327db86c643472259cf458,1276,TRUE,2816,1540,Dire
024a32abb562d8e3f0e81fce0232e20d,1232,TRUE,2392,1160,Radiant
1d3725f940a6fa1b2918f2bc93a2e2aa,1219,FALSE,2460,1241,Dire
1e942e2929504d8e5a547b6376e0bde4,1487,FALSE,2432,945,Dire
6d526e6d975757d32501ef973ff6068f,1548,TRUE,2790,1242,Dire
60981e8764600f7c149a16fa2adb85e8,1835,TRUE,2065,230,
69be8cff94c1312ae6c8e14fa2c074ec,2011,FALSE,2185,174,
6d0b502342a86ead09c89573c71f2881,2986,TRUE,3034,48,
c2cc98c33e2397fe177584b185b0aab5,2561,FALSE,2949,388,
08952973e816a318ccd4a59d1bf6135e,1369,TRUE,3165,1796,
25e41afcee3554888fa1a6d62159fd09,2311,TRUE,3823,1512,Radiant
46372c542285ba542cbffaf0765089dc,2605,FALSE,2937,332,
7cb9ec80f923a97938671743a7c5014c,2414,FALSE,2687,273,Dire
0d8f04cbc65682d783fc7c37842ae565,925,FALSE,2902,1977,Radiant
084f3305e692cb91e37b28a4e1159b32,138,TRUE,1136,998,
fbc035eab703797a833a14064eed4242,1157,TRUE,1210,53,
9fd13eb3e89849aabce571265b5a78dc,367,TRUE,1351,984,Radiant
7b6d88163a33a9baaa859536fedae0bd,782,TRUE,2718,1936,Dire
9d0ad0ef51ba58501cf858a7d8e71625,1337,TRUE,1477,140,
60730f4e762683cdee31acd8af9a9aa4,466,FALSE,2297,1831,Dire
a63a360271f8118e33dafd9aac2ed73e,165,TRUE,2382,2217,Radiant
69b609e8414b80ecd8eb7da5a8d787b1,1470,FALSE,2589,1119,Radiant
f1424a841a5f844815e4774f50b1c4ae,1546,TRUE,1866,320,Radiant
c3d42128efdda2d893bfb4bba3c08302,1872,TRUE,1981,109,
2b0a1136d387713c06320f83a82b9510,897,FALSE,1773,876,
fb00b40b1f15350219d6bd9dbdea6e83,1956,FALSE,2118,162,
3a80a92eb0273fe341db0cc82a5614a9,2485,TRUE,3095,610,Dire
c6f018157a3e6dfcd1c58614a6cc9db0,255,TRUE,2185,1930,Radiant
81d3286f5281d2a0ecfe5a1ea71de7a5,2692,TRUE,4021,1329,Dire
41ef87217c0397b4ed6597ef75b98015,1277,FALSE,2022,745,Dire
f4318a2f39ce75c9def7d054f8a90a82,1643,TRUE,2056,413,
0c937eed9ff318539e75ca510b15c74c,1789,FALSE,2600,811,Dire
c468df4b9c57b66b275f3a58bade8558,769,TRUE,2131,1362,Radiant
98f96d7ff914e6c3205395032246a8a2,973,TRUE,4290,3317,Dire
7e908fd52c781470a97a54ee74dd95db,2724,TRUE,2771,47,
2bded50f8da3774affa349ebdb6acdb2,2253,TRUE,2638,385,
042fe1743df73a5f7b2e36982d07924e,909,TRUE,1333,424,
bd08a063c0cb0edcf9164de88cf9079f,1005,FALSE,3080,2075,Radiant
be7cc6697fbef18c625966ef2c789f31,889,TRUE,1559,670,Radiant
6f115bfe44be6a01f07a93db250fd09c,1470,TRUE,1587,117,
607ddbd01874571fe5bc8a841c857f90,793,TRUE,2138,1345,Radiant
35916a424c17bcd344984e583923d3dd,741,TRUE,3003,2262,Radiant
6874f494f74738478787603f936adcef,52,TRUE,2850,2798,Dire
bcf739db611c4305f885477d296dedb7,469,FALSE,1030,561,Dire
6e4575139de8d6de85345a67c2419144,93,FALSE,3295,3202,Radiant
976e98044276ef199b0a8ae04885c6f7,740,FALSE,3194,2454,Dire
8f05fc864b113a2fba0b264a0f54944a,1008,TRUE,2672,1664,Dire
48c28a9f24e4dde4a894b548026c80a4,982,TRUE,2122,1140,Radiant
5fbfcb0c1d9aa835e9b7fe0348aabf05,693,TRUE,1997,1304,Radiant
65be1015c1042f6469137e037923544e,1576,FALSE,2928,1352,Radiant
754608da7bebd9442a4dc73b79ced39a,1656,FALSE,1901,245,
788281d9ea30d91cce76af268215dea8,2332,FALSE,2514,182,
2921067b1b95196f6344155c642c6aa1,687,TRUE,1219,532,
3b95a8de5a14296a3e2468e547bd1499,688,TRUE,2618,1930,Radiant
ee05e68fe2c5f4fbc9aa28f9146a3c8b,1927,FALSE,1970,43,
adb647714b20c99df3b569216f4c7ebb,937,TRUE,2077,1140,
b2aec27c3a1792efb7f58956bd6383ad,1650,FALSE,2064,414,
882eae577b2da69c0a71f75495d69ed9,2114,FALSE,2155,41,
ec17de1c0ce54dea9c5f345d4a1895a5,2325,TRUE,2818,493,
e7c4742afb5d62582e02f1287d82ca4a,630,FALSE,1741,1111,
2050ad8a2a669bbfe95cfbfa6e63e953,2067,TRUE,2699,632,Radiant
bd9c8defa63b5150b7cf8afa900fbbb0,1157,TRUE,2244,1087,Radiant
d5b9eeb370ad99d1a1eb2c4aad68dec4,136,FALSE,3548,3412,Dire
be86f00b72259d03629047d416b7c387,59,FALSE,2722,2663,Dire
4f00c504b27848278719daf9b8adbfde,1893,TRUE,2021,128,Radiant
6b7160d1d3322808ac1c48292dc9c3fd,277,TRUE,2733,2456,Radiant
fbb80eb8871d7021c73bd57abeaf2a79,22,FALSE,1719,1697,Dire
f10cadd65071889d6e3f7b23c3a1e643,21,TRUE,1984,1963,
ddb6bc99ba0d039751730b1c58284541,1727,TRUE,2940,1213,Dire
70b794e4d360d65f2afa848d33c9dd90,2333,TRUE,2963,630,Radiant
7e2bb0cbe77483f1931964ed9e7ca879,267,FALSE,2235,1968,Dire
ff958b4ed1899f6e53384d0129f64626,1023,TRUE,1662,639,Radiant
6af4d7630041ab1010669849f169e6bd,776,FALSE,3439,2663,Dire
b74924dd488856a9afa5c3974f4760ca,1747,TRUE,1881,134,
ac74cbd2c2631243b858b88727d49e25,684,TRUE,1751,1067,Radiant
fea2106d0a1a4488b32633fa35734715,753,TRUE,3560,2807,Dire
b34d28775981af6eeb42688607ba562f,1452,FALSE,2739,1287,Radiant
6d657d4925a7d5061bc57a775a68aa8a,1089,FALSE,3274,2185,Dire
ae588fc356ce88942f8290920a64e5f6,380,TRUE,1611,1231,Radiant
6a948437547ed9469758254d444f7322,1288,FALSE,3000,1712,Radiant
98083f3ba62635c9e1b79a2899bcf4c1,2481,TRUE,2791,310,Radiant
bc081fcfe55e9de69c150106a275834a,689,FALSE,2327,1638,Dire
db9e45e279511a14c1b393798d20834e,2204,FALSE,2330,126,
d97103a3bb9d2b000500f64974195daf,618,TRUE,1588,970,
379e609c18eac81b43a64b8a69135774,1379,TRUE,2236,857,Radiant
c0c7a72566798ac5744c582179f1c9da,1037,TRUE,1343,306,
8ba786299efeba2b17c2a772aceaa3de,294,FALSE,2303,2009,
46481256f603488b280a154b588deed0,1640,TRUE,1959,319,Radiant
c1aabbdfa2be41f3c538bffa21cd460d,2048,TRUE,2547,499,
a117e44030699a9cc05a1dee13be6e75,131,FALSE,1613,1482,Dire
68a72cd009bdeb4b943743c82625ab1f,1901,TRUE,2193,292,
e970b3ce596590fcf7a070ff42e0e1bd,1335,FALSE,1893,558,
86af73098b2bb2b835d4fce7abcde9f9,271,FALSE,1610,1339,Dire
47d0bbf475ca4f09f8adaa4efab4ca3a,926,FALSE,1730,804,
6b018be268b4d66330de047987d2b82d,2670,TRUE,4952,2282,Dire
7f0de7cf30497cf3f9897a1b19765e1f,323,FALSE,3672,3349,Dire
938f77a6c87f7c91524837a70d37f383,549,FALSE,2507,1958,Dire
6bcb006a88aadf6428718561fd8ce8bf,625,TRUE,2756,2131,Radiant
a5c686d8cafcc92665d9c815dc1f9c72,2601,TRUE,2687,86,
b773a08dad5b63ed58069224b03b19e2,1303,FALSE,1866,563,
9350fd76078ec5b6406f729fc909af5b,288,FALSE,1471,1183,
63107d0efbae6d1702dc3fa359c8307a,1462,TRUE,1888,426,Radiant
bcebecd06d4bb81f61032357102d3b59,572,FALSE,2545,1973,Dire
da5c15ca600941e83e733027147852da,342,FALSE,3649,3307,Radiant
03138ab516da493792444640d2da421b,183,FALSE,2554,2371,Radiant
0d14a0e1272db1fb8d584a820bd4b3d0,1881,TRUE,1930,49,
9fc8d3cd44c69d332173f8a5fcb2b910,880,TRUE,2124,1244,Radiant
c78ae11ae9865abc823bf61f847cb3d8,1493,FALSE,1541,48,
2a338cb7db5186508cebbe8a69785f06,82,FALSE,2286,2204,Dire
7bb2a521580a6de807573b79a40b9e36,760,FALSE,2273,1513,Dire
8dab82ef65a1741d21dc51d67c0c46b0,354,FALSE,1831,1477,
1c3a663ced6a662fcac362bff4ebe4b1,810,FALSE,2178,1368,Dire
27e9dec90ec8e2c52bc79abd5c72f4dd,759,TRUE,1584,825,
1edc611322101eb29c6426f87912c9fe,1749,TRUE,1917,168,
ef3154b383b77aa7f96301b9ed6189f0,77,FALSE,2054,1977,
f22ae371888c561478831dd82eab3dcf,2377,FALSE,2712,335,Dire
2ef27dbfef8b0036cd6a6c12eee53f4c,252,FALSE,1727,1475,
94086087da461a4376d21ac63f5d57fa,1156,TRUE,1750,594,
8fec49f367685bfb108ad071d3a2864e,1616,FALSE,1921,305,Dire
83ad639c0f912602b091eee7cf69fbd0,6,FALSE,1171,1165,
58a7889950d4196bf292e19dd32cc65a,815,TRUE,1816,1001,Radiant
c1cf3ab6f78b28fbba46537b74216eb3,957,FALSE,2186,1229,Radiant
536ec481935cfd16e16446416a46f05c,724,FALSE,2255,1531,Dire
6e7003445ff6014b556677722c4c4b35,2018,FALSE,2620,602,Dire
5734c79a3296cfca3af6123a50038d7a,1035,FALSE,2726,1691,Dire
57c7d1de3bf7547c28d015a3af071b89,242,TRUE,2889,2647,Dire
217686724ace22780caf69919d6f84a8,1521,FALSE,3540,2019,Radiant
b57f74d059586f4e5fcabb5b32da837a,29,TRUE,1703,1674,
9e7edc37e1463a7be3153ef7fb5909cf,1002,TRUE,1707,705,
8700000cd10503a0d5d356d80eefff01,1562,TRUE,2198,636,Radiant
3ba6347594fbafd235adcf59424bfa44,126,TRUE,1803,1677,Radiant
b91d3362cda032112ac927267c7a065b,734,TRUE,1521,787,
e07a364ab52840c62ba2d7a81c1d54da,744,TRUE,3031,2287,Radiant
d328063ed73c12226bff6d210bbf34f6,1019,TRUE,2323,1304,Radiant
610eedb4cea07ac9de67000392caa37d,2190,FALSE,2278,88,
a9bfc5b29e81338dc7dbb37abb70f900,2287,FALSE,2973,686,Radiant
befc3def4025d0bf2609d52a0b3d3f28,1272,FALSE,2623,1351,Dire
820ade57c7eed0f8e17b086bdc49b023,1497,TRUE,2105,608,
642793cb9c9a7ff5895c51adcb53cf4a,1307,TRUE,2866,1559,Dire
0d94b5c9627dd9cafc6142bd260bc776,257,TRUE,2163,1906,Radiant
5e2fd764f1e9871a672842ffe3bdfaa8,1252,TRUE,3969,2717,Radiant
9337efc9d49b5aa8b64eb0a3873ca3ab,588,TRUE,2574,1986,
8181fb8cad62d897062ba67fbab47e63,743,FALSE,1254,511,Dire
0f3512631f919792901d42e6d4c945c3,1938,TRUE,2679,741,Radiant
fc401daf221cca9ec6cc8677f159b4b9,103,FALSE,1553,1450,
fd52b9357d51ff875d4942358716f177,2633,TRUE,2783,150,
ba0921b558cd2f7fb36080faae882c99,798,TRUE,1886,1088,
366019177d57fa628f43e48bd96294af,854,FALSE,1705,851,Dire
f109c9d05a56963803c8382599de6347,1828,FALSE,2939,1111,Dire
05e51d5f892bd6e6a3d55e65a7b723be,1118,FALSE,2552,1434,Dire
52f5a4ca0f63e95b74b61b43c400bc3d,1717,TRUE,2030,313,
cbbdca76598bd8b03f09edb872ecedcb,1198,TRUE,1305,107,
c468a856176a5898fea6316b3b5d70a4,195,FALSE,2452,2257,Dire
c90fa3ced8b3916b3146f144f625ef1a,454,TRUE,2333,1879,Radiant
688bc014ac9a6d9c7bad9ed85c1d374a,1589,TRUE,1874,285,
faedee122adb983440bb0023e42473e8,199,FALSE,1159,960,
6b59b3847d2425f561d5bb42decb1069,700,FALSE,1600,900,Dire
45e5cdecd209afc5bb87bc03eeb5c9f1,1171,FALSE,2242,1071,Dire
09798d7889d6433b093bd143284d324b,108,TRUE,2345,2237,Radiant
f2fb36f7beabd36396641e53e1555636,1300,FALSE,2311,1011,Dire
663d46cd739236495f61d53010c3993b,782,FALSE,1317,535,
8d7c08a87b803223420234676b146f0a,543,FALSE,967,424,
e4fe052f0544009d5260a56dcc3d130e,644,TRUE,3126,2482,Radiant
e5482015215991925f2999b304dea671,767,FALSE,912,145,
a25d50a6a8f01a75d0a276331688fdb1,632,FALSE,1497,865,
5f8c6697f83323ea4b2e468db09d2002,178,FALSE,3164,2986,Dire
20581800fae401e1e80104ba334df7fa,682,FALSE,3073,2391,Dire
6dd88eea2ba02fd83a73a1c66f3253b1,222,TRUE,1354,1132,
48968eac4c009c605f3fc4a8dabad0b3,633,FALSE,1052,419,Dire
b2756d7558936befee5d07fb065618a5,1133,FALSE,1571,438,Dire
ad9ea6d1f0dd073925a283f0583c9a56,269,FALSE,2952,2683,Radiant
9f2ae78b3f3eded58c75513148c122ea,406,FALSE,2273,1867,Dire
308562ba38132ed9d88facba872ca705,1107,FALSE,2661,1554,Radiant
977356a9ac619967c3d042ec0316731a,32,FALSE,2844,2812,Dire
9cc4a837d79751d5c9e7561d700bf24f,1358,TRUE,3065,1707,Radiant
d73dba7a120fd47b0b73118cb0d6c12c,73,TRUE,1883,1810,Radiant
3e5f077dcc43510692f6baa1d9cf045a,2436,TRUE,2732,296,Radiant
bb676d17ceb193a2ee2f02797817a07d,487,FALSE,1900,1413,
34fd8c194c959847bf21b7a52aa6ce42,1386,FALSE,2514,1128,
117b9d7d380e6b34ebc8e1818bcd42c4,853,TRUE,1843,990,Dire
589acea15a474debac3165efd5a7de9b,1363,TRUE,1555,192,
05091c0f9e3ce83b73fca1dca9613d3c,341,FALSE,1566,1225,
007210fd60988a98763036b4832835ac,751,TRUE,2182,1431,
053347794b37990d892bb45b8286db22,2358,FALSE,2760,402,Dire
e4cac216a4cce0fcbea4e103d3f2c1f9,99,TRUE,2168,2069,Radiant
dd3352b1babd1b5b3b13f198fb77f1aa,303,TRUE,1445,1142,Dire
522437ed04cadd16ad718d8d3a555a09,425,FALSE,2088,1663,
3b69e71c4e2c9936cc0362e64219df48,877,TRUE,2598,1721,Radiant
fa5861359af2a7412e9772b68836a011,1029,FALSE,2926,1897,Dire
0d50d6c00f369a07a40698f08d7f98fa,1163,FALSE,2174,1011,Radiant
038ea06d9d4a301a4f3ae7618c19ead8,768,FALSE,2317,1549,Radiant
fb048b96442c4081541a69527ccf3f2b,1880,TRUE,2502,622,Radiant
3d8fa510ad6e1f2a18f24cffab75c85f,896,TRUE,2214,1318,Radiant
9526de2d661b997f79c5e78029d68c9f,1228,FALSE,2084,856,
1f22c526e29e10b3c75da64f73fe6149,1832,FALSE,2373,541,
674398cafc6d6fa1785a4171f9b1a7ea,1838,TRUE,2256,418,
ecb75a3c75a089d7d94b6e59d7deb719,2171,FALSE,2325,154,
40b359bb8145d4b025aa75a6f4fc1580,1078,FALSE,2005,927,
64c546dacebac065992bc5354b5a5ad1,48,TRUE,2321,2273,Radiant
35124c65d644ac7ab49096976acfddd4,62,FALSE,2988,2926,Radiant
3d5eb3c9699704fb2234d834edfbb981,54,TRUE,2807,2753,Radiant
022a2790a77f45e34fefd0044fc9d3ed,851,FALSE,2802,1951,Dire
54cd5ebc4c67556a9647e2fe11d39437,248,FALSE,2976,2728,Dire
c59b8f99c162d317ba1758798fadb859,863,TRUE,2600,1737,Radiant
108f75bee594de5cb1756ae5d25bb7f6,2162,TRUE,2388,226,Radiant
781b4a83b1b12f06ff7f644b344aff31,1104,FALSE,2705,1601,
9a1b5ccfd777be65b184e7ddce2d3a13,2823,FALSE,3625,802,Dire
6e86eb1927e831c5a120f79a27383562,793,FALSE,3145,2352,Radiant
078befee046d1ac8855b2089fc2eb2f1,15,TRUE,1697,1682,Radiant
da4a7c9a029c6878d6883d6cfbf10ff8,338,FALSE,1094,756,
d7f86cac9519f52a52a92c5c3e23a526,720,FALSE,2073,1353,Dire
7e56a617ca1236442f46b4b05bc31550,98,FALSE,1910,1812,Dire
f3f8024d8cf7e34c9cd330735fde6dff,705,TRUE,2919,2214,Dire
45126d4aa02743d1d737be5cfb9a4fb4,1039,TRUE,1157,118,
472eaa7dd76f48284d379351fc851a71,2225,FALSE,3181,956,Dire
e6afe3b62dc8a6f9c5320f8c41e32bee,899,TRUE,1602,703,
7d77f63af6c8ad61397d8ff4e0a1de78,581,TRUE,1912,1331,Radiant
76d2652f88960e6681fb6b772ab4e3fc,56,FALSE,2492,2436,Dire
4b823f15c48e5e97028118a0bcc95c85,811,TRUE,2042,1231,
830db87ca51536cd1ffd1c2ee395f116,404,FALSE,1350,946,Dire
770a8051dae436f88a01bc441f11f4a0,232,TRUE,1875,1643,
557739894d8f90ae6baef71ce757dadf,833,FALSE,1640,807,Dire
2ed23a0c9eec7f5bf6f8b7dcbed9a75a,755,TRUE,1604,849,
1d43cd55172d4d7f56e660475c54c907,617,FALSE,2151,1534,Dire
80e0cd25baf5aa09e625112a79cfa47f,1044,TRUE,2278,1234,Radiant
9e508e642e03e7d91f71db0a2391bb4c,2298,TRUE,3079,781,Radiant
d6629122c258094e727b94e7b2823d7e,691,FALSE,1786,1095,Radiant
bb16fecfa6d2e6f7600ff8d76a44a902,768,TRUE,1494,726,
8e1de092001f212731af061c345b8dad,273,FALSE,2066,1793,Radiant
a68e96ead25f49ee095575d016f35d43,771,FALSE,1415,644,Dire
a329cd39a2ab060b7b219302d27f8af7,792,FALSE,1409,617,
2d6f45ebdcf8a17cf24c1b47556d03b5,455,TRUE,3780,3325,Dire
d38dd22e7df85d6e244c5665a14c822a,1004,FALSE,2523,1519,Dire
fa2a95e9c79ac53f4aeec83ec1e1c42c,1676,TRUE,2571,895,Dire
d5a3eeb6e52612344e4b1af2f0b02e61,8,FALSE,1733,1725,
a0c008031431271d566bcc93b22f1909,405,TRUE,1422,1017,
e9aeb4989b7a50e27e7bd39019234515,2573,TRUE,2634,61,
7533fc19c4566dedff41c4170770fb69,716,TRUE,1818,1102,Radiant
6d8ebb1c612180d50ebaeb08a76e7ba9,1280,FALSE,1877,597,Dire
c2f77ba9d7a527ed7792756c7c541dcb,2202,TRUE,2626,424,Radiant
082029cde6727dba77d902a664b463e0,1343,TRUE,3612,2269,Radiant
080021259daf1a5afeb589afd4d13df9,2062,FALSE,2378,316,
062b34249c8fc2eb40669f665b6eb683,519,FALSE,3376,2857,Radiant
b07b31091d713784260f1ebe3c9ebac2,1059,TRUE,1773,714,Radiant
18124863886205c39a36b127c41cd612,2732,FALSE,2995,263,
47d55e3b225bf5fe61ba56504bc5833f,1608,TRUE,1669,61,
a8e46983f58d167c366d938073c79580,935,FALSE,2070,1135,Radiant
954ab873eedda21e81ca446a04966371,1829,TRUE,3138,1309,Radiant
0aecbcadb542aed48a0e2b7df4c8d930,1692,TRUE,1925,233,
603e4fb19c710d86d915b263d53147b6,2369,TRUE,2760,391,
6088ed7718799fb5498c373a856c1da2,542,TRUE,2416,1874,Dire
3a71b0868597fe78d19bbc06fa2caa85,888,TRUE,1999,1111,Radiant
fdf78263938d1df7cfeb7992768b232f,2174,TRUE,3949,1775,Dire
89aff71ebe4026b1c49175d1a02f6c01,28,FALSE,1859,1831,Dire
93aeb48772a0c6bc60c36695c21e33e4,1503,TRUE,1809,306,
278355f895152d0423ce648aa48a43f0,808,TRUE,2220,1412,
d4e2ae08d02b9c0a7fb70c24a7d8626f,873,TRUE,1920,1047,Radiant
49304bcf3fece98ba8544a267320d7a7,1672,TRUE,2594,922,Radiant
4b232848c9e8265fc40f849037efdac3,1056,TRUE,1601,545,
fbc02d88fae8e61c23a8a1759321b2c7,915,FALSE,1825,910,Dire
164ea1e7d33ab7122d09331c2058c21f,899,FALSE,1752,853,
d2773e27b3cfe82ea08c50ce19df7286,361,FALSE,2454,2093,
11a72ecc26730c1ab222903939a4844c,174,FALSE,1279,1105,Dire
e726f9b7948836ae7f233e5d13e729a7,1476,FALSE,2142,666,Dire
3f175d405e98fe9b53d53ec621522ddd,1517,TRUE,1987,470,Radiant
fe98840698ad7a77c04c48aef8375d64,1000,FALSE,2496,1496,Dire
4d062afc271e948dd650efeebd278dac,1278,TRUE,1622,344,Radiant
17ee5d011a3cd142aac5997ef01b1408,470,TRUE,2510,2040,Radiant
3ebaea09611640f610d234fb52448268,189,TRUE,2571,2382,Radiant
8fb06e3a55446e03d43fd4944e04a624,2546,FALSE,2818,272,Dire
d4d5c9c1b1274f9e4bb09094a66962d9,1871,TRUE,2073,202,
36e2389facd7669061f3d99dfdbe67c8,182,FALSE,3095,2913,Dire
9caa3286d09c23181923229358ea0d51,152,TRUE,1664,1512,
4fd4b601fbbe1d6364bad59b47a37782,2296,TRUE,2848,552,
1df98ebc25ad097e56918691cbdce652,1414,TRUE,2411,997,Radiant
a15065cf166701fa287b9c5d10d07670,1707,FALSE,1754,47,
d719f58e4be8cacda10cf21581279ffd,2265,TRUE,2437,172,
ff9650957c2bc30942d946eae4b3698d,1968,FALSE,2598,630,Dire
8ea361bc42f5c28624da5d627ff7e5db,2004,TRUE,3146,1142,Radiant
a115574c01c2353501fab5c2e2045905,779,FALSE,1540,761,Radiant
6a8dda4a3d8d2538dbb6aa81f394a03a,2254,FALSE,2393,139,
1d3fceac2e38a8c88cd9f580b51620c2,408,TRUE,2654,2246,Radiant
f0868784d1a0966a780718c15d26db18,447,FALSE,1895,1448,Dire
5c0b7757dda5a21018997bde6d65c43e,2191,FALSE,2475,284,
a32ba7d099497c49653ea1939ce81261,309,TRUE,1928,1619,Radiant
fdbf9098d209263985e7ccbb9b40c761,390,TRUE,1830,1440,Radiant
c893eeaa85f3a6c6dfb16597e0086a29,1622,TRUE,2884,1262,Dire
e4b8ddf8f52d998c574ba0f91886ecc2,97,TRUE,1677,1580,Dire
de2e339479cf8e5697aff693d190e411,2620,FALSE,3360,740,Radiant
402fa5904f6dffc45ea9a7dfb2cc47e7,572,TRUE,1596,1024,Radiant
f45508d8654a7393db66303c67fdfd9f,1,TRUE,1756,1755,
43c2d9dc773998f16502b061390f10ec,2033,TRUE,2220,187,
b6cd8ea806c93b0c9be406a0da341827,998,TRUE,2636,1638,Radiant
58337746567d544d053cbfd38f9df29f,754,TRUE,2342,1588,Radiant
4d08270bb94fc0f507c0c394800ec4ee,1390,TRUE,2255,865,Radiant
cbb692bfb025aa14795965c14dc41672,320,TRUE,2519,2199,
a72a1deb792cb9eb36d106e180849570,46,TRUE,1097,1051,
2f29172471a90574d6444cb4f3d43285,1880,TRUE,2106,226,
5c36af67763441c2aef0a0869bfc2724,820,FALSE,2049,1229,Dire
d581e63074ec59449930bc036bf2cdaa,723,FALSE,2300,1577,Dire
768c79691eed66619f91ac9a2891826d,501,FALSE,1564,1063,Dire
d84ebb0d078b4e4c35fd765f76f98fbc,2135,TRUE,2575,440,Dire
adb56220ae8277e98a37dc9ae1ad1094,367,TRUE,1348,981,Radiant
8132a0eb1708c92926fcb509fd88a33f,58,TRUE,2490,2432,
179d83bc1c01725100957918d4ecf81c,34,FALSE,2640,2606,Radiant
0e2cd1416249418511c346b57d3723ed,150,FALSE,2455,2305,Radiant
55871e5da3d1592e22af639fd7a4de40,843,FALSE,1331,488,
8e805bc3d548f76f1acfb275f04d79dc,2706,FALSE,4029,1323,Dire
c4d255d8a69ae0c349f3179a72c98c4f,940,FALSE,1897,957,Dire
c4696e6113cde61d399ed572453343c5,1327,FALSE,2546,1219,Radiant
404f50512fb931fab702d869933801bf,1397,FALSE,2011,614,
a3237c05dfce1d8d07f3cc38c47d6330,424,TRUE,2574,2150,Radiant
6a91db8a46b5b1ae1aaafc8c35113ead,1445,FALSE,2514,1069,Dire
bae813d3dd6954fd6f245ecfc360d20a,686,FALSE,1545,859,
e756fd167758650b340f40edb4fae9df,2315,TRUE,3092,777,Dire
e8f20053274a7d140df64974e1bbeb28,820,TRUE,1982,1162,Radiant
906a5266fd265b96422d6f1702281f04,93,TRUE,1542,1449,Radiant
e7b7b6423150efecaef16a283c56db68,1595,FALSE,2649,1054,Dire
d4ea5387e09d303ac7f111096e632474,692,TRUE,2118,1426,Dire
0a8eb9a3518ecc505bab491eb17c9247,1224,TRUE,2004,780,Radiant
17c20d8a2f1d4c128fded410f6d4c1d9,1691,TRUE,2137,446,Radiant
a7ff0f151c4eee43b028c7ac5870a1c8,551,TRUE,1527,976,
9f0868f706d3da9396a49d44fae781b1,1720,FALSE,2470,750,Dire
1b07dfed14a5487dcfbb16c20c8bba5a,525,TRUE,1824,1299,
b3176d04c58dab954bae0491dd1b6704,1855,TRUE,1904,49,
fb14b5a7dc73d98de474de680db318ac,659,TRUE,2605,1946,Radiant
3e501821cab4392a0ce4837432bb6d79,119,FALSE,2097,1978,Radiant
cc23eee4a954af137ab679cc87879b5d,948,FALSE,1616,668,Dire
db261711bd14a1fdaaea05a0dffd65a4,1723,TRUE,3124,1401,Dire
2ffdb2587e6b86758d89907169288937,1910,TRUE,3549,1639,Dire
d9c3ba13846eb0b45c6af51dafbea2b7,1191,TRUE,2238,1047,Dire
dc913468c68e1ad826fc9ff1f690908e,1962,TRUE,3827,1865,Dire
4827f0734959a0f79b2b75487657b6e5,1774,FALSE,1926,152,
1533f429519930a5f432ae37a67faa36,179,FALSE,1376,1197,
a6206e3321aaa5299f30748d74556ed1,41,TRUE,2069,2028,Radiant
8867751cb6f2215786cca1dc034d5600,1936,TRUE,3792,1856,Radiant
9b6c05b60f86d46c2565f484e855cfd9,796,FALSE,1316,520,Dire
1c92a5e7680befce9518b941fc22154f,363,TRUE,1506,1143,Radiant
b2cf457c03449607545755a42cb6abaa,407,FALSE,1956,1549,Dire
b57bbb967a00ee4d73ddb7c3b88ff6a4,878,TRUE,1433,555,
50c8f678fab6d20117c5ee824afbbc2e,41,TRUE,1991,1950,
3edc2700054e7bba2cb87e4ff233bba6,935,TRUE,1109,174,Radiant
213bf90b0da26c5d3fe74c4b150de796,2349,FALSE,2494,145,
4467228dd20e7c95ddce36b65d290b8a,194,TRUE,2920,2726,Dire
3cfcaf4555770524846181d7d83e85ac,1215,TRUE,2289,1074,Dire
dd86981a01f2754ec6f7cc9794f123a9,1046,TRUE,1286,240,
377cba1f5fb565b6561fbb0493f4e183,441,FALSE,1686,1245,Dire
e24d06acd3b1cc7cf2bd113b72e18bff,1490,TRUE,3140,1650,Radiant
6afa83a053cd8a4eeccf1585cadc5201,789,TRUE,2492,1703,Dire
e199c29f2aec7730cdd69dd89e42222b,950,FALSE,2122,1172,Dire
766783e4d5bab32602165823a3476bfa,324,FALSE,1966,1642,Dire
5b5b1a64699861082143c664bc5441a9,1175,FALSE,1949,774,Dire
b9f7c775d7aa1ef3a9a06ac2ccbf42c7,1798,FALSE,2218,420,Dire
6388c1113e8aa489c7ca13b5161fe389,620,TRUE,1728,1108,
6157c5e4825cd7eb1264db868ba4cfb9,944,FALSE,2188,1244,Radiant
3f2c6f6f1ed508fc6cc45d4606c680b6,559,FALSE,2563,2004,Radiant
9c50055c33d1f93d47665ff1a79896ec,1725,TRUE,2122,397,
4e40ae89bcbec293b3793dfceee27206,218,FALSE,2031,1813,
2a14939b752107e9feeea2837b63dbec,789,FALSE,3537,2748,Radiant
84a4db1504d4022a88fb41b7949807d0,2477,TRUE,2793,316,
3f01b3f62a230b6c8049b8ed1a0ab69a,1769,FALSE,2875,1106,Radiant
b4ddcab9216312a5ff366b65b974aad2,159,TRUE,3268,3109,Dire
a6f821da87c9cbf7c947f3a95948fa4d,108,FALSE,1911,1803,Dire
e8575616288a9ce997bd6ba2ade9b479,1469,FALSE,1500,31,
81ec1741593d7b202e7ac1e600fb911a,205,FALSE,2111,1906,Dire
43e16c741d28914134e4446c30b1f26c,1139,FALSE,1674,535,Dire
fe5771e3adf570a25cbb5d423828d8ca,758,TRUE,2491,1733,Radiant
550748560910edfe7064d1b9076e1474,139,FALSE,1616,1477,
82eccc7637fcb16dcde033fd44e37168,1146,FALSE,2804,1658,Dire
4e02f3588b64e8fc9f0ad054a614ec25,1310,TRUE,1451,141,
3f5ac0bb5a0bf152a8b9ba12155d102c,2015,FALSE,2630,615,Dire
e8059391715fc568d0325176ad3ff97e,2835,TRUE,4019,1184,Dire
1b79c07c25799f02240030a94b7e4841,620,FALSE,2772,2152,Radiant
f9cbc302c1a39a013840ee5856a4c217,544,TRUE,3733,3189,Dire
b0c76921af71f892ed784a02650c0ea9,1059,TRUE,1537,478,
1ae102b3cc01e12f5f167a17672efb92,444,TRUE,1325,881,
b2b49bf6c71d90b0077cc756e2a79eb7,1878,FALSE,3388,1510,Radiant
16626ed688cf4e4c7fb7b2780f90a6f0,378,FALSE,1949,1571,Dire
3781d81a715aa138d2e9523b2c13f98a,1140,FALSE,1980,840,
51c1fa55bdbbdcf6eda2ed750eb4c9c8,101,TRUE,2265,2164,
dd452300c6807954080237cd07ea72eb,286,FALSE,2562,2276,Dire
82a505e42287e6177124c2eb7a27f2ea,723,FALSE,1703,980,Dire
89ae2eff36cdd822337ebf0a2486c148,37,TRUE,2141,2104,
5b73d7bc05000e2180489a78c2231a5d,1150,TRUE,1605,455,
6a00c0b7da15bc25a3ecf1a9452491f1,1818,FALSE,2520,702,Dire
12a7305c5f8f88ff22809938fd7f5dd7,272,TRUE,2429,2157,Dire
35b157673e2eae4efdffe787db29beee,2060,TRUE,2618,558,Radiant
8a76fa244a9a42909f0b48720bc54464,1787,FALSE,2303,516,
cfd1a288ca2b0200791f13bc4f309d08,681,TRUE,2112,1431,Radiant
6a9b75ddb487cdefd49b3afc48d4cb9b,121,FALSE,1628,1507,Dire
2db2ef94bc323cb95025df117f99a7b2,974,FALSE,2384,1410,Dire
92dede94a557b47cbaa52f2037e5a971,934,FALSE,2890,1956,Dire
1c5b5545ef7543e4b21d0474742623fd,114,FALSE,3172,3058,Dire
b8aad4104b9c1136a53578441cbfdaf9,280,TRUE,1695,1415,Radiant
86553840bd36278f2ba4565ef9025e82,1145,TRUE,1257,112,
01820bed0f66921899313b557caca0fd,2468,FALSE,2936,468,Radiant
76bf7e65d909b7f06fdb679e9c6b6f62,626,FALSE,2269,1643,Dire
c8e94911be453493c72ab0ff37df784e,1126,FALSE,2754,1628,Dire
394d825a4babe522c7de3f6b6f8ede86,620,FALSE,1478,858,Dire
e97da9d8ee2ed32f5a31be2aceba0594,2238,FALSE,3715,1477,Dire
9acabea35a2c1ed2416ab985e73e85f0,2076,TRUE,2371,295,
673acdfdc760078f8fc2a6982d23cbff,2025,FALSE,2507,482,
c3f27823b5d1e815941bd32c4902f116,222,FALSE,2292,2070,
6cce0d247306ea1ae3bc7131fd9bf91e,390,FALSE,1660,1270,Dire
477cc2bed7ba8f9ce9fe3f4a2119b60e,880,TRUE,1883,1003,Radiant
57a7adad8ebad639b0e3c2e471e0fe82,1091,FALSE,1919,828,Dire
5c98f5721f930bf3ff0723442de9a2e0,1237,TRUE,2368,1131,Dire
38e6111d68c26f802b9ec0d35e848b9f,643,TRUE,2101,1458,
91976d9c3f85de6dc9e22e9a35b6267a,1006,FALSE,2264,1258,
c10024b80b8a06dbafec3c76df8a5805,35,FALSE,2174,2139,Dire
889063b788dc9627be4c0a4588b7eba1,1412,TRUE,2148,736,Radiant
5a2678cd2683df43f107aabe49db5bbc,2121,TRUE,2480,359,Radiant
cab74c1102730456056b473cf3d5f2cf,1475,FALSE,1549,74,
d9e2b2e8ad52baddd5d85b30f5b1ba89,725,TRUE,2702,1977,Radiant
2e2cff58e27f22f1865a3309a48aab18,193,TRUE,2594,2401,Radiant
531d6ae2ddf569ec430411cbe05c8b40,1333,FALSE,2151,818,Dire
e1d773ada42361e02f177f1465a6008f,538,TRUE,2776,2238,Dire
c2361f081847b0c9308ba65b491b3bb2,1997,TRUE,2598,601,Radiant
e61ec33ec566c722cdfde0e9b4c756b9,1043,FALSE,2271,1228,Dire
21853e4ba0440c236af8a34a6b2d6c92,2079,FALSE,3318,1239,Dire
bdc8fa86b8e43fa9be2c4a5ab699f75f,579,FALSE,1201,622,
99dea183cf817431fa2c9082f46a9e1b,1587,FALSE,2154,567,Dire
f0902685b8c53fe875c54de82c0b0ef5,767,FALSE,2113,1346,Dire
ef84af080a433019c4411e10f6a060d6,1412,FALSE,3113,1701,Dire
48b6b53983bc00fefb45465bc976261d,3533,TRUE,4082,549,Radiant
76804c70e84e5768d6733fd3297d47c5,180,TRUE,3543,3363,Dire
9a10f0a2f5c64ae5638cdfa179631543,2141,TRUE,3543,1402,Dire
107dad2e38dac4303fc2aa3cbc8b9328,44,FALSE,1696,1652,Dire
2a763978b48763d24e807aee1f07fdb6,527,TRUE,1964,1437,Radiant
489edcab90a34a067dda2e8ab48c5e9e,448,TRUE,2329,1881,
869b918cac77eb7eea3ccacb7520dbdf,1685,FALSE,1806,121,
cadfb4d2e3ac3860479cd522089da4b6,252,FALSE,1735,1483,Dire
64e9ff4f339b831b02bd5edc316c4ee6,1705,FALSE,3231,1526,Dire
24e62a20ea671db22029fc4cd688055a,1264,FALSE,2029,765,Dire
4e8fc90214620d872f1ccc10d3e7a4f8,1573,FALSE,2089,516,Dire
fb2b6b76d327e6b4334d0a0362eadae8,2803,FALSE,3345,542,Dire
eb5b226eba1c5620ffeef11461373eb1,793,FALSE,1966,1173,
cc8994080f529d847afb23e0937ccd1f,1030,TRUE,1892,862,
c6a97d51c56569193270e18e7e5dee33,733,FALSE,1816,1083,Dire
4674bcf862d351c5718210c8adf19d52,1096,TRUE,1910,814,
2c31faeeae084d8c109983790e394dda,2178,FALSE,2659,481,Dire
ce31122328eb29bc13c48b21c8123c76,1241,FALSE,2087,846,Dire
107226a6960efdf103866e48d37e6a0a,1174,FALSE,2305,1131,Dire
53051d4392e007327b1f60f09087f51c,765,TRUE,912,147,
bb42f8832d76e87321a807b95b3e8f0d,1291,FALSE,2779,1488,Radiant
fa125159dc9247c4bab1b9f5e255124f,1399,TRUE,2802,1403,Dire
dba57ca8606c982f80c5c6c8021ef329,1100,FALSE,2848,1748,Dire
92ad954c3c084fae7707a811e61c2dd9,485,TRUE,1461,976,Radiant
0e9d23f07efd8bd9606f9f898c90332f,1650,TRUE,2017,367,
4337a8273c84763eb59692515be05f92,2657,FALSE,3087,430,
924ea902cc80bea694154846f2b60d81,0,TRUE,1321,1321,Radiant
ff01d5512b2db6294ba308bb977894ec,1858,FALSE,2161,303,Dire
0f8a594711fb9039e9f10f83a947da1e,292,TRUE,1899,1607,Radiant
e523f38543dba6a93f3c5e875e3e4b28,1629,TRUE,2421,792,
076923be34ddb489f45116bd742ee3c2,3112,TRUE,3399,287,
88680df46a2186a6cf3d3912fecdf3ba,1162,FALSE,2156,994,Dire
339ed6e89943b4dbe48d173a6178a925,1330,TRUE,2849,1519,Radiant
d80aab7e0e166c6c857716cbeeb747af,907,TRUE,1925,1018,
e901bd916c6959fa9ee19e30cb7cb083,388,TRUE,2261,1873,Radiant
73a7ebee6a5c77e3088575cf58f15d92,266,TRUE,2167,1901,
06326a9a4a10ee05768fb80cfe933e81,2464,FALSE,2659,195,
1af2830093e17dfdfda241b32b7b1a48,78,TRUE,1802,1724,Radiant
30f5ec7f815fc064cc3a7cbe574afd4a,2538,TRUE,3499,961,Radiant
386aabe41ae88d6920925485a5eaa19d,2385,TRUE,2458,73,
ad4b68d3c54525fd216408a719980c44,786,FALSE,2236,1450,Dire
7e40ade7f1ffbf2d167cb9a6c6930c4d,1571,FALSE,2227,656,
d51d9b55af8bbf793386bfd18d45855e,1706,FALSE,1782,76,
62c60e284e23840096bb48ea0ad38915,292,TRUE,4080,3788,Dire
221c4166e6549f53f9782499bd310473,52,FALSE,1637,1585,
7cb9a09fda988b359aa3cb57f54a5186,1711,TRUE,2104,393,
d27231d15f988f62c9a58a7de83bfe5e,1320,FALSE,1962,642,
474b40fba2d463cead7052195ec91e9a,2032,FALSE,2971,939,Dire
14789a10bbdac8ff50858347e0272a4c,706,TRUE,1207,501,Radiant
d7b5ced10b095b3657617b213add8182,1243,TRUE,1660,417,
acd4cbfc84bc19d5342a103e48112921,178,TRUE,2472,2294,Radiant
8f1121633564b0baaf7432d165100a60,1327,TRUE,1583,256,
a26a360fbd191bb3f34510529c4359fa,1525,FALSE,2869,1344,Dire
32888eecbe2b836029fea56fa0c41467,1314,FALSE,2268,954,Dire
6f24e088e7816a77f1117085b00d4c4b,139,FALSE,1944,1805,Dire
abd872307d3f4410cf0111e2bdc5f1e8,1412,TRUE,2351,939,
6558d5f93f59194d34a344288db7dab6,255,FALSE,1923,1668,
578ed94db97c9e8471b9e3a8064b63b1,1427,TRUE,1615,188,Dire
8e1940d0cbe758b7f64f8c64bd5d2fad,1622,TRUE,1903,281,
0aa3689e5cda49214a3294aa4810d823,294,FALSE,2085,1791,Dire
4726bfc0bacd5f1ac8c8be00e8616b73,1441,FALSE,3503,2062,Radiant
fd50c46d9e3987d013f23a9ab663130a,1914,FALSE,2391,477,Dire
5f42db7732b4816f3ae8f35be5e2db77,769,FALSE,2438,1669,Dire
1050a6fb57b621fbb82afcef198deb57,335,FALSE,2169,1834,
8934bf3e1e9715052b6f11ff7a9b8975,239,FALSE,1679,1440,Dire
9f24ec2e0ef12973f535c46d06ab1503,855,TRUE,1553,698,
8ca54a554d52f78016a631da82da1a6f,116,TRUE,3387,3271,Radiant
49011a01390f32767b33349bc721b46f,817,TRUE,1566,749,
3abdb2f46bd0e2a6c1c9e48b3945a874,1908,FALSE,2689,781,Dire
9e70a105b14de2210fcab8fe68f08b44,897,FALSE,2608,1711,Radiant
d3744869e725809f474bb03ccc1dd402,964,TRUE,3316,2352,Radiant
6e79070914473aa045eb0f571b079a85,1153,FALSE,1666,513,
0b7a90ca574eee7168052f13f3599203,564,FALSE,2707,2143,Radiant
f48ceba464ab5f6368b3076425ac390a,445,FALSE,2845,2400,Dire
b61562a68e269d4c12d4010047224405,466,TRUE,2482,2016,
2a9e7911036d3a1a3d99d58888c15aa7,929,FALSE,2056,1127,Dire
9175a0eb940b10dcc5ec50c39793f9e2,88,FALSE,1521,1433,Dire
446a1202f147791c32a915625e871ded,764,FALSE,1991,1227,Dire
5bbb5b640af85b977a90dad49580ed57,1354,TRUE,2538,1184,Radiant
b6723ba32c7c0587ec44a1115fbc481d,1507,TRUE,2279,772,Radiant
c1ddf128592b6b182dec1400898d5254,1578,TRUE,2792,1214,
6af69ac8cbeb1bdf650a687e4ad20c66,2332,FALSE,2733,401,Dire
926045233d0a60b46cee6e0a29ad1a6b,4349,FALSE,4442,93,
beeaf345de4ebb4a9aa3f8d9f8c97049,107,TRUE,2007,1900,Radiant
43a28b90c23e564339d0ff3cd2852080,660,FALSE,1694,1034,Dire
420efdd4269802ce5943c68aa24f47a8,1479,FALSE,3214,1735,Dire
4ca6be89542fa41d224e9706f572cb21,518,FALSE,1965,1447,Dire
80734c9fda695df30dc35db76c16bf86,116,TRUE,2952,2836,Radiant
88669489f1509a27a45ecc229b76000b,1353,FALSE,1609,256,
ed64f64bbdc8634aea474b57fc91305f,785,FALSE,2444,1659,Dire
843315e4c233ba36795155b764be72a9,1943,FALSE,2123,180,Dire
422a0e4f75abffca21422ec0f89cba7a,979,TRUE,1581,602,
c8954f448974b840eac55e83fa5d7b8e,101,TRUE,2245,2144,
9b8a8c1ef947d98562ada7bff79ee744,2887,TRUE,3723,836,Radiant
6d715f6285d68c05a9e57bde70231384,329,FALSE,3086,2757,Dire
f5d8aa6b9fee5f755f4c040a03064765,1471,FALSE,2306,835,Dire
2ea92dc92daddb66336fb78e864c5b81,713,TRUE,2484,1771,Radiant
a5d72ada69ef17473636a88ce72bed18,1352,TRUE,1909,557,Radiant
1b1ee3e662b0db806a3f5c033db51482,1240,TRUE,2223,983,Radiant
31329c156cbee2870a3ec7c8bbd97cce,1212,TRUE,2321,1109,
8d5d7d8defb90257262f1b54b4e864ac,1051,TRUE,3005,1954,Radiant
e251011e53f78ffd9b40d4a77329a60e,511,TRUE,2820,2309,Radiant
c92ee8362a80f81bcabbc94c5bb2a4b0,2450,FALSE,2742,292,
95f857acacdf4102eb076b1beb3c9570,766,TRUE,1879,1113,
38c39cc28530229b94c7271a85988cff,262,FALSE,1740,1478,Radiant
699389398b3fed75abf3882f5af1f4ab,1233,TRUE,1835,602,Radiant
25009c3556660f088e9a65f07478bf70,599,FALSE,5077,4478,Radiant
59d4b092f25522be22e121e26bcdf73c,367,FALSE,2338,1971,Dire
d4c7785a4b6f100fcf55d19914807b06,2259,FALSE,2623,364,
865bd27f5025710f418a8d59319d34d9,164,TRUE,1398,1234,
47e455f5708ebc9ea962438eab965143,3031,FALSE,3126,95,
f15a1b55de6eaae006d8a65d9eecd741,1005,FALSE,2413,1408,Dire
624562d86d63abba0994f54601a56b9a,508,TRUE,1578,1070,Radiant
d8545d433ada7a421260c10cc042760a,1154,TRUE,1903,749,
7cbd4143c8f55d7bebc6d5ede14998af,2516,FALSE,3621,1105,Dire
ab3ed3e035185fbfc906d33977c2ea00,288,FALSE,2060,1772,Dire
646cdead14bc62eb02f520cea14734ea,1488,TRUE,2520,1032,Radiant
21a9402f5235761d5abdf3dc3bd705b2,1493,FALSE,2025,532,
1cebc127e5c7d15b08eee9646909f0ef,1402,TRUE,3002,1600,Radiant
03ffcea1405c92f24220a0825b99eeae,1764,TRUE,2791,1027,Radiant
bceda3f5246a8b9bc3890a1767ca0d21,456,TRUE,1766,1310,Radiant
954d8d2cea2f6bf4bde42c51b757d2f3,1527,FALSE,2707,1180,Dire
4a7dad74b272e993821e19a7a0320ab5,1202,TRUE,1924,722,
a1f1049b37de2b8f59361f2590bdce07,3650,FALSE,4457,807,Dire
7d9d81079b23318e7fb67e8cb9238c5b,1502,TRUE,1916,414,
ccf916a0282751d0c6964b0ddc774a9c,1404,FALSE,1857,453,
0dbaec38fa3bd983bd1dcc866754ac7d,1185,TRUE,2615,1430,Dire
ab3ae074c84081673e006aaec9f45c02,1923,FALSE,2515,592,Dire
7418af2482676785a1e75806ca4df7fb,1191,FALSE,2477,1286,Dire
d3172c5efdf5924fdba334b8c7faa1fb,2112,FALSE,3755,1643,Radiant
612697119708eb45fffd108ebd6263a9,197,TRUE,2376,2179,Radiant
cc1eb605ef0ef8ce173be0d89a9f99a1,2122,FALSE,2520,398,Dire
710169ddc171ad5b4b0fbe5030cfadfb,41,TRUE,1581,1540,
3794fa867ce882d6b05b2f8f3ce0c5bd,1256,FALSE,2258,1002,Dire
e174c0ae5c90b0332444e03136891f11,789,FALSE,1936,1147,Radiant
f65a7488ab83501a835790f56dbcd4b5,388,TRUE,1530,1142,Radiant
3217b13959a08af1aeea272f6be63e24,677,TRUE,3453,2776,Dire
5080f9bc25e9b6b68ddf455c0a73878a,1170,TRUE,1482,312,Dire
36c5828f6a76328f938166149298def0,2302,TRUE,2528,226,
264d3589cebbb1c71f2d10a5925415c0,317,FALSE,1345,1028,Dire
251fca34a2d213dc802efc65723cdd61,1043,FALSE,2466,1423,Dire
6a1f0eeea62e247259f04881a6c666cf,3392,FALSE,3587,195,
a606dfa36a78c4de7b8e99a93dc6d6fc,3404,FALSE,4348,944,Dire
9c2b473dabbe51479dc21a8a02113de4,942,TRUE,1732,790,Radiant
2cf9daaa7523921f37dcc515c87bb88c,2068,TRUE,3204,1136,Dire
0aa1043d989d1d951810c504414ec230,1451,FALSE,2423,972,Radiant
b4ca7cf1a8868f567f25ef6b31e63009,960,TRUE,2490,1530,Radiant
952ab58bf48b4c8e56326a8ed7b027f2,1173,TRUE,1552,379,Radiant
8e124f697522565571966899ad4e6480,2072,FALSE,2347,275,Dire
792bd14e0cb0ce9fdd1bbcd1d08ac603,719,TRUE,1482,763,Radiant
47c84c70c135c5cd951faf442da230e9,711,TRUE,2606,1895,
75858acd31fba0cd82dd4b8472008c9c,947,TRUE,1912,965,
89796032122eb74ade041cd996f381b4,439,TRUE,1523,1084,Radiant
f3dfe34e54c3a6bf75a975dadc928341,2333,FALSE,2756,423,
b687b16b91c844826d76ff2328e41736,1213,FALSE,1364,151,
602d6d23211684a60bbbb27f14516b68,881,FALSE,1396,515,Dire
da51cd95ed605c3cb5c0fd170a373d38,2280,TRUE,2361,81,
6528a06a16a69d0fe38e3d488d645783,1316,TRUE,1560,244,Radiant
57b9f87e302091eef42f493bf47c6b1a,973,FALSE,2337,1364,Dire
b680473163b29a978390a61c8aecb575,1396,TRUE,2227,831,Radiant
52990df27ac3fe7f1cd732cff329783d,281,TRUE,1229,948,
9ebdf4b2e53611509cee302e81609a46,872,FALSE,2197,1325,
da4783229928c081943c5eb00e61350e,1460,TRUE,1650,190,
189ee9c5bfbd9387dae9414958d79e0c,2356,TRUE,2844,488,Radiant
bec335c102f317ebc7aa96957393d619,98,FALSE,1861,1763,Dire
8885e16c3792d3f484994dffa0524afc,1825,FALSE,2628,803,Dire
38b5906b5f1af19814a2ec34fcd5e377,297,FALSE,901,604,
09150a588bf68fcaab943e18dcdc90ce,637,FALSE,3423,2786,Radiant
61f8557fbb43a543ffa52e5fd994a391,644,TRUE,2600,1956,Radiant
051eb2a81ee7901726010d5394744c01,1896,TRUE,2837,941,Radiant
a057c3d0895b6d3d5a3feb04b53056c3,160,FALSE,2580,2420,Dire
4114a6a5c45259a863dfcf05e50cca7a,3232,TRUE,3482,250,
e50f99e825d9db963d8a9f8720a0d9b7,236,FALSE,1019,783,
5c14a25b2295b4a1d71c40afdeb84400,2055,FALSE,2599,544,Dire
c5734a0455a3b03a5614325811f12cb6,422,TRUE,935,513,
e5eaa61fcc5135e513f31f17ce173860,928,TRUE,1188,260,
b9905379494774466b076f7facaae253,1125,TRUE,2326,1201,Radiant
da46739dd0ec288a10048a77d6622865,107,FALSE,2019,1912,Radiant
6ed8c7a851090beda929bcff45fd345f,1783,FALSE,2872,1089,Dire
283538980a1e9488eb439236761feb42,139,FALSE,1744,1605,
dfa51140a01aac2d562bc13582c1051a,1066,TRUE,3646,2580,Radiant
23212749aa9dbee76b9bb7868bedda0c,284,TRUE,1780,1496,
cfb92d8e7ed904bc173796009f846bfc,1056,TRUE,1495,439,Radiant
9fd5356cbfb9929822bb2190ff6d9a8f,1304,TRUE,1549,245,
41c3185516ea93a82aaaec0f8d869b85,79,FALSE,1733,1654,
2986dc2fcee2d27b61cbade3c9cc1363,1542,TRUE,2432,890,Radiant
f525ba7874151b45d808ef3aabfe58f3,1210,TRUE,2042,832,
5e5c696f0e613d64f668b61065fdba8a,313,TRUE,2572,2259,Dire
5e903e5479718e0cb8a5834f36dcb635,674,TRUE,2947,2273,Dire
9d594a830e4ba65c1d0481bbc465af9b,3166,FALSE,3531,365,Dire
8601455cd34eee9d07fb10ec4efd741c,953,TRUE,1358,405,
81371fd163616f1b16a4e288764e17e8,1255,FALSE,1861,606,Dire
4ee99924e206b555daabf1e17aa604eb,283,FALSE,2811,2528,Dire
5c664efc52c1602beddc09fa3284b8a4,190,FALSE,2136,1946,Dire
0c54199bb10dc87926b906dc1f0635d8,1476,FALSE,2476,1000,Dire
0156cbc51aaab09e06d312c51daa2f8d,1017,TRUE,2474,1457,
731875c7a719e92fbc85a201b4aef023,1536,FALSE,2055,519,Dire
4b05c30260c05701379f1f97f9e020e9,1863,FALSE,1972,109,
d271b8c41a13d8a43b328edaa08176d0,535,FALSE,1727,1192,
213b0a64218b3d41c9538836651c78c9,345,TRUE,1619,1274,Radiant
cdf664cec3d9228ac56d8a09e1de4e65,1440,TRUE,2459,1019,
423fbc56bbeb54287dc10f4883fd8dfc,881,FALSE,1635,754,
ab1de2224b7046f27d533108123b42a7,762,TRUE,989,227,Radiant
df36f74058006926f97eebd0b375b489,602,FALSE,1606,1004,
cdb1a3f117bba90ab1c6311e284ed613,1101,TRUE,1623,522,
4a1b3756f15e7e9a8fdab8e5f7894bb2,541,TRUE,2603,2062,Radiant
d54f0f4826517b4ceca9716301903024,915,FALSE,1795,880,Dire
fe15d6f621551cad855ca1e9d59c9d51,1685,TRUE,1981,296,
ca72e6f9306ba0b2bf5f439400356280,1705,FALSE,2487,782,Dire
e800718cacf4c4837e7f63d3fc323d52,1397,FALSE,2319,922,
d902a3b8a0138c01310bfccfb3e86908,181,FALSE,2509,2328,
ae93d4dd936604ec8668eb099ebc4be3,1006,TRUE,2211,1205,
ebfb09d33d01dfa555ddb3ed18bef24e,913,FALSE,1451,538,Dire
0df5be4b1c436d143373c312bb250a38,1375,FALSE,1649,274,
c4306f0390ed5d7715b13db78478c5eb,552,TRUE,2252,1700,Radiant
e7895ea1a1a7def08cb7043831a18767,215,TRUE,1914,1699,Radiant
68a598515a8f0cd1a240539b94a7b0ad,995,TRUE,2143,1148,Radiant
b0fe149f06ef951c80a4d6f316e43639,1140,FALSE,1313,173,
2eeebcc853963794b01053ebe8bcb988,1213,FALSE,2391,1178,
fe113ad4b6cafb45d341fa79d70b153a,271,TRUE,3910,3639,Dire
247de489f27447dc37ad628714c710e9,1465,TRUE,1603,138,
b7ca60ac88bdebb851a10a63af625656,1351,TRUE,2543,1192,Radiant
1e7b6a3586bf8132bd7091b71aa5ed3e,2199,FALSE,2465,266,Dire
40cbce6001b44cc835ecf06d90b37425,2241,FALSE,2394,153,
74ca20ef244cfccb616de748512fc0d6,1259,TRUE,3723,2464,Dire
7cf3c1375f8db2811408db981aecdcff,484,TRUE,2018,1534,Radiant
e6488782c0f6dce4a55ea173eb22c1d4,853,TRUE,1916,1063,Radiant
abc10f38134b9ea7b18edb92f5c5a026,226,TRUE,2389,2163,
3c7354e75ab4c52672988f4fba288d63,1993,FALSE,2998,1005,Radiant
69a9cdb10232263d8d3103f91b7171a4,1606,TRUE,2766,1160,Dire
e76e84ae75cabc855b12d2183fd23f71,1230,TRUE,1976,746,Radiant
f4c8e5b3b015b0e53f4dd40b4420ae71,595,TRUE,1333,738,Radiant
597b960119821a15f5e9c2c12954d96f,1342,TRUE,2430,1088,Radiant
cb590eb3a8e3a334d917735efe613019,93,TRUE,1995,1902,Radiant
1eb132c60df2d03a59be39eda7bf9179,695,FALSE,2936,2241,Dire
43517a77b000126c9bd8867b3db25088,2388,FALSE,3281,893,Dire
a3d5557a97dced0db17f87c657887463,1238,FALSE,1382,144,
a9adf818abf5ebc9b75b998f54708e9b,1168,TRUE,1645,477,
ce4a4edc562ff57c428e521fe5a4c4eb,263,TRUE,1610,1347,
8ce5b9c74246609fd60d4ed1d2062766,1068,FALSE,2136,1068,
6c24172f6b6355716e4fc47d8ddb8f5c,1549,TRUE,3160,1611,Radiant
febc69b709a5f56abe4420e70025b3ea,134,FALSE,1105,971,Dire
e2990c1375b80000290a596905b4d3ef,745,TRUE,2349,1604,Radiant
e9212ffbf30d69c466bf2296e447b66e,794,FALSE,1734,940,
e93737bfef22f4f5a8d89dd066822faa,398,TRUE,1573,1175,Radiant
8a47b03c7e55e32a888a57d6b89f9bef,1363,TRUE,3149,1786,Radiant
f64c015c964f2e19aaac42ccc72ba6b4,1741,TRUE,2216,475,
da86f6057ef2b494a7c47624471dee5e,453,TRUE,2507,2054,Radiant
4be2313869be90fbcdce381c2b20536d,894,TRUE,1262,368,
195875d0c4eea320a3d44e9d0cdad9f2,1434,TRUE,3107,1673,Dire
8e0ad8cbcf5a87c451e5e1e07596c443,1023,TRUE,1661,638,
4976034c366cbb5b9d212f3227586867,1025,TRUE,1529,504,
c054ef040fc24b22050b7b49bee0436b,810,FALSE,2690,1880,Radiant
8ecf4a02c723a1c615478c0ecb81fd9a,114,TRUE,2459,2345,Radiant
51d3c3d95ea37e17de66a717329419bf,980,FALSE,2148,1168,Dire
2ed475b5a4b6588b83f4a71b25aef79b,1112,TRUE,2551,1439,Radiant
421ff3eecd8751e59d2a72f7e52e39c7,1615,TRUE,2308,693,Radiant
51f4b36061a37314ece42f9a6d64ef56,1194,FALSE,1882,688,
446d8038acd21fccfc4f05a9b82702c1,128,TRUE,2210,2082,Radiant
1a8f9d10fd73213b8f27f6dca9c297fe,1605,FALSE,2153,548,Dire
4660499b32d71ee3ba52933cacddd540,587,TRUE,1549,962,Dire
ff65a228bc5609847c5f9814a935fe21,826,TRUE,1920,1094,Radiant
2a20576431606bb52adbd2c0ae79b0bd,1732,FALSE,1916,184,
0b774a68ae8e9c5a9501923db1ff1774,76,FALSE,1100,1024,
d2b4f4879988a24ed6d6db1e83ad3fdf,66,FALSE,2387,2321,Dire
87269c5c3dddaae5ba973ce280d41b4e,380,FALSE,1058,678,
618723186a6b6da7108cbfd00d6bfed3,1996,FALSE,2563,567,
6518f9bf80c1b766d7d32b23411631c0,1519,FALSE,3177,1658,Radiant
a2e2dd6771d98b79686de2111ce1168e,1126,TRUE,1521,395,
159f19776d9fde08185138f7143309fd,1247,FALSE,4604,3357,Radiant
c752f3d570895ab59a6d22afab5a7f3b,1082,FALSE,3510,2428,Radiant
23ac1e1e6c619d20bafe8c9476d949e8,555,FALSE,2895,2340,Dire
4f8cb453038984b9d5ff1b7ccc1da6f1,1228,TRUE,2245,1017,Dire
d544632fba5fc46eecedd2acedd12c4c,35,TRUE,2301,2266,Radiant
e82ed76e04b1cb61b24e6269110244d5,1589,FALSE,3256,1667,Dire
89b8c989a1590814968d571cda7e6635,413,TRUE,3203,2790,Dire
084b7730dbb8881ac83eb1ccf6a50597,954,TRUE,2031,1077,
ff0e0cb14bcac52c3da5463cdec041de,614,FALSE,1454,840,
4f45a97186efc5497c6f48809e8f67ac,66,FALSE,1978,1912,Dire
54a674594a421c1ecba8791dbeaa3adf,516,FALSE,1449,933,
6526368455c270a44b4f776e31c9ad53,2239,FALSE,2663,424,Dire
4e60b784bc47e817ddcd1ced1c7c23b9,95,FALSE,2559,2464,Radiant
f8389c6c21513a354bda24a4d49e553f,620,TRUE,1064,444,
590d09973d765e26141d403113733adb,2601,TRUE,2848,247,
103e3d0d37ecc865e781a5898ee4a755,1164,FALSE,2314,1150,Radiant
8b58306ef4565dd6032c477280483ff0,1587,TRUE,2442,855,Radiant
cac808e75c784166c6a45ed81c5bc8d7,432,FALSE,1304,872,
01b9bd54edffec19916cca03086eeda6,670,FALSE,1023,353,
e8b291ebbaea157e43143a2aca863c33,729,TRUE,1495,766,Radiant
2c383ca53e322a055911132b14b58f5a,1417,TRUE,2336,919,
41deda0dbbe94727f55370dc2cd717be,298,FALSE,4133,3835,Dire
db854d80e6e2c40b2841d471c5857493,48,TRUE,1886,1838,Radiant
e1ed4e80e93257c6e1b14cb1caf50aa7,1612,FALSE,2450,838,Dire
47bbbf616af8294351f9839f5feba566,2241,TRUE,3378,1137,Dire
59ebcfb8bac3b9ca348e84531ed2dae1,926,TRUE,3592,2666,Dire
33d84f32143aebdecf0ae0737c3ab0b6,428,TRUE,1341,913,Radiant
1a9418bb9ab22ce100b81ee79efa87ee,917,FALSE,2759,1842,Dire
2ff7274e9fccb45356b729ebbd8ebc05,728,TRUE,2808,2080,Radiant
5fa9f2f2e2f4d97a45e7d0839f509d92,500,FALSE,3016,2516,Dire
994220eed6153c738a1677d6e1c56cb8,159,TRUE,3124,2965,Radiant
4acb26495cbe635bcbe0807951d570c4,1599,TRUE,2061,462,
b435d31b849be4bc830771c13c659002,1071,FALSE,2914,1843,Dire
0d8fb951566c8ec9c9ab2085c307cc79,1817,TRUE,1892,75,
cf883f4aa1d8dc35aa7c5dc8af889c1a,1226,TRUE,2073,847,Radiant
6c60edd9788f2e024b28634b1f2e232f,631,FALSE,1159,528,Radiant
94da014f360237cf1ca6c015bf084b6f,2008,TRUE,2351,343,
b0c5f899510b1a106531da2f754fe7ee,1767,TRUE,2526,759,Radiant
a72704abe98fbcaf38bdbfd4e355c499,544,FALSE,1560,1016,
f0353e503e0b12e7ba223398bb97b3d1,206,TRUE,2206,2000,
f2092809d971821355f2da79941070a2,871,TRUE,1880,1009,Radiant
dfc718f3fd738368d2319ea159b50f92,752,TRUE,1898,1146,Dire
7e1b990de91f845421cc7bdb4cba81a8,941,TRUE,1095,154,
d319fbae5e4bd59becdd10ac278330aa,3246,TRUE,3414,168,
1e9bd872f3a5ed17a34e237a1c2458e9,271,TRUE,2116,1845,Radiant
24b81986262996ae353630e4a86f781d,1143,TRUE,2913,1770,Radiant
32ee4cdcf8380afa11ab09401b756855,1174,FALSE,1991,817,
659a1cedc836583130dbe45f74eea5df,1492,TRUE,2440,948,Dire
db17fba264bd7491168a8c66b60db854,85,TRUE,2501,2416,Radiant
2f57f4f51d0c0ca8794ff9ee2882b33d,2164,TRUE,2837,673,Dire
4732f13ec482814a7099d77814dae58a,1949,FALSE,2129,180,
6f580da3de1829f8f8910b21c35fc6ce,2010,TRUE,4199,2189,Radiant
62163edee7a42fee60351eae97e14a6d,1740,FALSE,2600,860,
8168dc45da3a692ab6d70533f60228e5,1522,FALSE,1632,110,
bf05b37c9daa7622b057c0e772b0e24f,337,FALSE,2050,1713,Dire
43a262c8db82909b8b9e21db8b2c3b7d,1145,TRUE,2345,1200,
f13a7630d00fce19992ab5c50952623e,1161,TRUE,2832,1671,Radiant
57fd6373600372c451e339c7e44bdb19,387,TRUE,1889,1502,Radiant
e6febab25593b4a02e478f946e0db264,413,FALSE,2250,1837,
cc87f3e15857ffb09183e8b3b58f42de,1085,FALSE,2755,1670,Radiant
35612061c97634d4ad67b0c9063ad8e0,1677,TRUE,2606,929,Radiant
aca457a9c6c372191023342e19ddb53b,1829,FALSE,2629,800,Dire
36af92fdde6bf5a09f5378323266b69b,899,TRUE,2760,1861,Radiant
c36bc21bdf5a03df07d042a2c6c621ad,844,FALSE,1129,285,
1167cdbf0bab267f74cc1a21587bc013,112,TRUE,1006,894,
ec0ba527d53a4c350e5cc782b1a0d4c3,1612,FALSE,1980,368,
d682e4bd75f7e3e23d036521f602e18a,832,TRUE,1861,1029,
05ce2ee9409a914f94e05c340007e978,1592,FALSE,2136,544,Dire
05dcdef7e0c5fe013d0b13c48d4b06da,2156,FALSE,2603,447,
cfe32062185347dc3becaa555f219802,1343,TRUE,1753,410,
656d2b75f7fcea0cee1ae05f8177b8b4,1317,TRUE,3342,2025,Radiant
c453c29db1f556a1eb0df2a3ee134739,458,FALSE,3555,3097,Radiant
8ca44779096e40db08f0bde2a397f211,846,FALSE,2805,1959,Dire
5a0d12cebe23cb404214ee2df28df99e,1680,TRUE,2258,578,Radiant
19b0683580296813cd1154405e05cac4,641,FALSE,1356,715,Dire
896ae9016c90ecc4e770c55e695fafd3,115,TRUE,1652,1537,
c9c0f399211c4c10546e3b9bd3d52335,474,FALSE,1977,1503,
77a0efd851f663cfb51e342035a9d857,224,FALSE,1068,844,
1d7f2f435c8ab0ffa2f8443ff4648280,819,FALSE,1858,1039,Dire
0c8bb6b3d025d128d399ffb2e58b6f27,2156,TRUE,3040,884,Dire
5eb2a86ae8557c68ae0ba8b2ba34c317,469,TRUE,1891,1422,Radiant
8ced4863f254556b0da52b443f554e25,1138,FALSE,1786,648,Dire
d04343a31fe7d82928a7f4c77fa8dcaf,161,TRUE,1678,1517,Radiant
fed3eeed40b39ac5f93c3b989064c289,640,TRUE,2315,1675,
5695c19a5bf120468430ab98a75c116d,1412,FALSE,2510,1098,Radiant
66a3a6cd1f04d9f58e9488221761d02f,1375,FALSE,1930,555,Dire
783c76bb1544c2db89c974caf9ff71e7,1872,TRUE,2813,941,Radiant
1949ef2fb978da2593ef08c2ac17c8b6,155,TRUE,968,813,Radiant
fda24cb4fd02958786b238f6b1d10a6b,1837,TRUE,2186,349,
9b5dcd2f531f54727a8e80a81f5e00e3,2105,FALSE,2267,162,
f03cf644dcc60f6d4cdc8b2000399a1e,1683,TRUE,2247,564,Radiant
3ebe7457d156c4f768ac14dc2e2f6783,1484,FALSE,2901,1417,Radiant
01abc22217e458a9001236ebf681ac3f,1953,FALSE,3173,1220,Radiant
1da617cef90f64742d2541b9d006c786,61,TRUE,2319,2258,Radiant
ef6afd79f0868d80b95cf033004b9d72,2095,FALSE,2702,607,Dire
f3170c59e8f690ef760b57c44e0b55c0,9,FALSE,2193,2184,Dire
7142792419a87028d17b4aae634db75c,568,FALSE,1488,920,Dire
e2bbf09b49dc953a0dde32854c2c1df2,349,TRUE,2174,1825,Radiant
548b40e369b10c41c36281b1035cc97f,722,TRUE,3003,2281,Dire
86efd2b9b8245d36837a8fcb4b095094,662,FALSE,903,241,
278f265296f211310adfe913abf3ba10,1576,TRUE,2031,455,Radiant
87507d9a4a4b4a89108977e0b4dcf4a7,242,FALSE,2226,1984,Dire
d45b7226ca193001c984897ebee71554,1014,TRUE,1714,700,Radiant
3e0aaf7041933ac89148717e85cd4435,1545,TRUE,1829,284,
3f04bf2471160a4f0c3a3326c38ed6c0,1786,TRUE,2243,457,Radiant
d7295d05b69df601aa2c3a2aa1909b31,246,FALSE,1426,1180,
9e63f57424e3eeb476291c85323e2a04,978,TRUE,1445,467,
95de2e4262c713caaab3379f2d4475fd,2707,FALSE,2810,103,
26ec8caaa27c9f50e75588f25314e4a6,423,TRUE,1084,661,
d22741bdaff79345152a3890a6f6d213,1444,FALSE,1953,509,
a50f4bedac5e78608b0a48bd12af1b73,2163,TRUE,2805,642,Dire
c6c1d07a2e5e5d7df6a2091a4ce9b5a4,184,TRUE,2109,1925,Radiant
bbefb7e43d3b5fd9e552b6289a109d9a,412,TRUE,2005,1593,Radiant
e706bf40d5679b02a5f93002617ebebc,312,FALSE,2420,2108,Dire
0a25db12b159663eb9d71a780ca7ecd8,2211,TRUE,2437,226,
a606b0910087766030389914a6632dbc,972,TRUE,1537,565,Radiant
686b5d56b247fff2cc16e7948c4f6b0d,335,TRUE,2064,1729,Radiant
06f326cf1ef53121c2dd5a4bcb905864,1473,FALSE,2805,1332,Dire
cf3a29755dc19fd028395e2ad0855c85,293,FALSE,2698,2405,Radiant
69dba99ef40cb570e6540d6212949eb9,929,FALSE,1894,965,
a34813248b0842a6fc27425ac5d22196,100,TRUE,2504,2404,Dire
5888752b85f2f10bcc8ac11a4fab6d6a,956,TRUE,2174,1218,Dire
759d8bef219eb8f12e8b9152adc4dfa3,1239,TRUE,2025,786,Radiant
cabb08857e314e49e861663d26a31249,1478,TRUE,2561,1083,Radiant
754d8b1f8efa99e88d3abf6b9510218a,162,TRUE,1457,1295,Radiant
e448755b5f3e695bbf922b8839d2b53d,1234,FALSE,2444,1210,Dire
3abca0b4b3305bc574a1991d11bfb279,739,TRUE,3150,2411,Dire
364d23855839938399374c4e80639bbf,1982,FALSE,2370,388,
109555f31cdb2c91acdf96e9b1fd90b5,336,TRUE,1663,1327,Radiant
240fcc962e64ea2aa516716c55729631,2270,FALSE,2597,327,Dire
3180f50a0b12a318e72e12d9889c2958,2310,FALSE,3254,944,Dire
5ab25d07dcb4829c0714c5e3a0567079,511,TRUE,1666,1155,Radiant
7d221d96ce5082384eb8150832c7c85b,864,TRUE,2625,1761,Radiant
84430cbe45ab16a3fe76f63558f2502b,685,TRUE,2480,1795,Radiant
73523a210edb3c7f026bd03b8566b926,1154,FALSE,1527,373,
9027f0577f0f8b96bb98d450baf6950c,364,FALSE,2277,1913,Dire
7a05888921ca894ce9928dbee7279b9a,394,TRUE,2093,1699,
a1b20d36d86009591e3d6aa24db51d58,179,FALSE,1963,1784,
24e9f6c65b89692332a1987beac4df52,2616,TRUE,3276,660,Dire
8c12a44fba888f0fbfa9e712b1d07fc6,2616,TRUE,2865,249,
9711f0067792e34ba6378dd669e64b44,933,TRUE,1601,668,Radiant
6f660d48f8ec09a238dfd30c48b655c0,857,TRUE,1307,450,
e3d3480fd177e53aeaf094cb7c50fdd9,928,TRUE,2284,1356,Radiant
cda960fd9e4df809b228d7f2f2e81ff6,537,TRUE,3168,2631,Radiant
662e281d18995aa0c7393ae93411284d,2662,TRUE,3829,1167,Radiant
9ece319ea662c49480e4bdd8d31a734f,394,FALSE,2370,1976,Dire
55c5bf2642be16cdecb96b0ee4611bfe,1445,TRUE,2490,1045,
eaa7845648666e4173538d19bfd803ac,1370,FALSE,2514,1144,Radiant
a0fde775fafb2f1eb06d5c0560533882,282,FALSE,2224,1942,
5afaf91125cfc8051327168598d3f09d,104,TRUE,2040,1936,Radiant
04b214ce3b4a7678bd83f5610cb09e44,1768,FALSE,2790,1022,Dire
3d4d1a27e383bdf52527de3e6f078671,1329,FALSE,2482,1153,Dire
d5c8c97a2b3e4a8084eabc9bbc2ca648,3415,TRUE,3506,91,
e9688a4880c847c639e05e32c658b8b9,408,FALSE,2510,2102,Dire
876d00915ebd00ca08423cd9956b3b9f,846,TRUE,2175,1329,Radiant
55efe6e5e8527e6675fe13a1a977ead2,78,FALSE,2510,2432,Dire
5a7f6af72353b2cae9dd3b898927ccbb,433,TRUE,1115,682,
0c34f427f9494313267f290b6061fda4,394,TRUE,1120,726,
3b5f903e23c9556f5a00cd17f79af923,2574,FALSE,2837,263,Dire
5accd53999009e071f5e18396d8dfe0b,1289,FALSE,1935,646,
da4fac9ad46fae11e28d9b95e3aecebb,902,FALSE,1080,178,
15c930aa69d63106d830683315720e30,1442,FALSE,3177,1735,Radiant
d4b32eec71fb241d5cef2cc19abd4fcc,2032,FALSE,2812,780,Radiant
1c9fd27f58388b20f5a98132e5f98c4c,1189,TRUE,2982,1793,Radiant
57eafc87a8101789da9fb99768e6e4ee,931,TRUE,1914,983,
d411f7392f83f409f3517de81c6bf047,2077,FALSE,2475,398,Dire
0732e4c004dbaeb93c818230b58a4273,1531,TRUE,1918,387,Radiant
0e10c9624243063b2c4ac02e2873e290,1372,TRUE,2409,1037,Radiant
f53f6339963b730a032bf7e81f76a30c,248,FALSE,1848,1600,
ca51c081432e0a76fb8a347fbfb8b790,2599,TRUE,2697,98,
623dca3bab613dd376031dc877f49eef,454,TRUE,1110,656,
5fd911b147570637150eba18eb0b2ee7,321,TRUE,1423,1102,
1034acf37799d8a497524eac13d182ad,1288,TRUE,2365,1077,Radiant
fac6babc6f9e973de2c4b54045de0281,1432,FALSE,2200,768,Dire
89afbf4ff8846ab850d57ddfc7f7f7ec,427,TRUE,1544,1117,Radiant
3bd1174f3a4053b8963dedac12e6b81e,475,TRUE,2381,1906,Radiant
628f7abfd32e4bb06c0ad43fb6b3b43d,948,TRUE,2917,1969,Radiant
a4c22f262002dd68835bd0351ea9a869,1278,TRUE,1443,165,
72b88de083625edce4e72df9e64268a3,591,FALSE,1375,784,
4c5e1512664757cf59277375e17daaa4,546,FALSE,2017,1471,
6cb74e591e612064f0aa1fbe5141869b,481,TRUE,963,482,
bb2d597e6a3b5746054545ad2ff3694a,969,FALSE,2387,1418,
60a8593449a76fcdf4e017dc5acfa523,604,TRUE,2051,1447,
6a3a6067700c25a35081414c7a9be75d,299,FALSE,2908,2609,Dire
fb84b6a2b7ebdf32fbb8f655a5e25b86,2435,FALSE,2844,409,
241ac42a9f9a39367ddf3f8f93b47285,2755,FALSE,3339,584,
5d6c0c862dd4483b30eb73fc3eb5f7dc,2080,TRUE,2714,634,Dire
0c3b30126b1efbae4f9a7a5174feaf11,440,TRUE,1421,981,Radiant
68e3268bb2e650eaf6555fbe4558e677,249,FALSE,2003,1754,Dire
87b1512b968ef98e696406341b400273,2228,FALSE,2391,163,
ec72360a1ca5f980e234c0b8e15d83fe,1864,FALSE,1950,86,
64998818b44adc359a8ff02dae5d6453,2006,TRUE,2272,266,
f09a2ea4c194eee8ca51d5a0dc62901a,1250,TRUE,2099,849,Radiant
4cd5ec7f6bfe4989c90d5ca056a1fe27,611,FALSE,3052,2441,Radiant
cab27582ecff44abedf4372dc309933f,1601,TRUE,2118,517,Radiant
ee950a46db514a55c77239ae44981142,1765,FALSE,3079,1314,Radiant
1296d344fc95b87e898c67e37c3c2f34,45,TRUE,1735,1690,
53eb287161f55bbbb6d3e884e6e3cedb,1469,FALSE,2206,737,Dire
e94104cc2cc9c641dad9d7b02cc1a9eb,276,TRUE,1292,1016,Radiant
99912e65aeb9e54b5a56f28e2ab7f3eb,270,TRUE,1086,816,
41f2da69fd43824a8a3ed865f1d4e7da,1831,FALSE,2254,423,Dire
9602d952e14069e674b19b30c03e7711,510,TRUE,973,463,
b44199972ca73a409170431d5502aba0,657,FALSE,1564,907,
ccd948f461ef761e9075aa787f3df2a0,1707,FALSE,2779,1072,Radiant
c2aaa701da02870933dd37e864c36c4b,103,TRUE,1927,1824,Radiant
c4cf99acaf977dba31db1698b46fba5f,865,FALSE,1051,186,Dire
3269b78708b48c632e7d31ff477096ae,782,TRUE,2146,1364,Radiant
72b4f09c4aeec5d5a69e0db163452ff4,2560,TRUE,4098,1538,Dire
0a39afe3372a5154dc06a022cd5013c6,3301,TRUE,3854,553,Dire
4d212ff59b9c354607f6d3ff0525bc00,935,FALSE,3591,2656,Radiant
f071f853e4078fdab221ae0a7c823619,2,TRUE,2791,2789,Dire
280618544f5aecf325c3490e5e281029,1838,FALSE,2823,985,Radiant
1e7c06e7d74e3046deaf2a3807a946ab,1693,TRUE,2026,333,
9d42936c63a3921a4dc2182ed3e27510,453,TRUE,1108,655,
ea15f7bfd6e034795b91d43e5f740541,2350,FALSE,2979,629,
78428701024404543f84a52d6dd696b1,970,TRUE,2132,1162,Radiant
183eb3713afec283344ea0615ad1f0a8,1537,TRUE,2815,1278,Radiant
c834b82aabc3f87adc208d5554689f4f,1063,TRUE,2173,1110,Radiant
f4e0201b156766cf6d63c762563ed825,1582,TRUE,1808,226,
da11d15bece20fb57b6e33cf9fb5b5b3,1019,TRUE,1491,472,
c1464526b4fc506673a38ec649e5af80,1658,FALSE,2505,847,Dire
7eff3a41a4fe1074f211db5bf9526c9b,1005,TRUE,1563,558,
9884bac6e6350d06d2df11a644ce2ce5,575,FALSE,2014,1439,
1430d2d8b23f4c2f4cf3c9d7a9d22023,1165,TRUE,2090,925,Radiant
4304f1578f16fd4ec626736e09efac31,160,FALSE,1936,1776,Dire
21681cc60a5020de25ecb70e40a22d3a,2604,TRUE,3936,1332,Radiant
40a7d04211c073ef884d60ea400c4114,705,TRUE,2840,2135,Dire
5a8297d0811b82c66548548b7cfeb4c0,989,TRUE,1881,892,Radiant
015b8fc01fff943462b486f4a108f946,960,TRUE,1743,783,Radiant
9ad0ba3be506e935c78a6b67250b6300,5,FALSE,3741,3736,Radiant
a65b1eaf365b8bd7455160fc68351d1f,526,TRUE,2958,2432,Dire
16788a4ccdc1fe11108a4cedd9f3b3bf,1813,FALSE,2640,827,Dire
9f79bac2d15342f642dfa1a54de1de55,1462,TRUE,1546,84,
15b1e821624defa6a5cff30bbe53817a,680,TRUE,2783,2103,Radiant
f72f0dcd054b9c6b9e850c08412cbc8f,1419,TRUE,1822,403,Radiant
aef3d95601ff9681db19ead5ce3bd24e,649,TRUE,1591,942,
11290e0361f82eedeedf0426179345dc,1426,TRUE,2171,745,Radiant
857a1a911d84cc92b858fc8d0088d151,848,TRUE,1334,486,
ae4aa75f3b262d3d246a1afe4dee638a,1421,TRUE,1945,524,
7689f2d60d24d4fd8a960087c776b621,12,TRUE,1202,1190,
6ad18aa2fa069eee0b0a61deda6a2877,1342,TRUE,2366,1024,Radiant
1394d9d618d2567969dbe9644ff49552,657,FALSE,2219,1562,Radiant
dc78649c36227bf6eb70613576e2f332,726,FALSE,2098,1372,
909ae56ec3ab1f82fcbd73998b82f558,790,FALSE,2105,1315,Dire
8d9124cb5e758b4561dd9777046077cb,1387,TRUE,1697,310,Radiant
4acabcfa1c2d102ee8c556f74b6a3fc0,3,TRUE,1861,1858,Radiant
8f1ad59dce1c8db1c5fc8d84cf97a882,1017,TRUE,1806,789,Dire
224c7b5a9a76ae20e2027ff786d9ed72,2518,TRUE,3183,665,Radiant
93166b9447bbb6dd3aa4b1a228878d07,940,FALSE,1857,917,Dire
650b7dafbbbcd920aa5aeb0c8e2bfb15,2172,FALSE,2544,372,Dire
c55f720974ae17310bedf77416b6c808,3397,FALSE,4051,654,Dire
1b044bc203b1c0867bd31c272d3c2562,485,TRUE,1281,796,
2dd2d2aa107c5744c0c6d537aad03d5a,601,TRUE,2661,2060,Radiant
adb889311f49e966e519cac429652dbc,2117,FALSE,2455,338,
483d6d67d5c13ff31e4871adb6d2f373,729,FALSE,1689,960,
ecdc9480a7055a49e4ccae7ff74455f2,1242,FALSE,2537,1295,Dire
09c5f29d5ac1818a9161404a2c41e91c,766,FALSE,1389,623,
83e55c9d22d5619ac3ed77677a139639,1346,TRUE,1972,626,Radiant
d0f1f589a46d860c14e4b8fc01cfa6fe,928,TRUE,1206,278,
adff2f2a51edc99e7f9f05d64551179a,701,TRUE,4476,3775,Radiant
a5bba2df809da52fbb1862b781b46509,1620,FALSE,2036,416,
971d2b4bb13c29094808eea5c0d5cc5c,2025,TRUE,3271,1246,Dire
8c69dd90d5e95a84098aba247352d49f,2767,TRUE,3725,958,Radiant
7496706fb68eb1e5c722c1c5e5c55109,418,FALSE,3051,2633,Dire
a5547f72635c89319d47abc401a7e933,824,FALSE,2622,1798,Dire
e48da14d64a3ed6f6a7c8def768ed3d8,878,FALSE,1770,892,Dire
83cfc266cb9b913d3a86f1db9c0a8914,2226,FALSE,2906,680,Dire
1e0cdbd581a39872afaba0c7df871996,866,TRUE,1979,1113,Dire
991a75c0914702829c64317aa663ae07,1616,TRUE,2401,785,
e8bf239963baa3f499b2f132ba2cbe86,220,TRUE,1131,911,Radiant
01e6c84e0b181e322ed889b0b907e427,607,TRUE,1775,1168,
18e73eb1548db415086755e2e81620b0,231,TRUE,2110,1879,
104f5f16051a1af1a632ac93a9db734a,381,FALSE,1995,1614,Radiant
28645ac4bc98b4f799c15bed79dbe783,2610,TRUE,2858,248,
06113cd00d94841278e4c7e8341bff30,997,FALSE,1615,618,
0643fa1aae2b56bb1e9292b099bce22d,2151,FALSE,2514,363,Dire
4401911d5f5ba1b866f6f206502893ed,1955,TRUE,2552,597,Radiant
4c5e533f0c39b49946ae09bc7c27ffd8,2131,FALSE,2631,500,Dire
e3983b0ded50932accd66388a9258353,1352,FALSE,1603,251,
cbb0a2ea36c32ffceaf12a76901a0dd0,1630,TRUE,2019,389,Radiant
a69a66e89e0eb552ea26f07c5c36206c,2027,TRUE,3502,1475,Radiant
e4c638c3b4d13be9d416ea9708cf256b,2556,TRUE,3812,1256,Dire
070e8fb07e01161d0d5014b9f4cb7385,1057,FALSE,3414,2357,Dire
c31c231f8075479d313adb11d515ee42,1600,TRUE,2044,444,Radiant
81fd6bc68745f73e0f7e1b0644dba01d,665,FALSE,2786,2121,Radiant
d244c1e7c8b3aeae8026a504648927b5,249,FALSE,1657,1408,
e94f5988b0c622821fa621e6091ce99e,278,FALSE,1914,1636,Dire
7fa000f125d0e6dc4a780d2becbd78a1,1517,FALSE,2314,797,Dire
c98b94fde38f64b147a67084e3371973,152,TRUE,1305,1153,
c52068d01ac337bdfc52c849f430b5b3,616,TRUE,1991,1375,Radiant
5d647d8e77329797a27b24ed42778dab,1301,FALSE,1902,601,
61c85ba7d01f91bcacf14a9452e1423b,562,FALSE,2457,1895,Dire
0ee72c05343db195177adabb2fa2685b,1090,FALSE,1841,751,Dire
1cd1635fb8d498c63243b08b4db2ae93,194,TRUE,1742,1548,Radiant
edcd8c3403101f7bbf47fcad1c6ac9b9,815,FALSE,1131,316,
465264fb32bcb7952a68b42069fa783d,1338,FALSE,3214,1876,Dire
de56f5ef64da93a54ca62b92831cd9ae,36,TRUE,1535,1499,
227c60fedcea017cc3c867cd7af56b2b,1027,TRUE,2195,1168,
50ad8147dabc6c4c1cbc57fa9564a62f,261,FALSE,2445,2184,Dire
bed324743cd00aee78d789c2dfd371ed,229,TRUE,2954,2725,Dire
89b7e94272550ee7aebd191aa90e6871,953,FALSE,1523,570,Radiant
550d65f3691b832f88d1e34930693f21,515,TRUE,1093,578,Radiant
c6600d1704cccf4859b538d4526a1f2d,1860,FALSE,2889,1029,Dire
7e1d4216f586f60d74211c7a1ae9ac93,604,TRUE,1630,1026,Radiant
187e38b26509dd30a446eee2660744b4,3270,FALSE,3960,690,Radiant
7a4ad9afb3a6868f4d9f740221c7b123,1183,TRUE,1925,742,Radiant
8eb802e4821912e7071a7520251a250d,1741,TRUE,2515,774,Radiant
e70f1a0288dfbf067e3adc70c59cd519,2084,FALSE,2604,520,
afae3064de86b80b2ba0c3cc9503020d,974,TRUE,4093,3119,Radiant
eeeca0453c31ca9be426d0cc0ec28c18,1268,FALSE,1861,593,Dire
6d0d23beaf2d33d0262475f5b463283c,3254,FALSE,4027,773,
36845cb531c438c2a9112991788a671d,2624,FALSE,2833,209,
23c9fea22f8f0af6e631e97b081a8e54,782,FALSE,1858,1076,Dire
db7433ee2d1b0e5d0d3a1687c8aa3d2d,1439,TRUE,1600,161,
f4ddaaecb4b4ea942ac69f6eb7576227,2976,TRUE,3047,71,
a7de465a6795f7d5e9ca8d294b539696,2247,FALSE,2405,158,
11a2c7eec4bf8202e2d4271e80c6af7a,948,TRUE,2822,1874,Radiant
30401f8c23a294671b205227c05b06f1,1180,TRUE,1663,483,
5b7936d53895c1812722f0b6591fbf6f,1939,TRUE,3866,1927,Dire
628890b431fcc5ecbeed23dc546d1815,92,TRUE,1373,1281,
7b98b487a5c89fc19d0e31dfdb671f93,1239,TRUE,2511,1272,Radiant
c1af70948a9e33f080777dafc3570209,275,FALSE,1599,1324,Dire
ab5e349c8741949460e2583140dc5dae,340,TRUE,3802,3462,Radiant
f7e1e85e4b77ed1f14020e9a6168aba2,400,TRUE,2387,1987,Radiant
db143fcdfa6e42a3f5a676c07827f77c,1608,FALSE,1881,273,
0591c0b2f330996c8ac871d689707bc6,677,TRUE,2535,1858,Radiant
1d415cffa71eba15a07d0472271fe258,70,TRUE,1586,1516,
641b99af85ae75a34365465e99e41484,33,FALSE,2149,2116,Radiant
3a9ae8abc355bed28661f76e2c8e6e90,1070,FALSE,1782,712,Radiant
0c81ff690403393611f06360d9449677,1061,TRUE,2558,1497,Radiant
d7c994549441b8cbc7bcbe33e05e60f9,455,FALSE,2439,1984,Dire
63bc225f5e5245baa8e6ed474d859fd9,2268,FALSE,2360,92,
c64f065af95030bd334e3834172e3976,1743,TRUE,1808,65,
b37a1b41229e347b0c763ca7b3be15e1,1374,TRUE,2025,651,Dire
7654858f64238a1b56a2f14c98fda127,183,TRUE,2172,1989,Radiant
ea95549a64974210d6bc7669d08d58d7,1543,TRUE,2363,820,Radiant
b80743731ad0e37795370b29d93716f0,713,TRUE,1231,518,Radiant
a9d0b7325ff2353ddea0f9ccc0e0bbc3,958,FALSE,2467,1509,Dire
2d7e07629b4be459c874210bcc6bd450,914,FALSE,1330,416,
0ff23ed3c1a17f4c774821b8307898c3,307,TRUE,2256,1949,Dire
224471a3dcbb7c3a56e438393fc41332,322,TRUE,923,601,
5cde39aeeaf9440fe3d1870b5fdbdeed,975,TRUE,1088,113,
affab4fb48cc259f1bca978d3119fbf4,409,FALSE,1608,1199,Dire
798930213d16c6c2f0eeb703743b2411,128,FALSE,2026,1898,Dire
68b36f8707cd9a5d262f1d4105bf7816,481,FALSE,1885,1404,
4c566f707a7f8e349936c5d4e3deea0d,557,TRUE,3010,2453,Dire
4bab2ea86f618911f1869b0de9aaf7a3,2045,FALSE,2549,504,
72576ae04ba7478336c2acad10d73b38,1021,FALSE,1400,379,
5d8d68ca3d8a59a85ed435da8a94629b,699,TRUE,2403,1704,Radiant
9e284cb71e94f1e74cdb183a05ce0991,1734,FALSE,2658,924,
4c2f29bc28dc07cf46a19b880adca3ab,1672,FALSE,1821,149,
5dc5ae801bcd0669924a01c815ba2218,912,FALSE,2062,1150,Dire
7dda84d6717c5a23264e1ba8ec731b00,2614,TRUE,5288,2674,Radiant
9a565b501d06914ff1185c91d240a528,62,FALSE,2821,2759,Radiant
b1555407dbe9add39a8f4d3e03610bad,2750,FALSE,2952,202,Dire
0cbdb9a150319f688d1c173acbfbfc83,823,TRUE,1783,960,
29556aa9b24c488076bb1048bb4790de,1725,TRUE,2512,787,
4de63e7ecec84b439c7f091f2f82a219,2226,FALSE,2868,642,Radiant
7e80a15454b1a3ab7573fcbbd5e830da,2213,FALSE,3021,808,Dire
efa527c4724145779a2c9e898c978466,2080,FALSE,2562,482,Dire
e88cd35737778d84168ac7c337bd106d,1770,FALSE,1838,68,
72589ebe9a760c0cb32d7ff17094864e,1502,FALSE,1646,144,
1e82bd2b8492662d3e8395d0d5cf40ae,1686,TRUE,3304,1618,Radiant
cbf08f56271b079769d6ddf98256f149,1120,FALSE,3639,2519,Dire
82f5540d2dd874b1b79d1d44b6130eff,120,TRUE,2479,2359,Dire
0cbdbd0dc59764c651311aadd229ae2f,1834,FALSE,2292,458,
3167a6f585d19fe5da7583c9aa9ee786,2462,TRUE,2986,524,
1f819c223d6c5e7b38e1230071c2cff2,1541,TRUE,3450,1909,Radiant
491d6320a701f0afda72bb15d1165e02,1041,FALSE,2997,1956,Dire
2e240c4ce84a0f5c0d668fe5ec150ab6,871,FALSE,2149,1278,Dire
0fc868f09cb87d634fe1ced635ff4dd2,16,FALSE,1994,1978,Dire
a2847cc75295f3b2e0aefa2eeed86306,672,TRUE,995,323,
3730ce827bc145e24cd3eacba6f4d880,857,FALSE,1219,362,Dire
54acf0afd71065505d223f153c5f579c,1050,FALSE,1695,645,Dire
e8b00dd08cbfd1512828914bc1312e1f,208,FALSE,2058,1850,Dire
b119d61b36355e42627e3a8aa2531718,1318,TRUE,1964,646,
3f93783026c90a3b982be2e416950dfb,1016,TRUE,1501,485,
692f3b5e90c2f1cdf3ec7cf14d7c3fba,1047,FALSE,1723,676,Dire
0292eb7f9995c917f7c367453154c59b,132,FALSE,2468,2336,
b49af46bb3caf1e97660be3494a34db3,245,TRUE,1982,1737,Radiant
1da47a30f20a6370c1256af52f9aaf1f,792,FALSE,1620,828,
d92ab87451657006fc74b92c3e619f8f,2258,TRUE,2592,334,
3e8759441e3448bdb9ac92be1a67392a,2151,TRUE,3126,975,Radiant
62c05e89c7f91ae07f4e20242a806e79,1481,TRUE,3129,1648,Radiant
d593ee8fe297696eb9c10d2498edd3d9,95,TRUE,2071,1976,Dire
366a1bea36e1ee5f38eb08fefc4804f7,1158,TRUE,1564,406,Radiant
8e35a1637f8b907151ae190d1157cee8,92,FALSE,1890,1798,
dc6c54e07085cb4786113a64ba1ee309,1751,FALSE,1868,117,
e07eac000834467898d992911ba87c2c,279,FALSE,2288,2009,Dire
10bb42cece0ca0fbd30098905315e8a9,884,TRUE,2939,2055,Radiant
208bf82684a6435d5ba9ba1585e83e10,178,FALSE,1423,1245,
474eb8e04bd88649734de0d87b109df4,1779,TRUE,2493,714,Radiant
19b1fe5acf8d2d3adf0fcfab78b3096a,1038,FALSE,2430,1392,Radiant
03e86e7f0d833383017179ef89b05ff9,141,FALSE,1953,1812,
786b7197e627fea8ad6e89a319c2e034,1065,TRUE,2711,1646,
5678394fa3e0e9d16c50a4d571a0031e,1951,TRUE,2048,97,
908b9d2ad9a84e71b834d26d8105c01e,1105,TRUE,2225,1120,
23b12873a2784cc46a5886895f49d6f2,543,FALSE,2053,1510,Dire
5bda14aed88450af15ea52220506900c,385,TRUE,3154,2769,Dire
9cbbc1f616cbe360670742df0e2eb12e,613,TRUE,1129,516,Radiant
fca6b6f9d022febdc20ca2b2dac51680,1513,TRUE,1617,104,
1d50f748e38ef0b4311a5b2c5beb5d15,720,TRUE,4373,3653,Dire
4a979b944aa24b18c3f8f98b3259dcd7,1265,TRUE,2008,743,Radiant
50da2b8a80a84b18dc6418bf402e7c1e,1665,FALSE,3843,2178,Dire
b7c942282807def16fb32d586d265ed5,987,FALSE,3260,2273,Dire
343f50d53bc1be6539a5b77fcc3e0978,607,TRUE,1127,520,
42852991c293564a1c541d4fa28b72a0,1484,FALSE,1691,207,
0255bb3a5fcd514fee4e5b6df791748c,1187,TRUE,2239,1052,Radiant
5e925fa9278cee5930ea64120d7e5c4b,1259,FALSE,3148,1889,
7c15fb4319d43135f6f376f8dd8d5953,494,FALSE,2271,1777,Radiant
0665d3051a4843b974299669d2970e5f,2275,TRUE,3091,816,Dire
44bcf1f22d076abc7531fa8a3020bb3c,521,FALSE,2568,2047,Dire
a873b2b101de08a4f7e972299a41cff6,788,TRUE,1149,361,Radiant
9b57ff5be2863ad2a6e201ad24d0409a,158,TRUE,1752,1594,
0aeaffd45f5ed023b0089199e2f5bb03,171,FALSE,1900,1729,
0375de690e3f74b24d0f38015b76b183,594,FALSE,1800,1206,
098012b6edf66511692ea51f20dc29f6,2667,TRUE,3566,899,Radiant
c4968dbf7d8b612ed64f969e14af6df0,1847,FALSE,3514,1667,Dire
44eed2156b1e11e77167ea0851289f6d,1773,FALSE,2443,670,
366dedf44004214971442468d253ee2d,1233,TRUE,2081,848,Radiant
331fd781e3fa8b71f2d44b6e51584b00,351,TRUE,2589,2238,Radiant
60937f3d707bb65baf8296a644e6c34b,2329,TRUE,2799,470,
cbb7f3624ba7a12e8b1e193eed6914f7,2019,TRUE,2185,166,Radiant
98348c5c99aa056de32f7f1057204b72,3327,FALSE,3380,53,
38104e11528e791ef30fad9dde3d5141,1585,TRUE,3171,1586,Dire
6f94cbb0a58ec3721c7393a7a35f3e50,2064,FALSE,2353,289,
9b10536c06ab0e713e93a619359b93a0,1122,TRUE,1846,724,
9335d1fe4192e166680023814bbf6256,123,FALSE,2055,1932,Dire
d49a4f2a3fab26f7dba138509fe30a6f,1635,FALSE,2602,967,Radiant
a6fc2cb5a7957a543e32b22eade53f5f,3063,FALSE,3437,374,Dire
6edeeaa11effccdae05c86fcb857d58c,737,TRUE,2093,1356,Radiant
f5b725b721c8cbc01bc65710ce219ddb,1615,TRUE,2623,1008,Radiant
fae7e24284c4e6fa7f7a8f0188fdaf40,1364,TRUE,2890,1526,Radiant
525ddbbd919226abf0aadcc7e559b901,809,TRUE,1371,562,
011dc4e25b15d2619b0fef9d27b75cc8,750,FALSE,3044,2294,Radiant
e7ce7db8e5f3b20ed1566832c0eee783,211,FALSE,2454,2243,Radiant
5e8d91eb5b9742707a24e280d4b08dd0,654,FALSE,2575,1921,Dire
c504c0fa4d771a3ffa16498793921cba,3331,FALSE,4691,1360,Radiant
9f63103c6d09e5f6ecf50b925824d8e4,1407,FALSE,2692,1285,Dire
2ee45c3f9977e3df8bbe73f7e5cfb6a6,2340,TRUE,2740,400,Radiant
129f32d9865d25435ac4263489fc259c,253,FALSE,1453,1200,Dire
9ba8b7f3c1964429a3fc0d81c590299e,2164,TRUE,2842,678,Dire
ec94c85f174d66cbceb9061e75075b6b,888,TRUE,2786,1898,Radiant
e95c32f7087b0f1cfaba256d5d4cef5b,2274,FALSE,2346,72,
b1f506a1ab1a67393afab9c138292aea,1753,TRUE,2108,355,Radiant
c6134e3042b21d554abbafb5de6f092e,397,TRUE,1157,760,
d87af713a0a9e295e7e1098effbe3b33,608,FALSE,1903,1295,
6fb1f32a18f8bf24502b092c61dc0f85,655,TRUE,3748,3093,Radiant
727b3f6fae1423c537d46060b0e8e0be,1143,FALSE,2057,914,
2b237680b2fa091dc7cc2e44c292f31b,1293,TRUE,1916,623,Radiant
06788ddcf5c46e25d081d2ae83c1d4e4,667,FALSE,3432,2765,Radiant
4f7cd4bb6a45b9c3948c5813c6273309,3154,TRUE,3771,617,
27356dd7fbae85bcfd1ed09b230843c3,1284,FALSE,2679,1395,Dire
c306f44fd01f387f2cd1a870c9f9112a,1043,TRUE,1393,350,
f5030a5bac78289630f389182ea1f4a2,1776,FALSE,2733,957,Dire
80aaf37991f62ab72473b23588e5c327,632,TRUE,2596,1964,Radiant
b4d43201b9932d2bfa65247239cfe894,2860,FALSE,3634,774,Radiant
ef2b5cb87ffcccb4fb82c9e8c1d7430a,2427,FALSE,2522,95,
b03fad0233726696672798d890c9f06b,787,TRUE,1747,960,Dire
363208fcfe9655e6025d1c28ce8c12da,1436,FALSE,4728,3292,Dire
abde3ec3980474079b73385c5f51a72f,1618,FALSE,1790,172,
c4de7679cf246191c0d0011412a56fe2,330,TRUE,1768,1438,Radiant
a0679c1248bafbe57bd0e744b5e4add7,506,TRUE,2780,2274,Dire
146584ca76727ce5346dc977cafc31bb,2038,TRUE,2210,172,
45fd2e2271a714cdb810792f75173d41,1746,TRUE,2033,287,
7f1e87f7c3d8958692cf61085988c3a0,2063,TRUE,2251,188,
bd8c73caab98869c913a7dda2a08d2b7,916,FALSE,1288,372,
209fca197e0e04dbe8be0a402f9a32c1,359,FALSE,2648,2289,Dire
6e6cfc8e63d742cb211870e3bc9c91bb,2140,TRUE,2593,453,
e04b7dc0a10d4f0e708308869c542ad8,2166,FALSE,2393,227,Dire
5ad654ee3cb5699adf6b1f9094c84d17,64,FALSE,3397,3333,Radiant
e9884a13edfebbb7b0797b0ec2b64e7b,1424,TRUE,2405,981,
30da590e99c183af9bca785877490a85,2473,TRUE,2573,100,
ae618b1519e6fc5687b0fd58337867f2,1495,TRUE,2042,547,
8c5ce972b9ba138d014202fedcdd05ca,539,FALSE,1511,972,
ed73aa73ac4b2f9b7a201da9c2de6bd0,1665,TRUE,5434,3769,Radiant
0c0888b998c6512e0f485f7e12686b27,1846,FALSE,3945,2099,Radiant
fd218fd497d2a4e2011663cd5b5d66d1,77,FALSE,3361,3284,Radiant
068fdb88c0a019ee7ab0143a1879c8b9,600,TRUE,1450,850,
0ee16d23caf5a28c3ca28c965419c32e,197,TRUE,2723,2526,Radiant
3aba93385c73e28dc956df51d7d191e9,1714,FALSE,2523,809,
3b7e394f82f8e51c5fff31dbacfbadd5,1416,TRUE,1602,186,
ad83e2a6767030b2c2fceae8c1de95a8,1060,TRUE,2067,1007,Radiant
bd5b324f06e0b0e02a6dbf4cd3a66764,66,TRUE,2189,2123,Radiant
f1d8c642adfb7da2355626f9cbf55bc0,1092,TRUE,1371,279,Radiant
9b5f23770182951979a1662a2a9de862,69,TRUE,2190,2121,Radiant
7dc3288a4eb3b31cce5089221a0f6072,474,TRUE,2612,2138,Radiant
6dcaaf9e34aa639832cca1dfcb515ff8,992,FALSE,2201,1209,
a9a4ad7a2e1c2034a3925b59aaa348f3,980,FALSE,2788,1808,Radiant
578129751f52a259b5eefee163b7aa37,1202,TRUE,1595,393,Radiant
7b043423475e864360461f9db5a76ffa,1773,TRUE,1940,167,
3af622a77835c5b500ef87749e4ac569,718,TRUE,2195,1477,
93f9bd54d9f6577a5cd7f110fb882cb9,699,TRUE,1578,879,Radiant
b6d3e1c3d4bbdea4bff899bad181e174,1456,TRUE,2181,725,Radiant
54ec51d0ad388cb0c5238e93f1e5633e,878,FALSE,2169,1291,Radiant
80c2330166b1176aac7cf07c777e5d9e,2704,TRUE,2962,258,Dire
438754fc383b6f0cc4d88608d73fa29d,291,FALSE,3875,3584,Radiant
f6d731174ec5a61add454ad5e5a330a5,1531,FALSE,2280,749,Dire
e4be707a035cb2853a8c9dc3bede0336,1373,TRUE,1430,57,
74e377b304035f7e2936e7655e73ec9d,2011,FALSE,3139,1128,Dire
ab590564e6608198f51c53c025e459d0,657,TRUE,1483,826,Radiant
f488f3d3c6d892aa8a7b758a0933d996,655,FALSE,3237,2582,Dire
ab4c7c4095aa2b8e87f5aa0907f5acbe,1783,FALSE,3567,1784,Dire
6a5690f7eb3da8af5fc591934d06cef0,1065,FALSE,3548,2483,Radiant
ff652f51109de538525267f2331d72d0,473,FALSE,1269,796,Dire
9f5e63249197fb63d8a4bd63f2eb3501,93,TRUE,1948,1855,Radiant
cb5522e4b64421892dbed4784dd6078b,1912,FALSE,3210,1298,Radiant
0d9c5583cbf4a6f21f37a406b728a320,1783,FALSE,2447,664,
6344cf043c17c4edf1965c231d0b2a72,174,TRUE,3646,3472,Dire
c42248d146f254bb11ed69d6b6cc1efc,1270,TRUE,1611,341,Radiant
0d2cc86584955dd0d5b752eb8fa52299,619,TRUE,1997,1378,Radiant
f1a3192a0011b8999b879a1833806f89,845,FALSE,2139,1294,Dire
76886dfbfe807984313f29f41d30926a,647,TRUE,1572,925,
08568acd542fcc3703548ebc9267d553,2219,TRUE,2916,697,Radiant
b1d5f2992f138ea625c49ffc7a67bb96,996,FALSE,1731,735,Dire
fd0d7fd827098b2c9a4b738068256913,858,TRUE,2770,1912,Dire
3b97c9946c18990d944d9e0898a8e25f,143,TRUE,1592,1449,Radiant
ced53189a021807717deb89bf87870e8,1149,TRUE,1766,617,
e6f0babac772f362a4d63118928e09a1,1288,TRUE,2413,1125,Radiant
24e4c0a2d229aaa0dec3fd761e997fef,1804,TRUE,3601,1797,Dire
e19c51a9f311a7d98ce6f4a375547170,2317,TRUE,3423,1106,Dire
f6f36ac232e9104d78aca072fe1779d1,256,TRUE,1748,1492,Radiant
5330419365a3370082a816414e8fab0b,829,FALSE,3504,2675,Dire
0e8bf6dba9a258bf12ac794e73b3f9ac,603,FALSE,2178,1575,Dire
5fcec57824cf25fda883057109aa060f,303,FALSE,2662,2359,Dire
c0c22529720df67509d5757200bfdaba,1804,TRUE,2819,1015,Dire
d9beb134abaf00f1d7ccc2a8628dea5b,751,TRUE,2307,1556,Radiant
410feb9aec108702298e8805ccae7b7e,2083,FALSE,2195,112,
378211ecb57e7a95fa00077811b1dad2,2391,TRUE,2914,523,
ea0a079f1d485e104d3438a6e7545dd2,1290,FALSE,2359,1069,
e89c27df6db7ff075d2f92364400334e,1018,FALSE,1738,720,
44e4a5121b8c1daa59a1774baa222fa7,1042,FALSE,4016,2974,Dire
6b42afa325a57c3c91546296b44eb63d,626,TRUE,1886,1260,
e8266144f92e9a4f8749f2fcae96bd53,2183,TRUE,3112,929,Radiant
be50d02dd0ee74f65236d1ae2e8b2ca7,562,TRUE,2015,1453,Radiant
20df83598b2d9374026672db45dcc9ab,1906,FALSE,3100,1194,Radiant
2995a94ea4859c121fa7bc92184b6f28,889,FALSE,2441,1552,Dire
62c4b2ee17942a89df909c240b5fcdd0,152,FALSE,2147,1995,
e59b25d5a4cd6bb544214fc63141077b,774,TRUE,3632,2858,Dire
ed22ba4602072bad0588df8418a554c1,1396,TRUE,2212,816,Radiant
a12f78373ce5e19850c04d38ab760c2c,1274,FALSE,1660,386,
ed6184c93a18e557df4098f6585f361f,1428,FALSE,2467,1039,Dire
fffeb99cb05fea90d18bf86f019fc39b,555,TRUE,2244,1689,Radiant
26085edfb5eb9c739dfa553c106f5659,2284,FALSE,2684,400,
8fd851a63b8d9e4eb74078e8ad402e9a,1807,FALSE,2471,664,Dire
02149ac04eabd569d94b154694d1e0d4,235,FALSE,1897,1662,Dire
1194f629247b8c3b2b0899bfb9d56c43,1881,TRUE,2455,574,Radiant
f27a2a8d68d5c3a74986871566d21da1,1255,FALSE,2416,1161,Dire
4f2372633bdb49b8dbd9b87ab7172e97,228,FALSE,1965,1737,Dire
33f724d7070e10b0e0d7580ff23ba580,267,FALSE,2333,2066,Dire
5032a9005876870be657a7245cc1d23f,477,FALSE,2182,1705,Radiant
74e32fc7a760b0da23d724e8e8783c53,896,TRUE,3067,2171,Radiant
88eeec605f38ecf7bb7a2f5781c0ff51,1931,TRUE,3008,1077,Dire
8938be0efd50690394cb61657e9aee70,2582,TRUE,3075,493,Radiant
b2997b218d327e98f793d39aecdfd103,1899,TRUE,2100,201,Radiant
7884596448c11affbb67547c1cb87d36,1805,TRUE,1881,76,
bb5e21b179b997670e25ad6805af88e7,1355,FALSE,2157,802,Dire
b4fcea244bb35e17df39fa15547274d7,421,TRUE,2184,1763,Radiant
137c7614e2e253370c6b851b934a0f9f,66,TRUE,918,852,Radiant
7866b51c4c5096f7f45f1493c0a62a6a,1517,TRUE,3879,2362,Dire
95ec760276311e7df162563c768814db,1135,TRUE,1272,137,
779749a489fc5901670553ae232f157f,1640,FALSE,1904,264,
f173568ae53467cbab56ec182bf84a17,564,TRUE,1098,534,
244c22e2c9de7b21609a9d182e5efc85,965,FALSE,2663,1698,Dire
04a9fd344e7654c85f95beff3ebe441f,1712,FALSE,2163,451,Dire
542d96a9e4cc2edbffe7e248ceae8659,119,FALSE,2923,2804,Dire
5437d075460348ca96cdc6539a6c8836,1074,FALSE,1302,228,
c10bcbb496b6febfdb32d25b183591a8,1505,FALSE,2888,1383,Radiant
4c26f3d55a6d1f047e4d780b7f86cde2,1378,TRUE,1870,492,Radiant
b6d2a37e56f9c75048975c7097d8e72d,892,TRUE,3031,2139,Dire
c237fc62f2bcc8982cbb07f97f723181,1675,FALSE,2216,541,Dire
036cdad2a352d91a9443f99507c35a61,593,FALSE,3108,2515,Dire
1b241fbaaa69d9b123344320ca695403,2218,FALSE,2383,165,
3ba853f85df95561e272a1ab26876c1f,2200,FALSE,2466,266,
afba0104ccef3a2baec07c105c52d2b1,1382,FALSE,2207,825,Dire
dad76d07fc9525c7634c88c8abbef81e,813,FALSE,2354,1541,
7dd1a8bec9a6bfd26caa86b8ba22c6d1,57,FALSE,1737,1680,Dire
e88693f53095ccd0c44b8ef225eabe7b,2298,FALSE,2463,165,Radiant
ba3b25e74e63db8dfd8bddefa897d991,1064,FALSE,2395,1331,Dire
6508a42e722cb04c6cd3253af11d2868,1506,FALSE,1752,246,
0e48319bca21cf97cf93f8cb93a1b80e,725,FALSE,2228,1503,
b00a62cdeaaad878e2d03cf87b4a3e93,1563,FALSE,2152,589,Dire
b3cd6291f08ab5e501954fbefd6b7899,2388,FALSE,2927,539,Dire
abccf05689741bcdf00b93c3ed1e41a4,1917,FALSE,2807,890,Dire
2f5698873e4d2bf1830066ab776e324e,713,TRUE,2162,1449,Radiant
260ed06578fa97f2d53c2fdfabc4e372,420,TRUE,2762,2342,Dire
6f05eedcbe030f0abde043f89303c02a,370,TRUE,2387,2017,Radiant
f04db19c8d0efde1b94cca31608c0eb3,600,FALSE,1794,1194,Dire
5ea797c8dc9eeb9da29afcb0dd25a250,2502,FALSE,3909,1407,Dire
e6e6e242ff1cf57bf2c9ad2db5d2815f,120,TRUE,1486,1366,
356a480d014b42ab0af7ee982d183051,2716,FALSE,3937,1221,Radiant
f4fee9d87173cc76490b82cd199a0b62,892,TRUE,2933,2041,Radiant
e53b658dbe715aefeaa08a5cb4868d31,475,TRUE,2492,2017,Radiant
80aa2e1ccd2c17ef708ea02c36d07d4e,1687,FALSE,4566,2879,Dire
5783e2fd8d38f278dcaf0a86378c3f5d,201,FALSE,1996,1795,Dire
f99007878acd878ce09bebad7a77d9d0,1098,TRUE,2800,1702,Radiant
9289eaa444dd58df96a4d65ddcf44326,327,FALSE,2099,1772,
a7d8867f985004125554810ad02bfeff,1636,TRUE,3431,1795,Dire
bcda0c9424ff85d0fd8d01c9b7c08567,174,FALSE,2899,2725,Radiant
3f5494fc49a91e4125dd5f08bc0ab69e,245,TRUE,1862,1617,
8e877df522bcef951d2aa62803cdf06a,1304,FALSE,2680,1376,Dire
781817dd05e9a1d39f9302d4f378ea0b,1687,TRUE,1983,296,
aa6496ac1fca8904aad24b3a486210f2,2049,TRUE,2818,769,Radiant
39ecd753079f8226aa7186a6078d2dd0,10,TRUE,3307,3297,Radiant
47850672a5dbe39bb88236ae6471331a,1364,FALSE,1587,223,Dire
510214c7e749b52666ec68c74bf79863,486,FALSE,1817,1331,Dire
00afcc30ffc24fe03e483bc09da7984f,613,TRUE,2260,1647,
a463a6e85b827629c4c7fe4a7ac37952,1679,FALSE,2322,643,Dire
60ffc80b6dbf861c1dc719384685c9cb,1351,TRUE,2551,1200,Radiant
78f414c0f20a5bf27eb3b2e83851c894,648,FALSE,1636,988,
037cef9ef3389aad2325d671429acd98,872,FALSE,2270,1398,Dire
4061ad0ef1bce91d8209bd89adff9b67,517,FALSE,1645,1128,
d6ad2a8761d0b6d54a35c25a87d656fa,193,TRUE,2163,1970,Radiant
144feeba5da7ef1dfca3e9d31fe93619,717,TRUE,2185,1468,Radiant
757c6ffcdfb61a128155494faa8ecf76,738,FALSE,2195,1457,Dire
5776cbfdf86e17f0b7b09ea4e647a64d,2288,TRUE,2349,61,
4c6b5e94605c0598896fd89a6957e8d2,379,FALSE,2212,1833,Radiant
2286661d1ba6a5d5eda1be1617c33746,179,FALSE,1499,1320,Dire
76c73900e5b3a75859009fa9b4080b67,513,TRUE,1012,499,
0930b55d10d2b1e8888c62b4ff5a41bf,2661,FALSE,2910,249,
0d245ed639331fcce11cd38138b23c5e,1494,FALSE,1928,434,
c6278aa7e660ef2a5c2b79c03207ec86,584,TRUE,1043,459,Radiant
66db9bed51ede735101d3f52a99de03d,76,TRUE,1589,1513,Radiant
aa20f885856f84413e434b77ea4e7d0e,688,FALSE,3197,2509,Radiant
578628a17ad233c4473f65fa497b3d8d,1249,TRUE,1857,608,
0bbb80a138bfc9969473f9c88fe8018b,1178,TRUE,1284,106,
4f7fc3028b58f1e75bbe9b9d077593e9,1265,TRUE,1550,285,Radiant
075d532bf539b7496060e52137c3cd24,646,FALSE,2037,1391,
391862529e1ff5cfd71fa78a04c98893,1566,FALSE,2274,708,
e46f4de5178c3d78c6db19675c05ea47,130,TRUE,2324,2194,Radiant
932dc38d84da36ec2204af9ee18598fd,1146,TRUE,2764,1618,Radiant
0d73bd5782c5e55885ab46c017e5a7f2,72,FALSE,1866,1794,
5dd2a263cefa06481838a6f9a6e69ffd,1467,TRUE,2023,556,
5bfba1cd83408001b983cd08f1e177d9,634,FALSE,3146,2512,Dire
fb6fcbf4917b65734e4dfe95f792c303,675,FALSE,1086,411,
7cacbad0462e64910211a295194fa2ec,746,FALSE,1755,1009,
53c9b4838422d223397193b23afb80cb,1794,TRUE,2198,404,
00692195d91981d7bc45176704eff44d,460,TRUE,2854,2394,Dire
1d8f550bbe850c2b056e30f7fb4d5b28,935,TRUE,2155,1220,Radiant
11b57b5acd2e5e350262da3e1c0761de,2410,FALSE,2554,144,
538e3a265370297f0adb69b761309cdb,1040,FALSE,1283,243,
1fb5f9e78101059b74d4664b5d1011ff,1638,FALSE,2208,570,
4a540b0502e6843fbdcd06ecc07ba1f4,3284,FALSE,3387,103,
83e929ac02d79dc5fbeb29c4db2e33da,386,TRUE,2163,1777,
fe62cc0f09cb9abf94fd72a696bc14c4,627,TRUE,2315,1688,
30cb93ba37354edc50e76ca092b1046e,1024,TRUE,2787,1763,Dire
3e48d43e084fbdf460dfc5b150e62511,814,TRUE,2571,1757,Radiant
269038240177d3e4094886499ea81f56,1346,FALSE,3191,1845,Dire
ab65ac5f5ecf835ef6554ab85991e9a8,779,FALSE,2203,1424,Radiant
df8d047041807b6d4e4583e874942cab,69,TRUE,2069,2000,Radiant
a2436f5d96027e2dba0e4f7c74e91603,2872,FALSE,3177,305,Dire
1e91dc3ca830c4648594684cf852bc79,1256,TRUE,1564,308,Radiant
1e72ca3d9439265c51cf1aab8a442172,1494,TRUE,2160,666,Radiant
ff0cab77f04b29f3cc7a4311ed35e1a0,567,FALSE,3070,2503,Dire
11361c2ed794385c7029c581e1547802,2088,FALSE,3095,1007,Dire
d055b035d8dbfaf88b3ff5a72216e6f7,1744,TRUE,2614,870,Dire
37c9c2b26537f7685e9e206a732be1de,2225,FALSE,2521,296,Dire
ba36665a2f02f8dfe75514c6f14fb124,941,TRUE,1414,473,
01ae021a8392afb995bbda894cd26ebc,1340,FALSE,3119,1779,Radiant
85875e2c908bdc31898318f70d01b18e,647,FALSE,2109,1462,Dire
7e6ae5b6d66270cb332610accef6f7f7,779,TRUE,2663,1884,Dire
a8808dbfa8bd1ad104cd23114303a9e3,1394,FALSE,2225,831,Dire
c49db1aab61ab51528dcdca47f61a861,1570,FALSE,1680,110,
2673890884ae4b77c6f47302cc753438,320,FALSE,2066,1746,
3d0cb0d9037cebaea7ca1865d5c9638b,854,FALSE,1419,565,Radiant
15b4dbe84a7554c5938e096277c476be,2975,TRUE,3041,66,
d72f46069e3d10302b5eda3f63cb5910,330,TRUE,2125,1795,Radiant
8ade53794687b30a52136387d7ca99c9,1353,TRUE,2096,743,
d0c2e0cf45e1d57260c7ff3e05ea3e8c,83,FALSE,1987,1904,Dire
fc40d5b99259d24f7d201b0a468e5d50,1957,FALSE,2729,772,Dire
7e0b753d1fa992c17cae3daff4cdc335,955,TRUE,1509,554,
c5f8bfd9ee68a2648199dd85eebafc11,164,TRUE,1972,1808,
55bd4d0fb937dafe283dfcea69b2bd24,1649,FALSE,2182,533,Dire
3c2583cd764f96c36bd36c698e34ac9a,1096,TRUE,2632,1536,Radiant
bfb664b890889465516ff43680951dd1,1486,TRUE,2313,827,
119f12e370a8970dd1e4dc168b747871,791,TRUE,2293,1502,Dire
28c69595d7ce054170df429f24a2fefd,1051,FALSE,2417,1366,
700460241c38cf94ecafda85891d19dc,1854,FALSE,2131,277,
fe44dd36ee63ae70d6eb43926e81ffd0,827,TRUE,2662,1835,Radiant
2b73e5c0afe041bdedaa1f3be62cc3d7,833,FALSE,2161,1328,Dire
ca831410b9e94243f761f05b177b3110,332,FALSE,2094,1762,Dire
a5e970c4af850165d7f79caa8b16dd48,1066,FALSE,2344,1278,Dire
8745f4cc74495872fd38f39d6e1905d2,831,FALSE,993,162,
8836ec4f54d151cd9de0847d435a68a3,338,TRUE,1614,1276,
3e7721f03c41886362064fdb97bc9db4,550,TRUE,2671,2121,Radiant
ebee85aa45f18d90a97be5d97f2d0ec6,257,TRUE,1328,1071,Dire
7b3adee611de14c855366ef32b4f72ce,2122,TRUE,2498,376,
0eac7e280803e133c67a6139cb5b2f08,279,FALSE,3201,2922,Radiant
f89a57b6a0eef9676ac73ebc118b88a6,386,TRUE,1926,1540,Radiant
d59ce37361684caadd838664bfd5d9b5,1586,TRUE,2423,837,Radiant
1c8b6f1c5a24d44ac1a26ef1ccb3844c,1804,FALSE,1925,121,
a05e26a6bbe501d4a802ac225c6a5e97,1161,FALSE,2385,1224,Dire
f532a4dee5e143916ccb7a6ef8caed37,1220,TRUE,2221,1001,Radiant
38e75a28afbc6ec62dfa6e14abf8def2,1511,TRUE,3033,1522,Radiant
89ceb789ac62cebd5061e1c5152c98b2,1388,FALSE,2155,767,
47b596908c7f3c96d43c04dbf140c294,52,FALSE,1037,985,
5062cad10681f7bb5c764e1c9f849394,410,TRUE,2757,2347,Radiant
b8f303eaf1c869dd783cc531a91ce0dd,2510,TRUE,2640,130,Dire
bc3b58b7cf628f99b9165982d9731c36,881,TRUE,2556,1675,Dire
676e363c25b9d8c313fe3a7e031ece6c,2276,TRUE,2997,721,Radiant
cc618cfd35945703001d10471685fdca,2109,FALSE,3636,1527,Dire
c19d39a746cbeaac226d9311dda16598,1499,TRUE,2618,1119,Radiant
68faca1be21036dad6396ed38e8fc499,694,TRUE,1042,348,
2e30833ead506f0c3578c05502a1907d,101,TRUE,1341,1240,
098c60fa8013beb93a831ac09eb2ee5d,1500,TRUE,3089,1589,Radiant
931137224a8cb4a471cc05e1aae9aa16,1261,TRUE,1334,73,
f9e6bcb5f83c6ab898b4bbdcd19e0031,1345,TRUE,2186,841,Dire
bd48aec1cc34386134c81bca73647181,731,FALSE,1175,444,
0cb007a464738b6706e023849c2a0bbe,919,FALSE,1672,753,Dire
79ca5702e4fa55d7da574ba59613851d,1639,FALSE,2657,1018,Dire
e957fbdd7aa8c142f27d7fa41c0397f6,350,TRUE,1001,651,
c5514a9496f78f61dd9f3940ebd63cdf,1201,TRUE,2482,1281,
5edc10b2ed1cb667524a2cbbeb7d8bed,2481,FALSE,2679,198,
884c2de9cde282cc5e0ea4e75dc7fcd6,143,FALSE,2165,2022,Dire
8de59e07440f4d49b457bad5c4e0b6a6,72,TRUE,1913,1841,Radiant
185ef805e608743fc846c17a93af79eb,1829,FALSE,1893,64,
d88dc26e853c4bed704d478425546853,2189,FALSE,2382,193,Dire
6e872e5b404bd53766990349f489e63a,1006,FALSE,3188,2182,Dire
22efe3d2bece4e3c81d1e9e810fc35d8,1418,TRUE,1717,299,
163a11979822be44cb3283b49151eeed,1636,TRUE,1918,282,
2799d3c8993646a72df153a600338c0e,423,TRUE,1095,672,Radiant
645b6aa85cd38db35646bae47830f89c,259,TRUE,1710,1451,
0f2cd7da0f7331ed272d6e1161e049c3,1259,TRUE,1679,420,Radiant
8eb58ea9ad2386ac7b786515d69f47f8,1627,FALSE,2517,890,Radiant
cc8f3ffd695438c17dc10d104ec11bea,1401,FALSE,2929,1528,Dire
54499b4fdc0492302d255f80d874cc24,180,TRUE,2274,2094,Radiant
5bb7d6fff192fe1c39a995cc636ba0e1,1101,TRUE,1464,363,
105dcb53f4421992f8dd004a7adc7b5f,666,FALSE,1962,1296,
29191d591e145aa8cd3e3e3632ce01de,2557,FALSE,2827,270,
9fb875d61f22c963fe698d4dfc94ca75,883,TRUE,2142,1259,Radiant
02c93ffec89a404407043e0974e3f29e,723,FALSE,2287,1564,
18fc3b985c91b39fbf313c4dd3c3be75,805,TRUE,2074,1269,
51098172e5a4927acb1d60fec95e37d7,63,FALSE,2173,2110,Dire
a303df12bf30f02d7eae0032c24ea4cf,134,TRUE,2210,2076,
e24668cb0b9ea4d6b14896d01a445ae0,1231,TRUE,1659,428,
0d5850ad7972fe53127795b03a7bcd69,1368,TRUE,1402,34,
f10a336d3564e8b8fee8483fa0078583,307,FALSE,2323,2016,Dire
3022b18c1a60542c7e5fbe1934b5c9c4,616,FALSE,2820,2204,Radiant
88298d4d00744c204b1ab9081b8de98d,855,TRUE,1777,922,
e32998df93b8d1832a2c0d6d89f36c1b,531,TRUE,1660,1129,Radiant
6ef13b5c4cfe6258a9330c268a13fa02,2709,TRUE,3280,571,Radiant
7709ecc687ed5f18ec39749b643714a5,1122,TRUE,1533,411,
4ca11ac6fbcc0ea198e16b23edaba5dc,180,TRUE,2123,1943,Radiant
cd9804ddd8f5eff03c53c7d13c7c63df,2417,TRUE,2465,48,
51915351f0eade1a8f61379a5f074a00,2389,FALSE,3408,1019,Dire
f826b16f339512f70491fb525af94adc,601,TRUE,2431,1830,Radiant
dac4d034a2793abf9dad44df18906595,1256,FALSE,1497,241,
dc14da7484e204e6edcbaf5bedc1ff13,1704,FALSE,2186,482,Dire
de5a39691aa7df6a8df97af0855e6968,2827,TRUE,2995,168,
3adc6c5e38038167c259f258edc24369,615,FALSE,1938,1323,Dire
eb049920535c965a56d22380c3c3318a,82,TRUE,1970,1888,
7588e03497e40fa874c224fdb8ad6c11,978,FALSE,1424,446,Dire
0e0c5b7e91e5270d134ded8eac817a4b,594,TRUE,1153,559,Radiant
76883b2d396bf10d5234dfcd65a32014,2069,TRUE,2857,788,Radiant
d3fe2e5c704dfd3c19d41887b3d7d1e4,211,TRUE,1494,1283,
ecf54035eac67ab045fa22e1abe0ddf3,1099,TRUE,2246,1147,Dire
d1fe66661db0602c6cef7453393cae15,787,FALSE,3470,2683,Dire
4d472ae6f51e9c0ad88a3a33303253b3,8,TRUE,2685,2677,Dire
72988894cd2e2e43d131abd2782883d3,1332,FALSE,1655,323,
69dd7772c4abfae7a82c1cfd4e0d71cf,338,TRUE,3470,3132,Dire
5317134205fbce9e2730a64655410dd2,1730,TRUE,2001,271,
ce566a2d691db96d1534e3d2f9c025f1,928,TRUE,1609,681,
6cc13d9cfb2e97f78dac3f5289446548,3009,FALSE,3095,86,
bcbf0f032c58ad896668c833dec24b50,2204,TRUE,2822,618,
07215937998431b4008d8d0892560464,330,TRUE,2151,1821,
302d02bb7e2d1e18d8f861c947e1a3ae,762,TRUE,1705,943,Radiant
d2ffed9f79a8818c52804ce72d5cd5f7,100,TRUE,2400,2300,
2521be9a2221c500e6d7f16fee6fc524,865,FALSE,2189,1324,Dire
f6996e9a7d5069b8a5180cbf97f2a055,1033,TRUE,2227,1194,Radiant
59341d11557d4df1bae699b076f61308,2091,TRUE,2162,71,
5cf5a5c03df4bc4bac5e97731106f307,1418,TRUE,2100,682,Radiant
8ad8079350bdd2ec6f733e84c412cf96,239,FALSE,2000,1761,Dire
daa9ec6ea8a975ac2595552a1a2125d8,94,FALSE,1158,1064,Dire
e1531e460191b4b964f017929ed14528,2036,TRUE,2674,638,
4961e5874d3ac109ee30e801397f0080,1086,TRUE,2119,1033,Radiant
84b7144486e6e9614238db20d62ba296,983,FALSE,2945,1962,Dire
01052afaeb22ef28e77994f5eaf14118,272,FALSE,1806,1534,Dire
accdcdcaa63f663439de2eea09515e26,2140,FALSE,2350,210,Dire
db5f33155d10d4c4613e34418490b411,625,TRUE,1847,1222,Radiant
aa41f76e05108f567b5fa11d14fb23e4,213,FALSE,3405,3192,
5bb52fa569a9257bc57056fdb830604a,920,TRUE,3925,3005,Dire
1b4cfc05910b07cdc9d8b5019e29aec2,1282,FALSE,1836,554,Dire
2b4eb001d14398ee30746000c85bbaa1,2092,TRUE,2707,615,Radiant
337ed04ee053e586d005e061ae8f3763,949,TRUE,3028,2079,Radiant
563f492d21abcf8c55ed7d9e469c4bcb,2088,TRUE,2506,418,
851be5a65daeb2879fb5d6cfe174160b,2568,FALSE,2813,245,
17a9cde8132ba3bb42e5a310330ecb21,1685,FALSE,2116,431,Dire
9e002c528393fa10a9802b4bae263459,3111,TRUE,3355,244,
7cbbe990f6aeec43238f0671a2ff699e,1404,TRUE,3412,2008,Radiant
845506216a7c3d3fe0b959a51e8eac28,1674,FALSE,3089,1415,Radiant
507cd94e20ba29d5e666dce2f9e92f07,1374,FALSE,3056,1682,Radiant
2914a8d762c0edae78d2a831b9b23a01,2383,FALSE,2881,498,Dire
c4bc96f6fdd251a1cb87a7bdc6a9a1cb,1295,TRUE,1528,233,
6ac57bcc3004caf915c18b70b7ceca57,1113,TRUE,1588,475,
e674207a46d5fa9b49202f5cedbff9c4,343,FALSE,2074,1731,Dire
3eb93fbd9056ebdb52ffff84e6c3664a,554,FALSE,2212,1658,Radiant
b1847b4c7e37e83231e86bcf22da2c15,2499,FALSE,2704,205,Dire
6faf6db211d0a26f7c67f8d01dc0ddd7,928,TRUE,3293,2365,Radiant
72ccd3290552545952724a5985f9fe26,491,TRUE,2565,2074,Dire
86b4ed12fe59a60b32f5739bb27e8136,2810,FALSE,4066,1256,Dire
a3503001d4bc9231ea2bbd48a2cd9243,657,TRUE,2669,2012,Radiant
114a901dcc938f4b4efc408aa59367df,1007,TRUE,1553,546,Radiant
becd58c349c25b4b282b842649546f75,712,TRUE,2447,1735,Radiant
4cc05872065f3c8f113839596b826149,1123,TRUE,1437,314,
463b1405c036b34d8c8beb81ccd7c74d,735,TRUE,2178,1443,Dire
615de72c1de0bfd04db067f54c881971,1392,TRUE,1761,369,
4997a82c9a6f6b85462541f98066aab7,707,FALSE,1946,1239,
7c12b03607f01af8cdf13774f7c4fe83,419,TRUE,3297,2878,Dire
8fd6556dbbde57455a83564b6dd45e64,812,FALSE,1854,1042,Dire
17abffd32a5023a1684869b352002722,2324,TRUE,2458,134,
cd8674f8e9480d19b1a141a4af35ba6d,1826,TRUE,2080,254,
10f81d4917b7b4b6a028250392d2e50a,2439,TRUE,4822,2383,Dire
d0f1ec65672e710dab20702275a00aad,561,FALSE,1108,547,Dire
2dab65311c92c11c7920310035cbb2a6,852,TRUE,1366,514,
b6dd28e07868cf27b786eacf1ef69b05,1613,FALSE,2261,648,
7fbef80c1fe45b58db601be7d3cb0b9c,1506,TRUE,2905,1399,Dire
6018627adedbcb2004a5256b39054bf4,1123,FALSE,2625,1502,Dire
64d89f247fb27469221fd0b5775c30c8,335,FALSE,2899,2564,Radiant
dee4e08e22727c306ed2f4a391f1753e,1128,TRUE,2514,1386,Radiant
8f85c593f031a54010f9b46ca7bbdae5,527,FALSE,3429,2902,Radiant
041c60f19a7c20dfe970f5cb292d6aac,3248,FALSE,3419,171,
7419355acfe2dd81f5d687db641c9792,1199,FALSE,2402,1203,Dire
c504fc285532a1a71fd5907071be90ae,1443,FALSE,1650,207,
f4807739b0a26b126c95fe4d436dff0d,1742,TRUE,3536,1794,Radiant
30013f1851db927b92f986454dc9f6d4,1846,FALSE,2876,1030,Dire
ecd313d6371ef47a7d90225b8ac421fb,1547,FALSE,2855,1308,Dire
63aff2f21b42bb586d57fab75586faa7,2702,FALSE,3001,299,
6e2615db2bd8b15c2ce93190cb702e30,671,TRUE,1100,429,
a6c39a1a8a04a27063e84a84d78e25a6,1391,FALSE,1942,551,Dire
dd84ca1f909f00d4b2ba2d85e2c8d60f,332,TRUE,1341,1009,
7ded7a64d8aa0445185feddee35a4acf,626,TRUE,1893,1267,
ccea95a89e9b6362bdf26f80e86eafcd,2236,TRUE,3102,866,Dire
cdde6493c513e883818666e804469ef1,672,FALSE,2944,2272,Dire
ba5b59798e45ba4a3501cd24746d6144,655,FALSE,1827,1172,
161061f2758df7f737eb3ce7bdb0eb9d,1545,FALSE,2158,613,
25cd2f327959a6dc0169e877cc541ded,1905,TRUE,2799,894,Radiant
d97879042e6045c7f64d25bfb48441a9,1095,TRUE,2077,982,Radiant
b5d81ff4d08b1afbe214b48f854503af,1821,TRUE,2498,677,Radiant
c0736be2b95f7ab33b81f437d437771a,1550,TRUE,1941,391,
40bc9a2bcb57cbd7beb9d8b4605405df,816,TRUE,2510,1694,Radiant
d06a5fbf6be00c2180a1471a4974564d,502,FALSE,2771,2269,Dire
726080678140500e270c8393fcd5b759,2940,FALSE,3147,207,Radiant
e8fbfddafe123b34649a39fde939f7fd,655,TRUE,2032,1377,
338ee641f334f56a8c7905b928a56f6d,1261,TRUE,1443,182,
297bea2ac5f2ba0ca7ead785e15fa014,2289,FALSE,2392,103,
58ce4a3aff1363d0e4e8434620856bf2,1099,FALSE,2249,1150,Dire
728011e9c6937f77c059bb6c7ed949c1,2287,TRUE,2707,420,Radiant
267c08b21f1d9c18322601c261b0f318,2601,TRUE,3576,975,Radiant
fe0f125868bb495058c3551d6c907991,312,FALSE,3125,2813,Dire
cae01d4f98cdd0073aec61db0a031552,1255,TRUE,1524,269,
8fcc5696f3dd369af13562d85bb8bb41,200,TRUE,1730,1530,Radiant
8609e366659dd7f21acdc65a29acf8b3,320,TRUE,2750,2430,Radiant
cb3fb05131484c402e96fa44117d3163,24,TRUE,2562,2538,
5a8bad916031ec0ef2b4dcfcd2ca40c8,579,FALSE,1922,1343,Dire
7c8d28c1ffe64670805454f0abe03e4d,1950,FALSE,4067,2117,Dire
c5e5c853c0bf8e025fba29a1062f3e30,1043,FALSE,1999,956,Dire
18143cd9c72cddfe266b2989f780881b,2554,FALSE,2789,235,
a3d3da63d5e1bb2c4d385f1392a1e8de,84,TRUE,2552,2468,Radiant
aee7a53da65fc34d5e85f26dcd221320,204,TRUE,1696,1492,
456dfdb3853186316315a2f6b238e7a6,672,FALSE,1677,1005,
d2cd2f90d8a5ef37bf37df62e5a54870,2438,FALSE,2865,427,
069c244e50f28ce24300d20d88d91b50,1725,FALSE,2067,342,Dire
fcf14011dc4c3eb8fde48a86edce9f35,228,TRUE,4292,4064,Radiant
5cbbaa97fc1f744e81f3b83538a16d74,325,FALSE,2512,2187,Dire
920f13148ca0e9254041b9976b0427cd,140,TRUE,2481,2341,Radiant
55b0b71a8d250bfc35fb3586d9a26fb7,440,FALSE,2907,2467,Dire
01939c0e3c44dcdd11eb38fd89ceeba9,2765,TRUE,3816,1051,Radiant
0ab1cf9b666b00035b4098a480d58d12,1367,TRUE,2510,1143,Radiant
4d2636be4ad9f65ba71f578ddd00dd44,340,TRUE,2234,1894,Radiant
a49bb0c3197e4f77556faa25df1b9a06,1347,FALSE,2088,741,Dire
a7c42e54fce187c2790c7311ec9ceb7a,765,TRUE,2181,1416,Radiant
3a3437499f526b8565b938331c10ec2d,373,TRUE,2197,1824,Radiant
5820f346d480258895342bf186549495,1251,TRUE,2221,970,Dire
e25987eca4a2978150e5fa2acb795115,1688,TRUE,1904,216,Radiant
7bf4984f6a8099e6d2a2d320afea81bf,1922,FALSE,2235,313,Radiant
cf94f41d93d10a8be8f6b5269eabfd68,986,TRUE,2182,1196,
4b76215b157bc00b21fde5db16f1e845,1573,TRUE,1904,331,
b301d955ac8fdb0930dcfe40fd73876f,2263,FALSE,2520,257,Dire
51d0d205ca867c824708fe153bdb95a5,2370,FALSE,2687,317,Dire
2aa5678a7a14e73115dffe71aa4c85c5,2120,TRUE,2241,121,
bd9951381b3c94c65e9acf2c470872dd,104,FALSE,2320,2216,Dire
ac86ce4d2ca7754ad3586dd042c47aab,776,TRUE,2270,1494,Radiant
67f2f985a032d0b6554ffe1115c4b689,778,TRUE,1173,395,
20b5d6c3dd7c776db0bd07454c9c94da,932,TRUE,2546,1614,Dire
1f848b5de636d3a5fa8340ff71a7b548,224,TRUE,1551,1327,
13a7183faad5c73f73afa799804e25c9,564,TRUE,2024,1460,
fd5141a43bbe83fb67c92f24fe87114b,1286,FALSE,2453,1167,Radiant
15f952b3c3ecd06726810f7c53ede74f,1750,TRUE,3398,1648,Radiant
07bb1a263b9b53d3551b61f325120e5f,621,TRUE,1663,1042,Radiant
7b6cca79bdf90588a493984427c5e096,1636,FALSE,3113,1477,Radiant
121ed68d094cd8332d2d1cce7d8da723,753,FALSE,1995,1242,Dire
89089db4c4ad59498405295e66c8a3fa,1094,TRUE,1466,372,
5871e240004b2c514163f1594c2c56c9,1374,FALSE,1844,470,
e2cf62f0f0c4801cc800ee63e9c4b81d,1508,TRUE,1920,412,
907b3d2708325a32a43a81364ef99ae3,422,TRUE,2266,1844,Radiant
2ce6d422272da8be8a943008e7221e91,1367,TRUE,2226,859,Radiant
24f8d30e800fc8ebf0ac68976db926c7,300,TRUE,1913,1613,Radiant
365534ace5d54f4cf837f5b53310f478,80,TRUE,1048,968,
cba722d12c228b8439f8cf31f937bcd3,841,TRUE,3075,2234,Radiant
75c89ffa15658c49465d1b03e38b5a6b,1297,TRUE,2120,823,Radiant
cfe8f529ae2c5f17991b3decc63c6bf9,753,TRUE,2037,1284,
082ebaf2536f45bfc46344814b3f3df0,728,FALSE,2296,1568,Dire
6582f6c4ddc15aa80e9bb5a2aa0a3110,622,TRUE,942,320,
a623ebdfafdb61098970e09772dbbade,219,FALSE,1627,1408,Dire
a99d93c0c698658631e09833bf355717,3551,TRUE,4365,814,Dire
900a1f39df72000edc5944fa13f10800,905,TRUE,2175,1270,Radiant
36b9f6649e95918676ec7ec5d51393fd,2209,TRUE,2254,45,
37d98a72438a374a3f57f66867c6ba2d,1549,FALSE,2448,899,
8df64c668e6a50ff24890a92a671c7ac,2216,FALSE,2350,134,
56f77d0189b3a8d2cb007b37b233a65d,1047,FALSE,2539,1492,Dire
93b0061b2f3122cbfa25927ca79e2825,1056,FALSE,2781,1725,Radiant
60795049c1091efb015087402a666af6,1643,FALSE,3042,1399,Dire
5eeb194810b5f0b0d4285b4cb7f08175,1587,FALSE,1927,340,
c89457fd1089318df76be1f349417df5,1916,FALSE,1998,82,
02dc0ab44cf001a2002029edc02992a6,178,FALSE,2024,1846,Radiant
b9a4a38a46d600b11f57c447bd2aefd9,2737,FALSE,3639,902,Dire
9691663e67519aad08dfe7a3f8551a54,498,TRUE,1335,837,
f028c9a027a056c924ed10d0552f3c20,1278,FALSE,2053,775,Dire
f30b6aae71e93d7140aec23e289dac31,68,FALSE,2587,2519,Dire
8b366b9da932f28afa088f8d99021c4c,203,FALSE,3255,3052,Dire
dcf4beb135d29811db722bc13637b128,1081,FALSE,2507,1426,Dire
b82a2a1c2e1aeb872d4986e6c339188e,2344,FALSE,2454,110,
d3e4e44658a6d991bfb6129708be3854,1925,TRUE,2353,428,
19cd8d82198685f5a718eb7c1b7aabd7,678,TRUE,1220,542,
28955a48cee7dbc41a29b540da2be1ee,1213,TRUE,1750,537,
848ab7b99aa6900ce29c1ff355fe9038,2232,FALSE,2760,528,
057f618b25eb34438fd17e4d57d6ecf8,2265,TRUE,2463,198,
9278810bc97d39a072dfd702968b5b64,641,TRUE,1322,681,
104cc130ecb0e24b068b2f71085669ae,408,TRUE,2436,2028,Dire
01110d465997fedaf6238d685e62fcc3,2016,TRUE,2293,277,
9f3e015fcf489fba6adc768ea1031b44,2011,TRUE,3148,1137,Dire
d97946b44b7ad30763dc438c7ecfbca5,4146,FALSE,4365,219,
79d8ab41366741a86155c714276e8db4,951,TRUE,2523,1572,Dire
eada56657c1bee2d45944b2de9c03978,500,FALSE,1853,1353,
bb4d8a024acc0ec174194673625d0184,421,FALSE,2011,1590,Dire
951bb7990ef6807e2475c21d1cc5b2bd,791,FALSE,2122,1331,Dire
9d91eed3b6fee7aa8e1d715529c9ad9b,931,FALSE,3054,2123,Radiant
1a5165804bff37d44beb040886acbb8b,918,FALSE,2941,2023,Radiant
1147847bc0df35235878258e8665b03c,431,FALSE,3215,2784,Radiant
c3a66cd6a19ae762de94bd054a032d7c,1345,FALSE,2299,954,Radiant
a79be1e112ed35cd54eb2f8d4cfac330,2086,FALSE,2955,869,Radiant
600daf5c06625d0324c700b3eb327330,934,FALSE,1305,371,
6ceba97516c8226bc29094c197039ca3,1279,TRUE,2432,1153,Dire
45fa0de937bbd83186850141bf1fe9dd,1536,TRUE,2194,658,Radiant
74065672129a42ad00ec1b84e3a94ed8,2136,TRUE,2890,754,Radiant
8b2e5db57f45fcd44dacd37f02e80af5,451,FALSE,2809,2358,Dire
0fca0c174c975ab5d711457e1e13489c,2354,FALSE,2819,465,Dire
34404060dca479b304322d6e76d4d28b,13,TRUE,2873,2860,Dire
8f9b6a6be6e753419c91ecf8e4435bb8,1905,TRUE,2811,906,Radiant
1c6c6e17c501520388a1234a911ba462,737,FALSE,1049,312,Dire
370939b613d84c04cd2037c1da583656,448,TRUE,2746,2298,Radiant
de9ab8211ed536aff7e6b488b797bba4,486,FALSE,2774,2288,Dire
d64ffebd5c97b84b13fc3cf3558a3cae,585,FALSE,2813,2228,Dire
ff341833986f699175f4a2b99e291bb8,636,TRUE,1695,1059,
d6a46276496311c1e0d57f796a0a214c,2598,FALSE,3408,810,Radiant
ec67f562dbe76612b62fc866aa1d7ea0,2589,TRUE,3055,466,Radiant
d84b2eea01e7c1d920e84c1925fdbe57,774,FALSE,1146,372,
fb311eccd3c61ad86d88853d8b84ba56,1062,TRUE,1273,211,Radiant
605e4c0710040858c0559c7a973bf1c4,652,TRUE,1913,1261,
bae268c30c0cb0aa2a8ff34c7b53df90,611,TRUE,2436,1825,
3fddbe5fb6861efa54becac3efd627fc,2512,TRUE,2830,318,Radiant
30b987a73ac37fda287d4777e8f809c7,2776,FALSE,3648,872,Radiant
99f8316997d70c26252bf1f2298952f2,759,FALSE,2140,1381,Dire
7332fb6cf897824ed0c69c81e61175b3,473,TRUE,1380,907,
8ad016cd86bba45cec468fde60dec2e0,602,TRUE,1253,651,
11a88aa2429565285f255390898285c0,191,FALSE,1951,1760,Dire
c3478a75b0ed48a1c519e12a9e93cd99,360,TRUE,2737,2377,Dire
7b88cc313141e6edd9b5d4d100f5cd15,2623,TRUE,3078,455,
97be2c086194f50eddfaf175cae2867a,2468,FALSE,2719,251,Dire
cbf7acd2a57dec6ff247a0a8012e5ef1,57,TRUE,2804,2747,Dire
513802af4c8b105eddbdf7e39f7a5156,1335,FALSE,1910,575,Dire
fe2d7f93fe30b32da7206dca0503ff8d,960,TRUE,1922,962,
f398a060f804e19a053ab4842c737b78,2841,FALSE,3136,295,Radiant
a41325eb28be430aa778727b2e4b916e,2590,FALSE,2958,368,Dire
252bcebd618741569442fe4d37a9803d,2750,TRUE,3124,374,Dire
100185f588962b5a4f347689af38abc0,51,FALSE,1572,1521,
9072f047768a5e7859e240ea515dbd86,2710,FALSE,3009,299,
6be55e7df37d16015b7782ca48269b7c,390,FALSE,2859,2469,Dire
e5072808b63d90f3a96842f306323763,259,FALSE,1315,1056,Dire
75fe162adc0cc4ea1ce007d4c9f9a6a7,888,TRUE,1413,525,
39ec8e14fe352f28721ffe6db9507a3f,2719,FALSE,3015,296,Dire
fd9cb59a47b6d2bd2d8520dfb95f2862,941,TRUE,1883,942,
5e1c3685fa43cbb00e01b20d999005e4,614,TRUE,1514,900,Radiant
088e7b08c52d32bc451d5bf26ce6036a,1150,TRUE,1625,475,Radiant
6b35cfd2449d79f792b6731f395ac7a1,348,TRUE,2603,2255,Radiant
5e4522ec96c12e339abdeff110cff7af,3462,FALSE,3964,502,Dire
33565b8299291ce4ce152d3517171ab7,619,FALSE,2987,2368,Radiant
c8cf589aa560dc585c2aa4604170bcc8,123,TRUE,1866,1743,
29d6ea5cd4e339638cbb2ae2cc60db44,61,TRUE,1248,1187,Dire
45a844d1083485a8e78017e4985b5392,689,FALSE,2188,1499,Dire
8af4ff1ec60f0fe321eb2a9055cfd4f2,330,FALSE,1175,845,
f967a4fb040fb280e3cff92cb25f1b0d,97,TRUE,3221,3124,Dire
1bee86686d89bc0cdf387f918785cd45,275,TRUE,1908,1633,Radiant
1285c98a4ac8fc744630de25999c3370,1504,TRUE,1673,169,Radiant
fd4957e7691420a57f767a8f7c208482,560,TRUE,2074,1514,
eaa753350cbb6b0f4aed444d2461a812,2315,FALSE,2490,175,
88b1ba65cd6222d5554ff0f92f546e41,2204,FALSE,2731,527,Dire
d9086213f698264b97a532d22b486581,992,TRUE,1947,955,Radiant
f810e04d6f33a2f81e1c358507a24ac2,822,TRUE,1698,876,Radiant
e5c22838ff75db7d9249d12bc8617c9a,1057,FALSE,1319,262,
feb748df7d9d7c26b44348d369464764,830,FALSE,1944,1114,
29203e4cc773f74637717ea1feeab7b9,488,TRUE,2333,1845,Dire
bc17d831a9b02dac3ec0c9aa73671821,748,FALSE,3021,2273,Radiant
99490c6a0909438003a320f50d7192f5,1200,FALSE,1967,767,Dire
d9f15320cc6244bb61b19b721d2fd0d6,1253,FALSE,2510,1257,Dire
5e454a6c9580ea83a1bec94643902dda,1515,FALSE,2187,672,Dire
c7ecfca9ae8764a558baa3d6d88f5ea9,494,TRUE,1276,782,
80bd11690dc421970d29f5aaaeb1a575,1588,TRUE,1793,205,Radiant
f0b3936832163eb4e110f589804b898f,87,FALSE,3620,3533,Dire
b2ceeb7b56e5369eccfd368d479ad06d,1641,FALSE,2536,895,Dire
114b2632fd068a6adbef4db7cfa6d292,5,TRUE,2375,2370,Radiant
c0b4b69276eb1df316e0804e868c6ab5,1952,TRUE,2471,519,
148d78a56448c0aeb1a34de1357076cb,158,TRUE,2989,2831,Dire
00c0529a9ff5be2c8dbbfd9e3dcdcb76,653,FALSE,2599,1946,Dire
7eda439c06f567001cf782074b3c7555,2185,TRUE,3348,1163,Dire
2837dff522872016ef5e2df1a4a9b15e,159,FALSE,1196,1037,Dire
7dd4e8f99fa33ad8856ffd1c1dcf3e18,1239,TRUE,2458,1219,
56f31490dc913c44cbf83d4450882947,661,FALSE,1549,888,
e1ed28b9e6814e773afdde605c5db49c,2381,FALSE,2431,50,
fca3c435efc894eebb94613aa3b105cd,832,TRUE,1920,1088,Radiant
7a5be2049c742d6a7506cb9b73a33acb,506,FALSE,2491,1985,Dire
d463ffb64fadbcb9a52dfed57532c842,1146,TRUE,2091,945,Radiant
4df69fd4da642c1e03eaefbe7c5e4d05,1782,FALSE,3278,1496,Dire
088e06ef02cd4e8834e050d8797a741f,1600,FALSE,1914,314,Dire
cd08ddfef730fbe3b1889f4c417c2acd,2107,FALSE,2306,199,
f47618e3dcad1aaeb806d5a415396f3c,1076,TRUE,1211,135,
f57b2ff855bb766efc21241b1794a481,1739,FALSE,2468,729,Dire
5c92e8bc2c6d692b39f2904673ae03d3,2394,FALSE,2865,471,
65808bd0fbdbfd5deb0d2a9cdfff0f04,1409,TRUE,2256,847,Radiant
a5e360619ed7d20b081e330f2ee6ab7e,1445,TRUE,2239,794,Radiant
76f9c5121b3f1f7c1bb9238753258582,2184,TRUE,2890,706,
7ce113a04084edcbb14619fdbe3167b9,714,FALSE,2574,1860,Dire
dadcf4bab3a490f3189b6240e1328bf3,1589,TRUE,3435,1846,Radiant
eb5a8113b02e0f11dd5a2f171a55268e,672,FALSE,2207,1535,Dire
ceaeb3e33bace2353baffb837d8780f4,943,TRUE,2772,1829,Dire
8b1b88103929dd27c62903908843aaac,434,FALSE,1270,836,
47a32674ef6a2daacb926d897ca243d8,626,TRUE,1241,615,Radiant
68200717475b14a4a15d5733e9efbd5b,772,FALSE,2242,1470,Dire
849206e13bfeab947796990cde42414d,1875,FALSE,2072,197,Dire
ec1bf08c13fda9cb57dcfdbc22a7990d,1185,FALSE,2090,905,
ee44eebc09eaaf203a8d08d7bfd7b649,701,FALSE,2324,1623,Dire
79df8cd559962070210827753f9c988b,1118,TRUE,2538,1420,Radiant
01ec3de7433b171880a9598ed141cd0d,1275,TRUE,1514,239,
fcec911ba83b4cf575e24841a2443be6,1247,TRUE,1287,40,
bf6128c5c10e08479f77b17b932451b4,483,TRUE,2183,1700,
f7ba1a4f10731d33672c8859071c080a,432,TRUE,1157,725,Radiant
007a38ddea8b228a10d606348e991943,1427,FALSE,2299,872,Dire
2eef2967f2885ec367250e9df25409a0,1483,FALSE,1626,143,
f95b89daf39796e19174f1d3946d268b,2622,FALSE,3095,473,Dire
c0f1270e86e6c67fe02697f6c254c25c,924,FALSE,2203,1279,Dire
02e426d715e40c0e73726a258be0ed6d,1320,FALSE,1580,260,
5059ab6dca9084d7f69fd380c9f953c9,801,TRUE,2166,1365,Radiant
eee20a065a3ea845796947dd1bfb3baa,1861,TRUE,2330,469,
d1914e1eb7a6d8ed85547b008ffa990c,938,TRUE,1692,754,
d284d8ac8e0bc15bdefb051c008c3420,1168,TRUE,2432,1264,Radiant
19a7df9a3f7669b34a57d9c358251060,1611,TRUE,1893,282,Radiant
accbcaa46975a12d3773b26b0a552d59,653,TRUE,1707,1054,
87d1bc9c9630c6af4e602f7f46911aa1,683,TRUE,1784,1101,
4a01850e6c1b04c78bd91d9d7600aed0,17,FALSE,3375,3358,Dire
ef954c51626a61ca0dd1403ccce492c7,2187,FALSE,2479,292,Dire
e5016418ec9369d0899607d25a1bc950,1127,FALSE,1606,479,
7aee1490cf20864595ed2d86b8402b87,1460,TRUE,1900,440,
7f3ebf0ec11b5ab1085970489573dd21,1784,TRUE,2799,1015,Radiant
25b8d496371b9e6615df21d703f04cce,977,TRUE,1088,111,
b6e8b562bc9efdd7602414b6bfd343aa,1479,TRUE,1898,419,
f7445a82be9460e855485f3bbbfe762e,2052,FALSE,2167,115,
ba31282d8ca9b8a4934c7ef8e0162e77,2250,FALSE,2799,549,Dire
a83aaf09a6b66bb6b9af53506a7ac420,1365,FALSE,1404,39,
7f6402ba830c788c95b6a49b583e32e6,1228,TRUE,1805,577,
6692d411f452d349ef019fb93d81c704,2712,FALSE,3396,684,
d4b4def1a4f3cf9c57237cc8cbeeb308,15,TRUE,1676,1661,
452551156ea689c532aaff8f30f7541c,1596,TRUE,2358,762,Radiant
3552109ffc9f1a213fb1b4ad95df8ab3,1022,TRUE,1092,70,
fbac9a2f322a080d08e0ba73aa6e63ba,1430,FALSE,2581,1151,Dire
6b24eac6188fe3d3ef3f5d19630df73f,1050,TRUE,1745,695,Radiant
0f2fd06d57fdfee948cffc6099fb6946,1223,TRUE,3212,1989,Radiant
8f2041b845fb84ae180709d328233ec4,528,TRUE,2807,2279,Dire
9c2103f3e13ee80f3eff811c523895eb,1525,FALSE,2494,969,Dire
d28df33c24b95a5718c7c5b7a0bb7c8c,1061,TRUE,1420,359,
e5c4c56ce4908b48c18c85398b3229dc,2463,FALSE,3562,1099,Dire
575160f84407e23a3bf64e89cb995ee8,2986,TRUE,3090,104,
f04b9e196694162e3c8fc673691dcdb4,166,FALSE,1650,1484,Dire
56bc9efaedb9b61b579b90ae4c2c34dd,2181,TRUE,2866,685,Dire
e039d8eccdd2d6c4d8346e702b08d7f1,986,FALSE,1790,804,
a759db054c55fc2a7611402082f19ac5,489,TRUE,1319,830,Radiant
fc96f6fb6c96b20e4ecd8620a2922065,1138,TRUE,2859,1721,Dire
4182ec8931a31891586b1fd164245f48,1322,FALSE,1363,41,
2c9ec79981e0a4b630b4666de58ff506,482,FALSE,2090,1608,Dire
dec905e31609bc54f2e0edf02f002436,25,TRUE,1963,1938,
e574521dafaaadcce1c24d8339e5f8c2,373,FALSE,2827,2454,
424e048c05ae99bb0f96151f06d6b7f4,384,FALSE,2770,2386,Dire
55c5dd49cd38d58039c6efe44c7be8d9,442,FALSE,1858,1416,Dire
2f07ba6957b0036a835c3122aafdd7fe,228,FALSE,2791,2563,Dire
67db5a1eb8beaebbb143e72f827b0f11,696,TRUE,3016,2320,Radiant
f8f8a69e909317d3fcddf8c09904fb00,189,TRUE,2394,2205,Radiant
463d877b4c47f17ad3a5061812c5408e,1058,FALSE,1754,696,Dire
65b953006d840624fa5e4e34b15f5b97,1176,TRUE,3634,2458,Radiant
29ccac2ebd32d4c6a0853ca71118220f,1247,TRUE,1964,717,Radiant
a5d1dbe66758b0be86b54554326b345c,451,TRUE,2070,1619,Radiant
c917b4eb8a45fc32085214995225d1d6,544,TRUE,2200,1656,Radiant
9c9a22d68f3d23b995c5e30ed29bc2c3,372,FALSE,2356,1984,Dire
97e9da53e75d6eac21b2814e44717d82,935,TRUE,1753,818,
68340d59e3fca104ea65880227d4c586,2411,FALSE,3254,843,Radiant
5641250e912cd5c65400c51796f468d8,599,FALSE,1611,1012,
a9b6c8f6c708044712f24b86628e43d1,1384,FALSE,1620,236,
c6d0980a399ca952198548b87b3dd127,534,TRUE,904,370,
bd9a539be491a6be7c1398093c8cb0f1,865,FALSE,2411,1546,Dire
217eafb0585d86279f32edc22b349ebb,1297,TRUE,3427,2130,Dire
6e13ec784a0c38d353cbcc9212cfed32,1071,FALSE,2085,1014,Dire
ea9651a0661e11b312e899b0dab974ee,84,FALSE,2167,2083,Dire
81d73b6f1c96fbc4bdd0cb5e5ef42a45,870,TRUE,3019,2149,Dire
4df2c6537ae803ca1c3c098323a7ed3e,1437,FALSE,2728,1291,Radiant
e6615c86bf1c158121b310cb20b8541e,804,TRUE,2530,1726,Dire
4c43fb745630fb1186bc151e4ad485ab,1045,TRUE,3716,2671,Radiant
5154b21ec3bfbac74831b7b681531204,1501,TRUE,1898,397,
2d82d8e8ab4d6f8f7b852ed98c7233d7,1477,FALSE,1975,498,Dire
787209cacb8941f8208fc73e13d600b5,1607,TRUE,1720,113,Radiant
61e9adde3a8efe127919b7a180d87959,1190,FALSE,2825,1635,
39b05fc1d8051041d03f126199a3a6e4,1548,TRUE,1878,330,Radiant
bca6da272b7a536b3c45e7b6485cc328,228,TRUE,1238,1010,
c7b26a49aef566894509c14de266105f,2624,TRUE,3077,453,Radiant
27b0078d70f5ccf0cb0c614e59d25955,1464,FALSE,2209,745,Dire
459638ef16ce90e5efd1e4aed5e4ca1f,1170,FALSE,2506,1336,Dire
24ffa465285327a3e3d9845d018587d4,1125,TRUE,3742,2617,Radiant
da6c9b63e8ec08bc5ab30f197b340fc3,2746,FALSE,2787,41,
0c0682f6162d3a13a06e75e32a2d498c,350,TRUE,1965,1615,Radiant
e692de4ddf76a0ebe1411029962ad00e,674,FALSE,2002,1328,Radiant
8419eaf0a0ddce787cdf729ad42ea611,486,FALSE,2191,1705,Dire
d803336e655034c95ce0c6d95b1caa06,1617,TRUE,1786,169,
7e4c2e6a49b1711ec3791bd120ebfcb0,1273,FALSE,1943,670,
f55dc3f79bcafd81bc701f8bc9c88abf,190,FALSE,2632,2442,Dire
eb26149471ba82023b3375837fd0ab5c,2855,TRUE,3417,562,Radiant
01c106af6ddaf376d88bf2e63e3a8bcb,202,FALSE,2301,2099,Dire
23b2a180830b8136ddad2bb5eac7df48,73,TRUE,2159,2086,Dire
8e25c93718dcc3a96d75b7e8344ab964,408,TRUE,1354,946,
9cc3ffd045acc5ec6cd57f31317fc2fa,1540,FALSE,1884,344,
580a87ee7af1e00b1420744f21ca6bb1,1795,TRUE,2567,772,Radiant
a4627eff24cc8ef658f9bfbdd0d5c5a9,993,FALSE,1125,132,
334e8ca571096a152dd9995318f56b6d,1362,FALSE,2358,996,Dire
eaa8817e5b4caf4af5e6264b637492a4,1130,TRUE,1566,436,
e51b12a796648cabfe717fc1e05deac7,444,TRUE,2101,1657,Radiant
de6fbe8b96d57ef4701f078e9049c377,1246,FALSE,2499,1253,Radiant
c3f592f1404d29dfb8ef6d46bd770c01,30,FALSE,2338,2308,Dire
5828f68903c3a05aa47fd0b845e5c024,814,TRUE,3137,2323,Radiant
37e4bbd6ac7279d9de751bd8eb434a83,1364,FALSE,1751,387,
3a5cea4039f043cdf46da248fec8d490,336,FALSE,2210,1874,
181e51f353e84000855f0a0a2c5f52d7,837,FALSE,2512,1675,Dire
c07d0b6b26890bfd83de2c2240682ebe,1828,TRUE,3580,1752,Radiant
1f919912f7cfefe2e02dec6859dc9e76,1741,TRUE,2635,894,Radiant
fac4c2485b635778aab1fd2a78c388d1,947,TRUE,1434,487,
4caf630d2795bf910d956a6ff032913e,86,FALSE,1894,1808,
18a46b6eabe89c5aac65e6d5d21d400d,1733,TRUE,2968,1235,Radiant
e4f90f1bdba09651909666c98e5136e2,79,FALSE,1227,1148,
86945821f37e357ec5fea14e222bc38b,356,TRUE,1747,1391,Radiant
6163d9d1132cbbb42d4f949031730624,1381,TRUE,1570,189,Radiant
bd3d602c8943f73525e185dbe7df0950,953,TRUE,2882,1929,Radiant
a71ac40d63d5bb66c344bf80b3261ca0,77,TRUE,1971,1894,Dire
11adabee27de9085baef636651ea70b3,148,FALSE,2667,2519,Radiant
c783af5bc543da1e5b33af4f9bb3f392,154,TRUE,1776,1622,Radiant
e8b9623fbeaafcd50c88e2b9d1130e85,1407,FALSE,1627,220,
c25084e7f6a63e8f0ee880dc4c947d51,120,FALSE,1697,1577,Radiant
51c1c4ebca74012757478dee1a97c86a,1326,TRUE,1990,664,Radiant
01dfa53772d31029c39e4b3a1412f338,517,TRUE,1757,1240,Radiant
dd49a18ef8089e4108419292e6937737,699,TRUE,2539,1840,Radiant
f6f3e20e03d3fe77feb64065b255a8af,232,TRUE,3222,2990,Dire
241abfbbd251b78443bc4dec8e4a5489,731,TRUE,2766,2035,
0b37acdea22e99c9538ed07e38aad636,1567,TRUE,2553,986,Radiant
c98480ac4868a405dabde4e15d37c386,1802,TRUE,2939,1137,Radiant
6a35209e5f9a2e2a6aec2469bfd9ba54,521,TRUE,1994,1473,
cd9e4eeaf3c9190259726b07e96c9009,187,TRUE,1795,1608,Radiant
0b35446c927bdbe71c17df971916e67f,1874,FALSE,2195,321,
2c8caa18721eec2da7fd2a6e2a760019,676,TRUE,2094,1418,Radiant
c517fe2e2a63775fa7848d66546aba79,623,FALSE,1877,1254,
7687b41ae534b9734a69da3c89619890,2907,TRUE,3198,291,Radiant
9b2dfbdd13fee22d2c3b98149e325a1a,522,TRUE,2065,1543,Radiant
346c741713ce9ebbfd5e4e7def0988b4,945,FALSE,2238,1293,
d773a6911d9710e97a3691998ffc2050,2269,TRUE,2421,152,
da24d8e6d1fe4d3022899a4bc052a8a5,1030,FALSE,1967,937,Dire
7c6cb4e44f391323be4ef6f6a0b9f7a6,1067,FALSE,1926,859,Dire
04be361cd082d4f4bd73b48e109a50b9,683,FALSE,944,261,
e9c7aabf8685825bff92da251c7ac562,326,TRUE,1169,843,
47d08e7a258e588ee340dca4824dedcf,1981,TRUE,3059,1078,Dire
4c56e0b148bbc0a99c18abb054e4f332,1283,FALSE,1476,193,
01552a096aedf5630de6e29da5ae4000,979,TRUE,2306,1327,Dire
1754635767d8fb53e19ed1628a32729b,1001,TRUE,2583,1582,Radiant
90ef216b200ec4d3d7266e6df1f9c9cb,692,TRUE,2223,1531,Radiant
e7c057c466fc2d8a7ee782675a8972f3,423,TRUE,2299,1876,Radiant
e1072ee657d8d886295db94028dee0e3,1193,TRUE,2877,1684,Dire
93e5667c4f73246ed7245cda93289c2e,1644,FALSE,1735,91,
8683a1d20da8b44634a3acc2f8f75975,799,TRUE,2019,1220,Dire
7e4ba8c98eb7ead4a5ba610b39c3c8cd,898,FALSE,1590,692,Dire
402873c3b0e8aed14c222630eeef9b5b,262,FALSE,2048,1786,Dire
46522db9bad5f4c89ee4924776d5b7a0,557,FALSE,1978,1421,
365254331f8ef24c066cb8024f22d2ee,710,FALSE,1674,964,Dire
0c29c41dc0f457045506c5f0566010ef,944,TRUE,2846,1902,Radiant
faf5e89c4bffe6fda4029be0b89078ef,1162,TRUE,2194,1032,Radiant
1b31f1c45db7d223b1a2cd2c7336cdd7,1049,TRUE,2539,1490,Dire
747c2d90371b91a1f0bb1ff9b8723c79,1655,FALSE,1886,231,Dire
85147939bbf8228e959761aa3f4f06c4,22,TRUE,1696,1674,Radiant
3e01d6c3dcc8f579c8da58b739bd83f7,1467,TRUE,2014,547,
9e891a55596926596a0cfa18fb1b61df,193,TRUE,1535,1342,Radiant
4e08c64f47367b3d7385b220ed572c72,602,TRUE,2878,2276,Dire
1913bda90f0fbb9a91542fa13d38c317,1629,FALSE,2512,883,Dire
2b5148a1f529390bbeb434f5ea0184e8,2347,TRUE,2579,232,
eda069ba6273ccb2fe28245f3ba41107,125,FALSE,2010,1885,Dire
52f5358abd549f7278fd36a0680e3e9b,976,TRUE,2264,1288,Radiant
4e5f6426d5f087e28cd42e2c3ec21030,379,TRUE,981,602,
0cd2528c21418bee737b32485f3c00a3,551,TRUE,907,356,
eebb948c99a273197d33a1dce5d302c7,2072,FALSE,3104,1032,Radiant
4b594e600eff9ae1a3a9205ef022c4d8,522,TRUE,1384,862,Radiant
f602783578abed321e5fdfb0bf41f7ab,1727,FALSE,1858,131,Dire
493dca08464c491d8f7b90500787fc89,359,FALSE,1936,1577,Dire
c43b3b4f1619f9bfdf32d3bbc55c6f56,896,FALSE,2892,1996,Dire
b55faa1bc98925c8939c7e6a527fc3cb,239,FALSE,1659,1420,Dire
48d8ba3a60ed56ce2f470cc64bea22e6,1184,FALSE,3842,2658,Radiant
adee683344cb232ec6c7dc0b6b73ecee,152,TRUE,1689,1537,Radiant
15c3d6615352abf3bf091f1882bfabb1,2736,FALSE,3957,1221,Radiant
3eb014e58dc05ebb18526f83879e7a56,910,FALSE,1732,822,Dire
2fe66baeeb1b9cb6292e92fecb86d856,1583,FALSE,3154,1571,Radiant
b4cf2d86ae8e10ac7a81ba975194a5dc,2173,FALSE,2399,226,
bce28c2fb75decb0043195724b01fe08,1473,FALSE,1905,432,
daeb4f6d32f7c0bb9ae2cc594253c518,784,TRUE,2483,1699,Radiant
ce54a1bf6cc7111e563b051f4fcc5d25,2557,TRUE,2682,125,
d1b1b0d8d7b5e28f93da5f67eec3549f,315,FALSE,2251,1936,
f19b3148af57721d9cc8942515dfee31,372,FALSE,1492,1120,Dire
a1610dbee21b9c3d199833ac7be2c7c8,2311,FALSE,2546,235,Dire
d50383e343708e589fd25a2a63a53c6c,330,TRUE,1912,1582,Radiant
0f64d937c89fb415e2ba8b4283e03e9e,1876,FALSE,3562,1686,Radiant
f0559684a519de52595d811c6cd7774c,1911,FALSE,2092,181,Dire
c4f7c96825a13f3d2f5ee8baac89eb55,1630,FALSE,2645,1015,Dire
5675b52e7625d0b0498e3fc4f6b32a0b,354,FALSE,1876,1522,
0a76f2fcd3e92173f98266704f6d2a00,1011,FALSE,1644,633,Dire
d008a8189ccc4bb7aa07dea12d0d1e2c,295,TRUE,1983,1688,Radiant
9699ac992330b1a8a528f72819fcc633,2581,FALSE,2732,151,
0199b59e2970f5e6c2b366a87cde3a78,832,FALSE,2337,1505,Dire
d8641ec1c181fb56114d3bffc788b88d,1066,TRUE,2588,1522,Radiant
6f73efecfc478d3e141c5326eadc7204,943,TRUE,2481,1538,Radiant
bd4a0d7042ceef8a3b69e9122d3aeeb9,642,FALSE,1838,1196,Dire
2c18410da62b785347652e0bd34258be,1104,TRUE,3086,1982,Radiant
9dcdf8c41806452c261b5949b1a5518c,1915,TRUE,2364,449,Radiant
a0674ee2b905cb6d0515e3cf3b776a88,833,TRUE,969,136,
5e8afde19af0d70359155a4524dd5cfd,2818,FALSE,3273,455,Radiant
2d67e083c36f2cac7bf82336d6a56777,714,TRUE,2266,1552,Radiant
20f214a801868bbb8622c4b4d5d51b0e,2327,TRUE,3125,798,Radiant
da00326de49e677f207c3b985a509ebc,1743,FALSE,2262,519,Dire
5db85a57443a232c6bc9b379761e7b22,588,TRUE,1919,1331,Radiant
26ad637b4f6e6a68fda44496aeb851e1,1198,TRUE,1956,758,Radiant
cf54ba1da90c9bebc2c4518b6a9bc48d,1669,TRUE,2930,1261,Radiant
70e286143a5e5e5e3a40ef889de43397,1083,TRUE,1640,557,
8ae33950621583a8627b77459885e2c5,2414,TRUE,4025,1611,Dire
92ae1d0b89158fbca5669a233dd6a3f7,1727,TRUE,3763,2036,Radiant
e0f7431ec7d9de24ac64cadd28b59aad,315,TRUE,1032,717,
0b366363d8127aae70b9c706b96c45e7,1573,FALSE,2272,699,Dire
07c1c37daee2491077dc4698f12580b7,1230,FALSE,1928,698,
103e64bdd39356c0e48c9fffb1eb7fc8,261,FALSE,1630,1369,Dire
59f10a818bc7e22e3017a827e388b75f,313,TRUE,1101,788,Radiant
7416ba89c8e8dee373ef63dc6f893a90,344,FALSE,2300,1956,Radiant
0c10715adc58258b754fac56af4be901,1562,TRUE,2435,873,Radiant
deb70b5489a9a2502c1b7fee3865decf,1614,FALSE,2297,683,Dire
f271f6cd328d79f75f356e493e74aeab,1060,FALSE,3007,1947,Radiant
75501c09049364084232b05879370082,1109,FALSE,2188,1079,Dire
077bec5b525e5dad02c2d6ee8b907de5,1368,TRUE,1775,407,Radiant
363a9491463e6d4c2756b7647f7dd792,258,FALSE,1482,1224,
9791054a518a8c0593d6a9aa15ef187d,1023,TRUE,1268,245,
11f9981c4679f74ce6b7a9ea2d2f9c38,2149,FALSE,2976,827,Radiant
049974ebea2bf34cd5997109ea924937,2716,TRUE,3109,393,
9fca5bf1fecb80e9a84c72ab977ffc77,575,FALSE,3621,3046,Radiant
ea1acbe4b51f0e1fe56677ff865a9fd5,198,TRUE,1353,1155,
582216f3ad5658db43c5a102f0a7b43d,1992,FALSE,2103,111,
322c0eb96959fbbfa1f07035c946a7b8,1964,FALSE,2032,68,
a4e26ff8ed7f90846de3415f9b52e5dc,39,FALSE,2498,2459,Dire
2c4112cbd8b35f83b58d64ac7a78d1b4,89,TRUE,1813,1724,Radiant
d2a186f17d3292ab795445f5aada72b6,415,TRUE,2264,1849,Radiant
8ddbb5fb88af66ced4fdf9bba514e1ba,1779,TRUE,1962,183,
8ecae71195b660fdb75bc74192e37258,1992,FALSE,2298,306,
99278bfc10f9fed276aebad6ffbed09b,1592,TRUE,1826,234,
de5ad3f77f984c132291365400126bcd,1943,TRUE,2057,114,
6eac3d28378c4a2596cdc79d51707204,938,TRUE,1716,778,
3d7b6136167289a0b22047e9c2ed34c1,557,TRUE,1820,1263,
a623c956936938e22b1f9f69dd973b26,2108,FALSE,2253,145,
29fb0004c293911b51b762adfd93226f,407,TRUE,1498,1091,
0f1876840c38150694ba281ec928bb34,1606,TRUE,1963,357,
35f07dcc9cf19268a775676d724cf291,476,TRUE,2555,2079,Radiant
ce74f30ba41ca39b86b09d340f206707,1283,FALSE,1546,263,
8e6b2fe084efa177bcabde3e94a839ec,861,TRUE,1773,912,
7b117479959bb51d34353233a267294d,234,TRUE,2211,1977,Radiant
572b37af3e9cfccfa288158a1c4ca9df,1345,FALSE,2543,1198,Dire
0a9bd481edc1c29405cc456a5c0bf476,908,FALSE,1949,1041,Dire
7f5088e40ab54ec27945279e5a287498,1434,FALSE,1653,219,
9da1468d0512181bd65becc0b2e1f6c0,633,FALSE,1765,1132,
4f84e7ace1b7a4a3b9d596a6e3e17137,513,TRUE,2840,2327,Dire
68d65ed594a6d0f49088afc611b9c27e,115,FALSE,1554,1439,Dire
8c604d92f575074c367eb7705bb70fb9,806,FALSE,2803,1997,Dire
b12eb70138efc136316fca6548d2189c,944,TRUE,1912,968,Radiant
3d0fd826ecb4416ae808ab0208e1dd83,62,TRUE,2512,2450,Radiant
cfa6ec8ce9a01a8c61655ceea6cb9956,2616,FALSE,2862,246,
9e3c9bbec77832279f0cd278e68de820,2109,TRUE,2507,398,
a35c66e596526f59189d4b727320909c,1622,FALSE,2338,716,Dire
cf5c84e2842bb24ad274d5d06dd97571,2151,TRUE,2633,482,Radiant
be773eb6189b73391b1e692c5061f5ea,343,TRUE,4247,3904,Radiant
fa69acd5ce2788f9a2de93e127ae88ff,1540,FALSE,2750,1210,Radiant
1aced2b5322935c6a03f9a6be1643531,880,FALSE,2236,1356,Dire
ae318e8b2cf4351a170d2578511f226f,255,TRUE,2755,2500,Radiant
4b52d473dd7911c1ad116ef5b36b493e,1973,FALSE,2506,533,
6e333d47d1158b11ab6704df9037d480,1556,TRUE,2355,799,Radiant
e8b15e00b45e04a1a073ebeba3c477ec,142,TRUE,2482,2340,Radiant
4705fc8610474b38c2f2eb5b59fcec94,1813,TRUE,2010,197,Dire
f246c5f8f4a7117a71605a2c2170fe38,973,FALSE,1692,719,Dire
70504b5b4b057831da731b9721bff676,996,TRUE,2326,1330,
c0ba3739869c3ca9a9433bb82481c326,567,FALSE,2437,1870,Dire
725d8421f4d7b38fd0999416c825aa95,1137,TRUE,1436,299,
13511e4f54659264a285342bf50ca02c,2857,FALSE,4067,1210,Radiant
f926932b4a3173cb50bee6a8fce123ea,465,FALSE,3110,2645,Dire
f61b46143a26cf7c0489a6f87c6dc6c0,44,TRUE,1654,1610,
e1d73201bb6cc7c326ad94a7998b5367,296,FALSE,2101,1805,Dire
3ef03ca2202a439203be12fc2a93aee4,3397,TRUE,3613,216,Radiant
75513e8eb813254879c9087886aadb62,3040,FALSE,3413,373,Radiant
597c88c711f89c6174db790e549dfc02,784,FALSE,2578,1794,Dire
ad90995258cf7080c30bca94ec3948c7,938,TRUE,1507,569,
6747f3e8114b3403ce9dda1603cf0ed9,1820,FALSE,1967,147,
51c0080818de5a79576c36bddc2d819b,1270,TRUE,2477,1207,Radiant
ee9c087f9e43ab0df941aed3b9474fce,1658,FALSE,2780,1122,Radiant
2490d3eb7e28816547cab94041a02151,1936,TRUE,2627,691,Radiant
a40a9f87e65b50b72eab8d80eb2a3dd1,1717,TRUE,1869,152,
13f1539d08f7cfddbd20396c91d4c658,1404,TRUE,1944,540,
1e09986238ff6feb9315daa50e31fb6d,1396,FALSE,1906,510,Dire
3333ca08d0a838e61709c99007e531c5,553,TRUE,1062,509,
8225eb5b95aae15f5778e5b69f4cacc9,659,FALSE,1956,1297,Dire
382d4082b497d21d5951afb17ac3a682,1477,TRUE,2198,721,Radiant
060db939f4879461381275f517949954,887,TRUE,1396,509,Radiant
f9e4f0440a4ec998ed8226b73fee65d2,1366,TRUE,2254,888,
d00a4fa67cd08b3e380fb1bd3927b75b,1473,FALSE,2462,989,Radiant
d56e4e6a4e210c639470c8fd10862506,769,TRUE,2420,1651,Radiant
82508b0b1d6c0edcc70e040ed291d66c,231,FALSE,1702,1471,Dire
8c52ae97611f60f304615a97155f607d,655,TRUE,1561,906,Radiant
45d4159d591604dce285b5e75f56a850,1667,TRUE,1905,238,Radiant
84650f34e2ddf119a3ae1c5f2305400c,2601,FALSE,2725,124,
dd8f76abffc79096ca18cf65c7b8ed68,1271,FALSE,2650,1379,Dire
c385e48fe0ffa0edd670d5cb84b710f8,1865,FALSE,3505,1640,Dire
e94eb4fe0681277fc15ee7a53b6333a8,2067,TRUE,2520,453,
25c344e9166a787fc0f4d5fe517711b8,536,TRUE,2787,2251,Radiant
7d5a8c730552dc7b9ac6c778d075b102,384,FALSE,2054,1670,
5eb70b08cbb8296330051881be63c2ad,3312,TRUE,3653,341,
472b21e4f536c06bac396241b48634e3,1389,TRUE,1588,199,
8912b5a6ab0e96945d46b16719fae624,2633,FALSE,2745,112,
727313eb8fb28b03d7f42d1fe12497b1,3346,TRUE,4634,1288,Dire
8d1df704807ce7a5f2a97b7490912b71,1515,FALSE,2218,703,Dire
321ae16681413e8f9d2edbaa138b7b8e,1446,FALSE,3275,1829,Dire
e2c6aad819f56da524ae70c100e55232,813,TRUE,1576,763,Radiant
ac3541028e4d92d910659cafdc60ef09,266,FALSE,2381,2115,Dire
e954a88fae690d05e789b8aeacb11481,1582,FALSE,2182,600,Dire
693aa34d5a0794f9066e4aa85ecec36d,809,TRUE,1514,705,
78e9bb645f11460adfd8a8db94c96def,1168,TRUE,2395,1227,Dire
f0d8b0b10a688ea8e5d3b7c2ec1213dd,938,TRUE,1787,849,Radiant
27d10bcfcecea937e920f9863d3e363b,1339,FALSE,2064,725,
1ee6d25935aa418ec8ffe7c7c7878dac,6,FALSE,2192,2186,Dire
8b4d3126826d414429baad0f2128e21a,1640,FALSE,2566,926,Dire
f65280190bb26dce99e3eba2ddcf637e,939,TRUE,1918,979,
8df30b3e17a41232e546a00dfeee14a7,1555,FALSE,3119,1564,Dire
cfe6e57532337c31a0f1d87c98ef8a23,3197,TRUE,3265,68,
a3ff63516e7633e7fa7b385b6bbc8ff2,900,FALSE,2233,1333,Dire
eaf6a6bb520f738b25c0d285e8afb59c,500,TRUE,1273,773,
b59b5c41cd5437ed968298d3aca45133,962,TRUE,2408,1446,Radiant
654cc50c57a897cb409e819b212e16b7,1873,TRUE,2269,396,Radiant
457b9d26408cf46b62ee111942c357b6,336,TRUE,1606,1270,Radiant
e0ddfbac4bcaa9e19edb84bef1478012,1222,FALSE,2510,1288,
c36018e9622fd1c044444c8124c49d12,1708,TRUE,3360,1652,Radiant
31bc03c265f08b64eb6f00673be9bfe7,1962,FALSE,3100,1138,Radiant
69c3a3af3ae053b116ae69a4915ab397,918,FALSE,2069,1151,
38a6340360d903e763e94a0178c4c840,1507,TRUE,1766,259,
f9c12ad4e51d0bed884ef176858c5254,1833,FALSE,2746,913,
0ede8ab71be537d1273cdc6d9a72c4aa,926,FALSE,1727,801,
626d1b17f9c1921b9ecd4cb732ccd7ae,947,FALSE,3329,2382,Radiant
671bcb894bc37cbab09bbe2a17b99873,1668,FALSE,1763,95,
ad3f39bf07c272e840bd5c8279a05867,502,TRUE,1781,1279,
aae87fccd06a8e300f8923718ac18132,190,FALSE,1645,1455,Dire
e2c580884072510de38989470cdec7ab,224,TRUE,1659,1435,
4a69a93a627f5a1fec2ddaaf7fb598da,55,TRUE,1627,1572,
6e894bcbe51fb2dfca139f4b738e04dc,1495,FALSE,2479,984,Dire
afb2fbb177afed492fbd231de8223700,1062,TRUE,1408,346,
b1a23a2646dfdfa31259643d1b8c172d,921,TRUE,1687,766,Radiant
95ff9270030f7366e2669f131f7d991b,231,FALSE,2159,1928,Dire
1c7e3dfa1d892bd4d9587fe857b392eb,816,TRUE,2536,1720,Dire
705ce31aad0f9a7bc2458e7cd941d68a,251,TRUE,2302,2051,Dire
940cdc4dd27baa0328d68241be4a1b3b,1182,FALSE,3037,1855,Radiant
7717166c8146919557ca5f1715fb0cb3,650,TRUE,2085,1435,
a399c4f8c4b6a4a1fb0d28f892b3332c,2535,TRUE,3043,508,
d97739007ae81a20a65d35d0c528dd33,277,TRUE,3389,3112,Radiant
dd1cf05c207a651db03b65dda9fc1321,2123,TRUE,2402,279,
80d92bb54a469bdb546c0b42c45974c1,748,FALSE,2629,1881,
6d7f131b3f03e9f31adbba4c0dfafee3,1467,TRUE,2487,1020,Radiant
26943b2b4c7494e93be3fa74e4a3a980,659,TRUE,2134,1475,Radiant
5e141a38223fb57f28c6488eb7110322,502,TRUE,1623,1121,Radiant
2a60d548b6d1d3988aa361806ff45cb1,182,TRUE,2908,2726,Radiant
3a19649181e558f6ee33a020274ab590,2542,FALSE,2930,388,
65981380dfaaf08b9e3b390cb9c5976f,581,TRUE,997,416,
e034221e0d24ff4d5c7539ea5d2fb2f8,544,FALSE,1755,1211,Dire
34129b68c48bee81797bd04cf154aba4,1015,TRUE,2510,1495,Radiant
92044642372ca9f89688829e3be52849,744,TRUE,2763,2019,Radiant
f337c41e7b7aed6208254725ada5b665,841,TRUE,2144,1303,Radiant
71428ccebaebbee31f63efb381979411,591,TRUE,3369,2778,
2008184187fbde25d69966a618673da0,1659,FALSE,1898,239,
0abfee39ef87b3b0e6d93c50f76561d0,2324,FALSE,2404,80,
54ba5d0389fcf45c602eb4aa9da4f67c,2235,FALSE,2283,48,
d0d014100f69c9e1bfd85fb8f94cc313,264,TRUE,4581,4317,Radiant
9b7cd96a0e2be74154c5109e7e6ed2df,2277,TRUE,2352,75,
b5e366450c509c9320ed4afb10e681d0,2414,FALSE,2575,161,
a5f4d304014a7bbade382505fc8a1514,1748,FALSE,1911,163,
6207e54864c659be75f89ff2b7a7053e,1605,TRUE,1684,79,
0eddbe75d1bc1a0350bf48bb701b8199,869,FALSE,1681,812,
f5469b71bcdd59c00760d1f7cd086d23,864,TRUE,1790,926,
4b34e4e7cc0af89bd260e5371a3b4723,1364,TRUE,2696,1332,Dire
07f77a90a0575bbe895ebd06ac84e2cf,629,TRUE,1544,915,
7ba1686cff7610fdd18f64d27376b39a,2226,FALSE,2824,598,
65ab2759587717a6dd83a9e22e48aa22,190,TRUE,972,782,
29ed50b24aef6a73fe414170eee8cc14,296,TRUE,1890,1594,
495a444ae38180dbe33567dda8ec5dee,1102,TRUE,1393,291,
a486a9fd4df0c2b3f189707ddf64e81f,754,TRUE,1938,1184,
0fcbc478ee225364a1aecc8f9d97a6ca,2208,TRUE,2929,721,Radiant
08766f90e9cc780e9e8d663c3f742aec,1752,FALSE,1975,223,
87f686bf653c022bd7e30569ede6c143,637,FALSE,1877,1240,
3adccde86158b5af620b0a4f17a402fb,1059,FALSE,2386,1327,
287f25f6fa60e58ee82c1fa9454521de,584,FALSE,2704,2120,Dire
77898899db6d2f1c335f7accb8f6a229,1589,TRUE,2062,473,
e56c48dc0259ed81d34753a1a67cbe54,293,FALSE,2213,1920,Dire
90e798529d8c297260d81a98a3c775ec,161,FALSE,2970,2809,Dire
2d255663090d2004dca20005c2bdebb6,104,FALSE,3135,3031,Radiant
dcbeba34ebad35dd2ede7250ddd75ede,3444,TRUE,4116,672,Radiant
89e15a5dd49221ba47354c698edf18b7,103,TRUE,2239,2136,Radiant
426b0fb06f9890b55b893bbe7e526453,460,TRUE,2620,2160,Radiant
973e3915a11da2b6e5d009fb0b9f185b,328,TRUE,3025,2697,Dire
625105214c8dddb8c3a5682821609587,1042,TRUE,2107,1065,Radiant
c7d22096aa9c1ef61df876ec280a6734,927,TRUE,2002,1075,Radiant
331103bc277b562b7711394a2035bb17,515,TRUE,910,395,Radiant
c43f37ac759a5f4959e03f380646fe2b,1386,TRUE,2593,1207,Radiant
533f2774d9b791bf45ca2377be206115,1343,FALSE,3407,2064,Dire
5d0d7cfd0b75039eb3761abecd6e0701,373,FALSE,2437,2064,Dire
fadac479febc768735432e59bdd9fdfb,1766,FALSE,2068,302,Radiant
72b89e6f5128b6c580a3a898e68fab7d,167,TRUE,3003,2836,Dire
7b115067ae67fdc223bd80766e58cf53,1127,FALSE,3057,1930,Radiant
86b979adcb1fbef69b2f83de8391aa04,221,FALSE,1696,1475,Dire
20b95afe6fd0e5d8872feb7495c0486c,574,TRUE,1344,770,
54adbd1f8dd03275180e2aab3b4412c4,1027,TRUE,1800,773,
e880da03598515fdce57f876703d5a9b,139,TRUE,1822,1683,Radiant
31d4f17999df031c8de34c57986cf43b,186,FALSE,2826,2640,Radiant
d7dde7e7dd3bd8cd760485433da737e2,2039,TRUE,2334,295,Radiant
7a866f258b52ec566d289ca9b2c40475,465,TRUE,1968,1503,Radiant
e94f04e1a723ad70434d39b9f3709760,1068,TRUE,2677,1609,Radiant
5eb90cbaa22bff4457de743b116a7b98,2,FALSE,2669,2667,Dire
d039dec9cc064d8211728e93627ebe31,802,TRUE,1914,1112,Radiant
3935a0d511966004fca083ebb0634c33,1107,TRUE,1521,414,
ff05f20508c29458422fcfb9ba52ed99,1600,FALSE,1805,205,
6f963f09032dee3e52a7a04db2d1f6d7,950,TRUE,1654,704,Radiant
bb189790ec17b9ada041319553bcbcd8,663,TRUE,1296,633,Radiant
979be1d4637b09212aab2964c0da234e,2135,FALSE,2573,438,
1fd69c5459c19bc903616aa677fbaa5a,1682,FALSE,1762,80,
306f2e080fd331c293ea94b41933f853,1430,FALSE,1994,564,Dire
82f0e000cd71047b4fc7d20a40708456,268,FALSE,1931,1663,Dire
07b654032a01666bee0ebdb4fc739df1,993,TRUE,2542,1549,Dire
6f611cf49227eb6f2c47b0dd9fede2b3,977,TRUE,1829,852,
3bf5cc849d4330d86f7e3b5086d46694,1052,FALSE,1893,841,Dire
b7d9bbb33274b6644c84f8ca14666f44,159,TRUE,2205,2046,
5e7ee24c397187a781871e41448b8401,3807,TRUE,4120,313,
728824d96a538db712692b7fdaf8d2d2,27,TRUE,1448,1421,Dire
73a89bb0e7f4c4414b467716fda61311,2438,TRUE,2893,455,Radiant
987b48ee7ad8d2f9aa73e0c1e14fb602,1567,TRUE,2552,985,Radiant
ee24ea4812ad4a57915699a9e26e1586,40,TRUE,1673,1633,
600ead72d236bead535f4154ffc77eb7,2382,FALSE,2789,407,Dire
c8d82e6799bd5279ab9c728d8c43587f,155,TRUE,3573,3418,Dire
0474b6577379a8ae2e5a5a1a3d80f5fc,1008,FALSE,2276,1268,Dire
cf2ae67186a81c6245c9fd987ca16bad,2700,TRUE,2808,108,
0fc88adbc68bcec506d5ba4a58079025,2183,TRUE,2922,739,Dire
cee4ef7f574f713e36570a568c747987,2342,TRUE,2564,222,
4495ecb9d3db4076c1854b8d45069e77,889,TRUE,2179,1290,Radiant
9351b19e133651bec14fa96d271dd25b,515,TRUE,2577,2062,Radiant
e9b7c4f830afd819150fb9fe16abb57d,2374,FALSE,2442,68,
6b2b35da959a3f55b0098ee3491770c6,824,TRUE,2498,1674,Radiant
9eedb6fd807efe2835e1baef4d15b203,239,TRUE,1349,1110,Radiant
b29fddb948318e520e995a9bd496953d,108,FALSE,3341,3233,Dire
7dcd79579f8678530b3d5c7038d6d65b,1067,TRUE,1406,339,Radiant
dfaaf74d22f0693353a5daa5843f8b6a,1595,TRUE,2504,909,
63907f925fda9c13b46e6add730c4d11,1079,TRUE,1779,700,
fe743526df2ff915baae52dc4d7d12ee,1739,TRUE,2557,818,Radiant
741afbd593c54dcf2007bf99fae72929,828,TRUE,3068,2240,Radiant
760d70a8d8bdc4e50571ebcbab8ee657,1207,TRUE,1618,411,
47f0db8ae88b6e35a245f2d1d871b817,58,TRUE,2728,2670,
dd59a10059c8b300cabc96d5dafb7400,1092,TRUE,2347,1255,Radiant
51d6499d038b82c4778889c91912c7e5,1025,FALSE,2227,1202,Radiant
a8b78f5247b3424c9f635160fc486c2d,609,FALSE,1972,1363,Dire
c7fe8e63648d676af7d68b243c110022,1115,TRUE,1908,793,Dire
aa78d65f583f3cafb7bc2d1ff2051591,1713,FALSE,2874,1161,Dire
38d3ba7cb12e5ea320b9cf610f5b7d91,738,FALSE,1370,632,
b6432d58f9d6d59c38fd0c277063a277,2679,FALSE,3042,363,
4d3a5de4525a86f32d98b1003bf88edc,376,TRUE,2578,2202,Dire
ca7c024b02745a0150d37cd582d700eb,802,TRUE,1102,300,
31e9b3a67d6ba29fc93a94daf1165792,1895,TRUE,3939,2044,Radiant
e5dac1c0a63eb8af29b84010bf31bd10,106,TRUE,2524,2418,Radiant
561b95fd7417cde9d01c2e9afc443f50,1292,TRUE,2301,1009,Radiant
146b08e4ed2f4e1971698e03e1ae745d,1138,FALSE,1886,748,Dire
4c04c4a8b2dedb0473bff16549c134db,1612,FALSE,1834,222,
b471fda7f6ed37caa6828af36797f73d,1815,TRUE,1902,87,
cd4af782c567952bb514fd9087682ae3,2038,TRUE,2085,47,
f09f7404e46eaa6e3c15749a2acd1d8a,2485,FALSE,3036,551,
683c5cae6702332e6e5c0bd55b10fbb1,262,FALSE,1334,1072,Dire
b266ee8c4561056cb22d1d66e56bec24,490,FALSE,1256,766,Dire
b5a010146087d9a0f7d3fd6323caee4b,1577,TRUE,2313,736,Radiant
379dcb8b7dba9f5aa93e51c0f5d999a4,320,TRUE,1797,1477,
fa2a650413e6bb119670468bd1afdb37,1760,TRUE,2615,855,Radiant
05adc97857c56a7de3ac0a2531d93318,2610,TRUE,2945,335,
4391a252a69b1c94d108735b884c8dcd,1000,TRUE,2461,1461,Radiant
e1bfe3d698ac1ec16f8bf875616cb40a,468,TRUE,2393,1925,Radiant
a1a92b161a2cae0d924a8b6ac0947691,2106,TRUE,2356,250,
a81ed3e91183d829c6e27efc143a0297,1122,TRUE,2567,1445,Radiant
fa49688c458efa22868738ab76882a68,1111,FALSE,2726,1615,Dire
4681f8e6b4c075cbe2d52aef02112d72,456,FALSE,1043,587,
8dea82c895aaef32344f5f9350f09e70,1145,TRUE,3024,1879,Dire
28883fd45aa41c771ca410dca4799e03,2470,FALSE,2512,42,
837e940465a9e14cd258f5f17fad8ab6,1077,FALSE,1508,431,Dire
21bce7200ddf333e59b21ca1613636eb,3013,TRUE,3448,435,Radiant
5fb4d268c99286163c142d1d4cdd90c1,972,TRUE,1369,397,
c5db31f69d889f7d016d41d5ad65b44b,1500,TRUE,3436,1936,Radiant
cf2b8ed82a7773d90efa35d750206fd3,850,TRUE,1716,866,
ef87572ff6ea24b663bd271e98b016ab,1246,TRUE,1876,630,
88964b54b4c5115d651d0d1e12c9b0eb,819,FALSE,1249,430,Dire
12af57e47ab50bf0616ed2fba2845432,510,FALSE,1447,937,
efb5bd7f5ef82008281acb7d8d7697ca,421,FALSE,1912,1491,Dire
bb53e58b5821cdd7a2ac78d3afc92a29,728,TRUE,2671,1943,Radiant
bff22d492c8913d1e2951c79033dc6dd,1323,TRUE,1500,177,Dire
11415bccb7f3401db8bafc8d06a1a9fd,681,FALSE,1793,1112,Dire
89477327507f365b150d4d58316a0e5a,2287,TRUE,3035,748,Radiant
8b57f20667dc189edf2a213a41a3b5a9,1287,FALSE,1983,696,Dire
d9752c3a26db0e9541f07da1353c7bdd,1246,TRUE,2275,1029,Radiant
9fd360c83c150c5a47734426b6c07f86,147,FALSE,2655,2508,Dire
9c6132ac04f998c7d2bcb548001a3d95,2076,FALSE,2499,423,
062b9372dcb8277c0a7bbea2dd67328d,1296,FALSE,3092,1796,Radiant
baf9c13ab25b1749c123b7b2e2d98240,502,FALSE,2153,1651,Dire
3b1c397fc6ea3ba42a1531fa17d28586,2971,FALSE,3318,347,
b31d914bca447855eee0ed44340b7b57,2773,TRUE,3437,664,
62393de8422ce55e3383c876518e50df,1975,TRUE,2523,548,
9426ffbb36eaaac510af8501299c9f9c,2342,FALSE,2531,189,Dire
f5fb453de64e8c77b7fd30f9397c6e4e,636,FALSE,2573,1937,Dire
efa95a92375ba0648c601db4ad69e1ec,133,FALSE,2869,2736,Radiant
bd011c06d347d22492bd7a507dfcd35c,3280,FALSE,4187,907,Radiant
e82d1ae364e3cf5bb1e06013f113b01b,720,TRUE,2726,2006,Dire
6a6d2a5235de75596d0171943c27b8f7,921,TRUE,2825,1904,Dire
f08bca913f73e46192f893f328760cd9,2556,TRUE,3997,1441,Radiant
00bc365169851bde3eceed200cba9d34,1389,TRUE,2228,839,Radiant
91a714891604b800efb1f54fdf201dbe,2514,TRUE,2790,276,
eecd1f1ce47ca28dd63ba5ff882bc57a,818,FALSE,4392,3574,Radiant
7986d0a56e8c88ccc25d108727935106,357,TRUE,1052,695,
ab8b99671773eb3014d23b75a9b1fdf4,679,FALSE,2209,1530,
e68ca738e906479f44c8d5de95248a1d,490,FALSE,1153,663,
1dde6e7c08d12095248d15eddab616da,1286,TRUE,1405,119,
076ec7eb9ac110abb9e7ade3e21950ec,903,TRUE,2103,1200,
97fdca4319aaa6d9213a1fabff641ea4,201,FALSE,2852,2651,Radiant
21a550a68206b97f87573ca272a7508d,310,TRUE,2164,1854,
29005feadd527e4533ea9a82e08dc86f,1852,FALSE,2288,436,Dire
6ab1415a08d66db11149788661aef920,210,FALSE,2368,2158,Dire
05f2a632a4a9662f35c9b21fa3fa999f,970,TRUE,1398,428,
980599fa3e38b6e6694ef8bd280f4838,1399,TRUE,2542,1143,Dire
0e0b1b6efa86e63a109e1cdc1f4e9174,1205,TRUE,2183,978,
8db4351e772ec1120383064560eba5f5,801,FALSE,2278,1477,Dire
affda2d00c37a33530930a047bccc0d2,882,FALSE,1714,832,
859cda32b3e3fa50366f50d808ec3f07,955,TRUE,1536,581,Radiant
008731d14830bbc80ef0873cd021eafb,1811,TRUE,2317,506,Radiant
fe1fb121fd9aca457459e6805e1422ad,2221,FALSE,3391,1170,Dire
9c52772d896cbbfb99884b2dd3054b19,1794,FALSE,2245,451,
9499708626181a7ec673ec0f5c9d0892,99,FALSE,2364,2265,Dire
305b6311cdc1cfeb137d2427acc4819d,1373,FALSE,1570,197,
c295a1d95a4fe950dfc57a13c5685066,648,TRUE,1910,1262,
c19d2ee5cab577fa4ae57936164d1a11,907,FALSE,2593,1686,Dire
ef81829e281b975cec82b463ef91bd61,551,FALSE,1855,1304,Dire
8ee91b60bb98e86fecd0a41413513d20,626,FALSE,1038,412,Dire
31418152c6991983fe2375552af9d727,2676,FALSE,3072,396,Dire
97f77730bf0305ec82ec7d3abf2fa9e4,699,TRUE,1559,860,Radiant
457b83f4f80964786708bd6f4303373e,494,FALSE,1193,699,
a030ad9233c7fc3b61a747c1bfff0616,548,FALSE,2508,1960,Dire
c85c915d3151c9ae9e63b8d6273e8081,456,FALSE,2075,1619,Dire
7409eb4aac7b138dadf62dfea07c4ca8,303,TRUE,2885,2582,Radiant
d46154c03f4a8effc2bedb0a31bd0f2b,1814,TRUE,1899,85,
8f09ca32b37d025397e1fbb282591cf8,2555,FALSE,2771,216,Dire
d30de1891b345e5b6dd51a621c300554,929,TRUE,1525,596,Radiant
40317c34210491d9d5d090d9f609bf66,2285,FALSE,2773,488,
46296e4e4a2476f9f46bbd3197282fe1,1907,TRUE,2143,236,
e59efd6e55c6c806b13849ec3f188186,1765,FALSE,1840,75,
5cb86a94eea3600aef8ce651b64bee56,723,TRUE,1647,924,
d38e3d194427e75dacbb0b9ff7127fa6,1088,TRUE,3715,2627,Radiant
ffefd648b42f335a32c5da4d85682e9b,1175,TRUE,1703,528,
075bfeda3a6c47c644c00aa4679812c3,1931,TRUE,3986,2055,Radiant
c2174d34974deede27504076d8cb750b,1744,TRUE,1997,253,Dire
d5504f2bc74acd813826d6c8f61e4229,510,TRUE,2945,2435,Radiant
c01016bba686f6425d00881f86518076,467,FALSE,3139,2672,Dire
9f7078409c2378a5513ec40c01baa9a4,82,FALSE,1028,946,
427c9774c94d8ebd1596508dfedd937a,1962,TRUE,2311,349,
c6194e3bfe33e3df964961673a4f7956,552,TRUE,2365,1813,
97e635ae971ebcca1ebedb54349dc9b4,732,TRUE,2505,1773,Radiant
09f37d282ef613cc59abb9df45fe4c60,606,FALSE,1446,840,
875f9ec90d4233f6ad9e799d91a17edb,624,FALSE,1425,801,Dire
8fe2ddd46401e24c14a469eaa04e46f4,900,TRUE,1662,762,Radiant
2f71ccbee44eecfb2a9c9caf03a1c855,1352,TRUE,1766,414,Radiant
98079ed3805431a113bf0993bd386a42,1010,FALSE,3571,2561,Dire
e987c7d009ef452d6ac82cc4982c39a9,268,FALSE,1904,1636,Dire
01e661789bda826d42f2e9ca0e5547d9,316,FALSE,2083,1767,Dire
04e0cdc3523e809831dd81a47bab7220,1839,TRUE,2771,932,Radiant
fd47f9b39df3896a05b61cf964c58096,596,TRUE,1786,1190,Radiant
3c6ce911e9c43b66e955dca62f401879,1103,TRUE,1983,880,Radiant
946a293749f13dc4ede81b15a2315297,210,FALSE,1899,1689,Radiant
50efd15095dfdab7143e55b0261dc864,1033,FALSE,2240,1207,
f291cd722080d007ed5e4048815b24c5,1819,FALSE,2187,368,Dire
2482f83e1e525f7c033cbfbaea5f5f2f,1212,TRUE,1607,395,
00e829fcb8b3f80583122cf9ab5fb7fb,1846,FALSE,2973,1127,Dire
a8949cbb9a5f01e3e5dbde741773968e,1479,FALSE,2643,1164,Dire
ffb3f4227175a37f9f3f810d6218cd3f,1998,FALSE,2540,542,Dire
06d76c402e54adf2c987dc2dd866fe5d,522,FALSE,2038,1516,Dire
4ca2d7e2461bd8fb453d1d7fee05021b,1084,TRUE,2359,1275,Radiant
afb2b9d40f7571ff4b509f407fb7b668,228,TRUE,2898,2670,Dire
3e04e071284d99e5222834172d10dee1,242,TRUE,3043,2801,Radiant
37cfe62d63a8730292bbc580bd282150,2895,TRUE,4255,1360,Dire
c361000325ccca602fbc42759f0fdbe3,1804,TRUE,2540,736,Radiant
146add3013c6a70acc44f5a30b960d7b,100,FALSE,2057,1957,Dire
dda363c5182651c3ae580c82cccf95f4,506,TRUE,2157,1651,Radiant
a62e11ca7def7d6c2bf7d86f3866d8ee,596,TRUE,1514,918,
405e014b8f4559d14f2565b0158ff1bb,1569,FALSE,2232,663,Dire
4c4409d10edd88340d56117a1a07d519,537,TRUE,1681,1144,
4658e9eb9a3f4629c88f69ebad01759f,541,TRUE,2278,1737,Radiant
5eed126ae9989e4398f2b135c9fffda0,52,TRUE,2465,2413,Radiant
e06fc43ff75b2dff3f45646e8c9a7132,1305,TRUE,2622,1317,Radiant
1c3471a8ac285c235a20caff3f0aa378,120,TRUE,2233,2113,
83055e859192cacdddfc6aca180dd0bd,1314,TRUE,3818,2504,Radiant
d6fd0d01414672d3aaec1ab5ce5ce634,791,TRUE,2547,1756,Radiant
a9bcb02dcf4273591bf1d86b84817c19,475,TRUE,1742,1267,Radiant
b269596cfcde5b0f2def58cdd7494eae,107,FALSE,1689,1582,Dire
5359c427f21fb19899980f9a5cf60ab6,303,TRUE,1599,1296,
66848ff534270508a85e17394dec219e,898,TRUE,2196,1298,Radiant
130d5257960be9d81640fd83fd7b91a4,1859,TRUE,2396,537,Radiant
54e9d02dd4a1ead51b3e185126ee63b2,1866,TRUE,3068,1202,Dire
807270f0c97665745c2d60e3bb76e211,1812,FALSE,2262,450,Dire
e19a5fdfb12cd5bb6bb40fd2bae42cde,352,FALSE,2407,2055,
d50d636d3288b1f3e4e646eac96b481c,616,TRUE,1845,1229,Radiant
5d31d3a123b24e24b37908cc9e376f87,341,TRUE,2779,2438,
9a15a1eceb4f04c3a7bfb9912469d804,24,TRUE,2411,2387,Dire
277c2e5a8e56f21e598ade5900f2a176,1509,TRUE,1686,177,
52a4043147b185286a9f038d378d8e66,810,TRUE,1226,416,Radiant
cb4b111d8a7cab6f1fb6ca92be6d8f66,1880,TRUE,2530,650,Radiant
2001f944e8069bb2a7d554e122f4c425,616,FALSE,1533,917,Dire
837947830ee9d6e51e6fcc8a5d474e0b,1549,TRUE,3992,2443,Radiant
3a66a23ab5c9baa6c4386bc2e79e7b2e,912,FALSE,1573,661,
9ba301d205a66d0c38136ae250cdf030,1241,FALSE,1620,379,
7d95f9f3ebcb8bbae1d3b89c68ef08bb,1735,TRUE,1895,160,
668e91c7b412e2935ac125df7f51e7eb,22,TRUE,1385,1363,
1b4304d639f65fdfcdceffbf3c291ada,882,FALSE,1392,510,
682cdf2dd5f7a2604dbd8df290fd4020,790,FALSE,2596,1806,Dire
da06b06f816a3d2665d12b8435691f64,83,FALSE,2964,2881,Radiant
56116ee898f36c2170d7d2c6e816170c,1533,TRUE,2489,956,Dire
0dd13cf4b6763c60d2b639821d005791,1301,FALSE,4560,3259,Radiant
392a1edc453b3a79f184c0125b0adaee,1062,FALSE,2832,1770,
59804438a266c8790f532c46e4154990,1207,TRUE,2404,1197,Radiant
f0f9c7c19d5a1ddd8d0fa3171b143037,2358,TRUE,3339,981,
09cff0773f4d7d55c12b663325a5a104,2068,TRUE,2456,388,
6b2034d5044a3622d45c9f1fa36d62e1,1005,FALSE,3023,2018,Radiant
17880d05a303b28978758fb2bba38853,236,FALSE,2847,2611,Radiant
8da7a32935cd3260fa2d03b5395903dc,967,TRUE,3418,2451,Dire
7477441538e75dfd8d345371900f8c85,1288,FALSE,2237,949,Dire
fda9274620434351b66a8d18c6e404a4,762,TRUE,2988,2226,Dire
cf365ecb880d3b088a9ae758dc4818b5,833,FALSE,2242,1409,Radiant
6323a4628276039e180b1a9a7d4d4589,1367,FALSE,2188,821,Radiant
9588ef22d0edd71b45257e995aae1de8,1109,TRUE,1424,315,Radiant
a811cef79fce5b692ffd8fc3abd7e0b0,1215,FALSE,1906,691,Dire
71d925e86f21207e3d3ebd4c5b424c98,819,FALSE,2250,1431,Dire
94b598fec825161acfd7313886537013,279,FALSE,1290,1011,
321f90ef95202dabc3dd64299f20a897,297,FALSE,3159,2862,Dire
795cf757e2c73553db54be81755456c3,477,TRUE,3385,2908,Radiant
c533d2fcd46a0f4ab033275848b22efa,890,TRUE,2003,1113,Dire
48b0784b4f0d2c7c90bc6d6bb384528b,1278,TRUE,3360,2082,Radiant
81a6a384a158c737ac5e81fe7639dd63,415,TRUE,1720,1305,
6c5809e66acdbe04b2f8429a4b1a2881,127,FALSE,2412,2285,
c26424b0f6c178f81660a0b4a7d7c9fe,140,FALSE,2490,2350,Dire
04c9fbb569e7c35de53f20268937f1a9,360,FALSE,1517,1157,
cb6f2fceaf379fa77c9b35ab5e59248b,1694,TRUE,1730,36,
2ab7a1588b7711ae685c685f60ac38b2,36,FALSE,1278,1242,
a7f7e8b4589c152294f30115d5cb0fff,1622,TRUE,1850,228,
bf85736cb3cafd79074db884051197d4,999,TRUE,2659,1660,Radiant
aca9396b20576e49afabbc586162feea,337,FALSE,1671,1334,Dire
f1b66db155fc0ab7a678212b04def89e,1,FALSE,1782,1781,
e131705771794071c3245670489379a6,162,TRUE,1654,1492,
524c04739ea2317ec8d469809d9ddd91,2428,FALSE,2566,138,
4ef7641a37ba964a5abea6dbc24bd02d,656,TRUE,1757,1101,Dire
21b1a464f3dcfef0e9beb7cd24119e66,279,TRUE,2198,1919,Radiant
b146de7718707cd7069dd8025bac22f2,2197,TRUE,2528,331,
beef17204720ba94322abd01d917292d,551,TRUE,1289,738,
7fc8c3c06232ffb81089b482d61406bb,2590,FALSE,2734,144,
aa3a12768112d473d9d2d4a3b6be83b2,473,FALSE,1633,1160,Dire
b86776541ad78d366615931e21e11f1a,608,FALSE,3291,2683,Dire
c486b9992b2114bcdc0b14c48ae0aab4,120,FALSE,3239,3119,Dire
9e20ce8f7ff0a6db297d0c48734a8aed,99,TRUE,2334,2235,
d92e50bd6307b0d5d0030d2ba9d24ef3,1532,FALSE,1614,82,
3922fdf0fccf8d9f53f1f0b741ef0643,678,TRUE,2373,1695,Radiant
ea6f7a4154d18473be2297ac5dac8194,2772,TRUE,3544,772,
63cae73b3783c090294ba9107045c680,4156,FALSE,4820,664,Dire
dfd4d3b2907afb1497625bb503918638,1416,FALSE,3000,1584,Dire
e1c57401fa0f2af6fd3cb9a194457f72,1199,TRUE,2612,1413,Radiant
89391a4ad3b0c477e3fad3e171d88664,1678,FALSE,2346,668,
30f0dc9fe0f2aff0e698aa88f48a3c8a,23,TRUE,2013,1990,Radiant
a8b89ee517f20d7b675b10c4fd3a5d0d,1108,TRUE,1415,307,
5c34c745e162746a6181317b4c0239bd,348,TRUE,1871,1523,Radiant
b10006b1b7d4e0083086c72c681f6ad1,1508,TRUE,1916,408,
37d8bf902b96d16f138859963214e1d6,1221,TRUE,3639,2418,Radiant
875f1a8afef7b05fb57a3652b03b0ee8,504,FALSE,1747,1243,Radiant
7f3318d89dc3455f05aada92de631d1f,1835,FALSE,2450,615,Radiant
094affc9e9c697d33cd96e8ff6f1930f,688,FALSE,2634,1946,Radiant
71f76dcb95dd90032e0ffc737ae4760d,1249,FALSE,1877,628,Dire
271abb4792e89f92c5526eb349aef950,1239,TRUE,2481,1242,
1f8d4a6e57fd619e78f85b9db9f683ea,749,TRUE,2769,2020,Dire
d745b9eb35fd76e2f4dc47102f805a42,288,TRUE,1056,768,Radiant
a2e3656dd7414de343a8e0ce6eaefd4a,1149,FALSE,2378,1229,Dire
2cbb7586e99ef2227be649684ca41ffd,735,TRUE,3060,2325,Radiant
e3451ccc4080a247f7f56317f3564742,176,TRUE,2417,2241,Dire
a23abd332f1d0fe34502e0b7f14fb221,769,FALSE,1229,460,
05eeeb8100260fcb88aeceadffe16cda,812,TRUE,2357,1545,Radiant
e066ae5196e712dd6a8f39bd40364204,789,FALSE,2230,1441,
16cddbcb928caaa73b28e1180a8da6fe,900,TRUE,3500,2600,Radiant
c9f20e64e04d547d07f909a0da2e73e6,114,TRUE,1693,1579,
c918ba142e28b6e53951a193e160893a,394,TRUE,2113,1719,Radiant
47c92d21939c25df0fecf84e90771751,331,TRUE,1636,1305,Radiant
453d8e559851d8dc5c1a6d706dead062,1462,FALSE,2050,588,
0c64799c37a86248c0ab2a029f0a0214,1266,FALSE,1517,251,
444bdec9971a7dd8ba44d9cf7151bc2c,318,FALSE,2645,2327,Dire
104f248f52a062b8d3d4c6bac9d47d97,384,TRUE,1959,1575,Radiant
81ea1a4f6869a7683110388e7c7daf65,257,FALSE,1948,1691,
377493ffd19e72e27ea8dcb37a1b6b2e,2039,TRUE,2179,140,
58584751e66d49360bf24fa58c103450,2128,FALSE,2378,250,Dire
e14a2aa9649ff37ad4acd863d6fbb255,732,TRUE,1370,638,
4d0f514f7bfe6e69afa1f41b6575b7d3,1644,FALSE,2470,826,Dire
c586209b6a6dcecd752e3f7f34dd3385,69,FALSE,1793,1724,
927e00a998011c87327916df7ee78e51,2351,FALSE,2460,109,
5a7022617d30887bb709ab29512e96a5,2385,FALSE,2787,402,
551add8a2f66e704b2df8b1b728641ee,1611,TRUE,2128,517,
ab39429cab870db5db2c47dc04a39157,1388,TRUE,2449,1061,Radiant
f333c38fc6bd2f1324130af08ae70853,194,TRUE,1095,901,
db3814dabd3f423ff6c0ea4bfd514093,241,TRUE,1594,1353,Radiant
df16fbad2287a92f20cd8b68905985c8,269,FALSE,3427,3158,Dire
ad69143bf59a43ae09a8c041988ba09f,272,FALSE,2246,1974,Dire
3b09d8e9055da207c42a752c491a3808,685,TRUE,2165,1480,
0126d62f59ada378b98aa27c6e7134bc,2066,FALSE,2281,215,Dire
5c07d68c7918ebd8bd1bf42ceca21f62,482,TRUE,4040,3558,Radiant
638bc471c29bb0cf67d5538236c91c7e,805,TRUE,1508,703,
5f3b2dcf78326b8393c584b6794903ce,1093,FALSE,2494,1401,Radiant
bf7aaeeaea2091a9865d41176e97d2f8,985,TRUE,2832,1847,Radiant
7c0e42c94ee38c0e41a5295901b5d4fd,1347,TRUE,3214,1867,Dire
9d74c547122bab72fe84fd0085173f82,1906,FALSE,1998,92,
90329723070148a6b97c7e3c87ccbc12,743,TRUE,2144,1401,
23c3ee3f486aa12f1156a67776f4981e,87,FALSE,2323,2236,Dire
7f391751513ee9b36ac9ade3618db52a,2184,TRUE,2641,457,Radiant
74d6e3b92c3660e7929f38c556a96c96,1589,TRUE,2063,474,
325c50886fe0a5edd079aa5ee2623b3d,1176,TRUE,1584,408,Radiant
bfb44ef07bdfdfa1656d1095a1b15d25,151,TRUE,2066,1915,Radiant
a48ad00a4c1244f9cfe7be6cb45f6d74,1564,TRUE,2613,1049,
14195d01cbbda3cd91b39e0654f8feee,1543,FALSE,2040,497,
ac1405ac220ae8c8ee3926364cf276aa,1063,FALSE,1602,539,Dire
c50025ab360452eb5e4604f79cca1cc8,263,FALSE,1864,1601,Dire
04fe20780ab536969b634cf43bc1fb88,1691,FALSE,2022,331,
f6e9d6e84d6677b2a2ca9d623623afa1,2225,TRUE,2483,258,
29d8e46de54163456630a7107bde62e7,2314,TRUE,3025,711,Radiant
6a87077753f6b5919639b799c58d2e9d,1679,FALSE,2094,415,
5064e8ac006e911928fecd8b63c5b75e,902,TRUE,3750,2848,Radiant
bcd2edfbb15c21699ba3698067a8d799,1509,FALSE,1876,367,Dire
bc1703306cf8b8b5a14de3405e87f61f,708,FALSE,2625,1917,Radiant
40a00b56dc1347ec61ed73e1e48f0f23,1907,TRUE,2369,462,Radiant
cffd82de05b21dd031e22794cc468f2b,580,TRUE,2783,2203,Radiant
e0694c0405c5f8d3eae204d510bb786d,241,TRUE,2080,1839,Radiant
28bef12b9ba595610db7201e38025a20,940,FALSE,2478,1538,Dire
4305847374b39e118d296b992d135285,933,FALSE,2343,1410,Dire
54974c4a856a633421bb640c4c36b6fd,664,FALSE,2503,1839,Dire
23bd217e4619b5dd214baa777c147eeb,2218,FALSE,2543,325,Dire
5d0984f415872b241cdbb1770cddc050,1455,FALSE,1799,344,
f497987aad78593d687314e7679e4ea9,812,FALSE,1876,1064,Dire
e5e49d0cee384773be17fd37ffae19c7,2174,TRUE,2300,126,
92a3eddfffd06b3b0f9f73e2cac6f92c,837,FALSE,2769,1932,Dire
e91da98230388f3220599ad0d6989ca2,579,TRUE,2127,1548,Dire
96c97a665e2d98b604279b350e501706,2472,FALSE,3020,548,Dire
c64a5c53bcea680052e308a09384346d,1848,FALSE,3551,1703,Dire
428c9e65e84ee1f8b8f27cfc72192018,1997,FALSE,2306,309,
cc10a5729f76a2d0df81fc8bbab28620,330,FALSE,2097,1767,Radiant
997be87d1069706ebc2344b0356ec36d,568,FALSE,4193,3625,Radiant
89ac152d6df20ba4468fd5da569e7ebe,895,TRUE,2196,1301,Dire
07125441e5578da3ddd4938e10d648b9,2409,TRUE,2662,253,
3a9ed593bc2c1b2f0f827d678a96dad2,2027,TRUE,3697,1670,Dire
c8d4764875c19d1a83348bf778acb5f3,1222,FALSE,3989,2767,Radiant
1d29a0433966adfab93592afe0ef5f34,2293,TRUE,2468,175,
eba1086c5e065cab9097f49f0ef06022,950,TRUE,1194,244,
7da1464ff8d1980a4d6a1dc07313fb3a,954,TRUE,1671,717,Radiant
afcf056d341312174075e06bd285fee8,1895,TRUE,2016,121,
653d69c8b60808add2d324af741e6965,2285,TRUE,2464,179,
51cf38720851d9b441f2bb7975d0b409,1301,TRUE,2063,762,Radiant
41be97fe79d5f05812112e93cf8056a7,392,FALSE,2978,2586,Dire
59ab93034a061ee71a4c8b6ca0c3e1f3,778,TRUE,1626,848,Dire
bac935a99699e821e8c7206a98004c80,553,FALSE,3733,3180,Dire
7154cf987d4e3d3acce8fef9a29f0f43,875,FALSE,1422,547,Dire
9004756afe6f47d8a206dacd45f44c92,1015,FALSE,1742,727,Dire
d76acf6d24e26ab2b9215ad27b3dfce7,1591,FALSE,3262,1671,Dire
6eb01bc77aba6b7f183fbf0a5fb4e178,2125,TRUE,2822,697,Radiant
b193fd928525d63f0e79c1ddd622f208,2358,FALSE,2770,412,Dire
b9e41f1d3fe5bdd71c7fa9978dda07e0,1308,TRUE,2518,1210,Radiant
605b2d7af078cfc5d0ccd0c640fab316,818,FALSE,1999,1181,Dire
4fd6bd52f5930161849623f7949f65ea,770,FALSE,2190,1420,Dire
ba4499cb8286556b3a209d96cf657bb4,557,TRUE,2231,1674,
8a579161350ced9949b6a801bcd03e46,126,FALSE,914,788,
e8dd090c0846dc27e6ae8f286a14a8b7,1915,TRUE,2127,212,
62a62c76cad0307234cfe2a2a986c24e,1443,TRUE,2389,946,
9bbfec26cbfffdaa7b78d5b5485cdb40,1965,FALSE,3524,1559,Dire
87e2422e572a01f7e2385bc16c755f4d,519,FALSE,1869,1350,Dire
b6d6f23b542af97aa34bcab3332dfb07,1308,FALSE,2405,1097,Dire
d595e4a01ed25e87cb86109d582bd8b2,1385,TRUE,2869,1484,Radiant
ed75954f8e56134f1331c43a1cee3ab0,1364,FALSE,1798,434,
5a0aab408a8e6c1cd7c6c7122922d6b4,2561,TRUE,3580,1019,Dire
fe7705a3064f4bb04baf582f8b9296aa,1782,TRUE,2218,436,Radiant
ff97bbd875e82df66d2e79aa502307a4,18,TRUE,1741,1723,Radiant
ca62795398f72128a6d45c2614306502,607,TRUE,2086,1479,Radiant
21a0f7fdfb6027f0f06775a47c6e90f1,37,TRUE,2488,2451,
df2e95ae4f08c4b29ffe6c3d12043ddb,2709,FALSE,3461,752,Dire
f5912393c5df3eff3f200dff7c767835,2371,TRUE,2917,546,
2e1b003c35b71cc9d33b941f44fbe65e,906,FALSE,4151,3245,Dire
dd966ae35b54a3a8d20149d7d8d7b15d,1239,FALSE,2060,821,Dire
e50cd5ad1862a1b28799a0a07a306a32,2197,TRUE,2275,78,
6d5b080d97ef26dfb7599689a82e09ce,241,TRUE,1647,1406,
4bbef08350541b5a87e380c144391f59,2106,TRUE,2953,847,Dire
f31e1e6d220c8ba36b9a0baf5cde25b6,872,FALSE,1678,806,
c07aa275c9e3f949403cf18ac124dbbf,878,TRUE,2484,1606,Radiant
bc9ce36f2edf150638234111d7521c9b,1552,TRUE,1798,246,Radiant
17645c42d7965208c4a1314b2fbb0daf,757,FALSE,980,223,
64748c601cc6490e6fcdd0f3f456c19e,551,FALSE,1177,626,
9b2daac9d5e62a25fbf124519e2fb26c,1331,TRUE,2344,1013,Radiant
3e5a343bb20305d5afa3c7f0360b4017,1452,FALSE,2005,553,Dire
aa0eba812bfcaed0cd402d204ff62354,961,TRUE,2232,1271,Radiant
ff248702ff03cb202841c8806cd2a9d7,878,FALSE,1144,266,
6d00585bbfd247b373283d4bba7f9292,1179,FALSE,2229,1050,Dire
ecef181f430f92dc6988dbd4f39e56ed,1175,FALSE,1776,601,
c3de8dc2c2269409608711eb50fba4f0,1211,TRUE,1561,350,Radiant
5c173421faa016016d3e3d4509deb6d8,1423,FALSE,2294,871,Dire
18be246506f59fa6829da0ce165cc5ab,1567,TRUE,1782,215,
74d7792f88d54fc1c88a1b9bcbcce77f,306,FALSE,1211,905,
21947cc36f6f14cf24f3fb7d1aa6b13c,753,TRUE,1667,914,
0a3f26ee28fbe590f9d67dce0498bf92,763,FALSE,1363,600,
b3da94bdde1a11fa1ad104d7699d64de,307,TRUE,1021,714,
acc6b6ddcacc96dc587911e87b674878,784,FALSE,1073,289,
3d4af0c8cd59695b214a3359cf8f27f0,1205,TRUE,1997,792,Radiant
723ae52eefc6cd472bf8d01371ecf07b,1187,TRUE,1787,600,
5807cf4c868b80ce50deaf3f37a1a90f,1160,TRUE,1623,463,
ef2ab0f7ceff088d61d17fe6381eed02,1158,TRUE,2473,1315,Radiant
a52cfd4f8a62d827f370cf83a9676535,2090,FALSE,3023,933,Radiant
e840eac5aa8a03f00aea9031528dc3a4,144,FALSE,2341,2197,Dire
4052648ae19376866a2745a7d790b52e,596,FALSE,2084,1488,Dire
f0b9e4eb6194c345c050e570a1aac2ab,488,TRUE,1409,921,Radiant
0eda76ff14c0d9c8b9a7496c5a0e2769,1463,TRUE,2047,584,
1409f5a9885cb77148d4cd737a39b60c,1709,FALSE,2629,920,Dire
67fd0e5e9a17a3090be8de3999d0e8a0,1325,FALSE,2702,1377,Radiant
588faeae6218ca276a6bd49c1f499959,787,TRUE,1132,345,Radiant
59c0b8a020800c3273efd18b47217a52,598,TRUE,2068,1470,Dire
3bd32ce95c2fa33747c120e023a98b07,1834,FALSE,2727,893,Dire
d5e62a01819fc6ad431013921fab2573,1062,TRUE,2135,1073,Radiant
9af75246b52015fec01c81a04df1b417,2202,FALSE,2902,700,Dire
9b2505cc2e70cbfce0421d26ec8f3b08,870,TRUE,2880,2010,Radiant
4d83b88b3747897657d13ad97e516dbb,36,TRUE,1686,1650,Radiant
cdd76b6894f675fbf4a370962ec1a61a,121,FALSE,1359,1238,
308dbbd862a2fc1912ed1028b479022d,418,FALSE,2532,2114,Dire
d1f00bccbfbb6a9a8a5eb0a5ffd27253,395,TRUE,1300,905,Radiant
9767b20d24baaa75fb5261fd4f5438d0,1614,TRUE,2281,667,Radiant
7f432160566aa3fe41ec52d65988a694,885,FALSE,1902,1017,Dire
f6aa6b78cf030a0437df6a65b11b578a,1474,TRUE,1719,245,Radiant
6abd0a906fa6fc881613f179d35937b6,223,FALSE,2089,1866,
7f05781f01caa1beb32ab3790e297c4c,415,TRUE,1926,1511,
62a5e3f07ff37ffd74b6ef2a17ee3464,436,TRUE,983,547,
69e3399269e8f30926be9d20801dda48,1242,FALSE,2865,1623,Dire
8d1e5f8a54c91f744252a545fbaebb2c,891,FALSE,2662,1771,Dire
73dc06a01205751cddf6d76ef7a46b17,3121,TRUE,3648,527,Dire
d6c9220c97d209fcca48a4118bdc16aa,249,TRUE,2076,1827,Dire
a7bfaad5587e30a4fc278c8292dd12e8,569,TRUE,1466,897,
1bb79a5ba21c2a6b6759c2b960700241,2494,FALSE,3156,662,
0224fd58d63426c9862ce3b2812ecf2a,3331,TRUE,3589,258,
041ee2641463ccf183a05043e53a7d05,2199,TRUE,2390,191,
0094ffa705aed0dce25614604892f30b,722,TRUE,2493,1771,
ddb0119c99684702a25d9b26afa2ddcc,1831,FALSE,2445,614,Dire
3d61004c2050d6d8a3061c6349125204,1154,TRUE,1950,796,
9ec6f56fbca0395e12dc7f218e065ee2,1386,TRUE,2822,1436,Radiant
2fafed4268841ed79b28623c6159be40,519,TRUE,1949,1430,
5c518da7f74b9332a201a3ea89cd0c1e,2276,FALSE,2363,87,
c66b5a64dc148e2f8ac191778eda1514,350,FALSE,2477,2127,Dire
d3f72adf36a4f3d721a7c2ddb8dbc768,2551,TRUE,3567,1016,Dire
6dfaab5fdad725a07f144ccfd432f1fe,48,TRUE,1152,1104,Radiant
430d45018acdcf0da4800b22fe6e3712,709,TRUE,2383,1674,
66efb20baceba06cec97c254788e47ff,998,TRUE,2569,1571,
ecf6c7950878833c6eb1b759129b2ce8,783,TRUE,1789,1006,Radiant
46c8cab22375820b60d557243a88481d,589,TRUE,2679,2090,Radiant
75ce52804c3ba7e018a2f3010e368315,1142,FALSE,2194,1052,Dire
0f3c2e32e60a2130efe3ae8295b4f702,1028,TRUE,1094,66,
cbdf39c862e98ceda78f15f9487b7301,1122,FALSE,1366,244,
9dbea9df6f05e6e68e73804d3934d044,661,TRUE,3090,2429,Radiant
ea7294fc82ebec3cac11a500279217be,913,TRUE,3182,2269,Dire
e548af386a7f828354b8dacb0dfa671c,1867,TRUE,3237,1370,Dire
cba61bcf794dfc83b25eac85214abaf3,1266,FALSE,1869,603,
a9b704237fdacb76a78f3f2427aac2d7,1947,TRUE,2169,222,Dire
8deda76d214b02e39b49ddb8eb83c57c,453,FALSE,3460,3007,Radiant
743b255b3cf6898ff94f61d10f240fce,827,TRUE,2307,1480,Radiant
b860c93927429430859c5d9b78e73b63,806,FALSE,2663,1857,Dire
1bb347c4257c2dbe353455bd9589f0da,1136,TRUE,2478,1342,Radiant
df19a0fd2505d9eed077c88bd14b85c6,391,FALSE,1617,1226,
0eddeee271aa8312de6b557de83bdd58,1157,FALSE,1374,217,
cf6e37df3b4fcfcbdf26a8097ffea1bf,1923,TRUE,2353,430,
2a32c538075e19e477984bd521b46f66,694,TRUE,1964,1270,Radiant
af707c6930aa7393a129f91901c09cc2,572,FALSE,1276,704,
fc6917cc11213f2e2e24c0fa9b1178ab,376,FALSE,2521,2145,Radiant
cc7d406da77575523bd59646ec180eaf,506,FALSE,2358,1852,Radiant
fa56b260796d479a3caa4fdc9c7a9dc5,1070,FALSE,1904,834,Dire
3c102831fdc3fa188af6eec6eb019a35,1604,TRUE,1645,41,
8c6c536d3df6a4adc303cedc81063c7e,1870,TRUE,2156,286,
6a5e79554b5ccc89a241801cfd2ce994,2245,TRUE,2526,281,
6dcab5a1e603d8ed10d415f0e2b150ef,2076,FALSE,2311,235,
19d94a4d726710e5addc3eed32ba5a3c,1376,TRUE,2148,772,Radiant
2caf6239a58b1032ca220295cc32dc8d,1413,TRUE,2666,1253,
4c19b0b84a29297d2312f79633a812b3,808,FALSE,2579,1771,Dire
eae57590adf3de4b359659da25cf08fd,1262,FALSE,3117,1855,Radiant
595df7a6a6460870c894df0d577e6a1f,327,TRUE,2365,2038,Dire
73075e060d60080ad6f68a3517126a61,520,TRUE,3724,3204,Dire
c3a607a414165102388dde77ccce105d,1856,FALSE,2423,567,
7618146a8008bda883f00a6062149885,1065,FALSE,2872,1807,Dire
3b381adee15c208e3128e3e574e01c1e,1390,FALSE,3042,1652,
b1285e5ff5a69c76b3ad8cbd72896a25,1089,FALSE,2194,1105,Dire
a239338495072e559c749166483afaf0,916,FALSE,2331,1415,Dire
aefe58958f75826b0703f84b5d65f7cc,1333,FALSE,1618,285,
65507b742f8d534ffea04790a8cb179f,1610,TRUE,2436,826,Dire
d2e601dfa9f3e39acee7a8ad624c97c7,1703,TRUE,2238,535,
3efd1bac68bed56d9bd0b9c31d77d521,1052,FALSE,2182,1130,Dire
58e070332f814d36f070f2c292f1866a,765,TRUE,2046,1281,
09e11528b931724e30e2b2ddfa669c7d,266,FALSE,1902,1636,Dire
e85308088ba7ed99abbd1b84c610bb62,2036,FALSE,2341,305,Dire
d10b7e760bc9b148f900672f75df2eec,1513,FALSE,2625,1112,Radiant
e03fe43ab0d2f1eb664795a371823bfd,1906,TRUE,3448,1542,Radiant
03662635ba139076f59a7c8f2b16172e,783,TRUE,2272,1489,Radiant
efb0b9eab2b55aee793d6c35d625d6b7,1884,FALSE,2005,121,
751d0ca0e3dcd38f8c8928071735985f,966,TRUE,2175,1209,Radiant
cba9d83efd0ed5a2f54f6251435adabc,2043,FALSE,2331,288,
a5fe4b4e1a1e437f7e13fd1d973d79b7,653,TRUE,2259,1606,Radiant
b18e5cd4971a52f27266641eef03c7ab,289,TRUE,3532,3243,Radiant
e9ec952d8bbc2c47063983f68ebea7d6,791,FALSE,2693,1902,Radiant
77c09d7beaea3dbb8bafcd1949b5a0f6,479,FALSE,2901,2422,Dire
dfcd61f8d83aa8d2a77a94409f14c984,1670,FALSE,1859,189,
53abd0848dfcdd9b592d56725583f144,2110,FALSE,3477,1367,Dire
76cd17ac00996b6c9b4c5508ba7b100d,521,TRUE,1283,762,Radiant
fa16d1e66bd23f7736fdc5f62cee243f,1633,TRUE,2187,554,Radiant
2abc6a9872c9bbdbfcfd25dd1f46d748,785,TRUE,1322,537,Radiant
501ecb39b21ccf8d7f15090450294556,2891,TRUE,3243,352,
e1212fcfe427dc18fe522d013211057d,314,FALSE,1745,1431,Dire
47fdac23a7716dd98e097bb41da40e40,876,TRUE,1942,1066,Radiant
aa3a2d11de1b22039aefaf2aa8411487,819,FALSE,2064,1245,Dire
f228e78bb40ed0b6c93f7e9f85b77a4c,724,TRUE,3221,2497,Radiant
76308506e4d91c6d14b4fea7ffce043f,563,TRUE,1318,755,
df1e957bc1f4243d50fd12f71d194a47,1691,FALSE,2005,314,
c7009753d4e7b891e541243a1f8cd6aa,191,TRUE,1049,858,
340da27b574626afae4eba9bb3e9b722,981,TRUE,1557,576,
fcb79599704d4d5b5af48017d99bc4b0,598,TRUE,2395,1797,
3ca785fde9da0d99fad687b6bb26d40a,2089,TRUE,2486,397,Radiant
fd362f47f52a46d975cb076c23257236,1245,FALSE,2671,1426,Dire
1221f3ef0704392b7fec9c488c966599,50,FALSE,1684,1634,Dire
7e016094f7905f6270d76bf7aa3629c6,1502,FALSE,2378,876,
48b16dcb8163773ccaa81b88e11149b8,2259,TRUE,2600,341,
f683d9d8fa7c0fbbbdfdbd7f4d345dc2,327,TRUE,1419,1092,
3c3db3a205b96d8e1c3f0fa5bf0ac6d5,295,FALSE,1471,1176,Dire
be37b414dd3693ec1c500756cf28efa8,3702,FALSE,3738,36,
e9e6b8c6a44c7260bebe6919fdedc3a3,1405,TRUE,2011,606,Radiant
e1407c72054e07e3f0f7a5afafdc08d9,895,TRUE,2599,1704,Dire
dc390ec72a7c6e98424e95389e21af46,1261,FALSE,1411,150,
ecbcdfd4c1234d94d9622611e6f4fbdc,33,FALSE,2278,2245,Dire
dcfa4d4dec73efa9cece8d3d1fff745a,734,FALSE,2471,1737,Dire
96c75fb2bdac009c4e91b33b8b23dad1,1922,TRUE,1959,37,
6325888afccee6349a52a70e0c97aabd,1596,FALSE,2202,606,
4e29140bea4518c13c977dde86bf14a2,727,TRUE,1528,801,Radiant
39f97581a7408284ff950f59d6fdbbfb,1817,FALSE,3269,1452,Radiant
341256af1d40f08d2550f8399e267928,1421,FALSE,1980,559,Dire
15c5397c6420a160644a83831ed7bc7d,411,FALSE,1620,1209,Dire
267c1b926c099e6f843270d82b102767,332,FALSE,2162,1830,Dire
5948951f0c8fe2972258e7fe0ac8b866,301,TRUE,1078,777,
440820d140438ecd6dd466ae3bf37248,1651,TRUE,2564,913,
a8fef7abcb0064126bc9735d2738e921,1346,FALSE,1858,512,Dire
764626ad2c7098aadc22d0cf127b507e,894,FALSE,1647,753,Dire
4f909d990220eb90943002d25213b8a6,145,FALSE,1941,1796,Dire
89d26b0db2d5b599e2af9905c740d4f8,1516,TRUE,2050,534,Radiant
42f36682fd3dd586fdbbbcf61bffb262,475,TRUE,1442,967,Radiant
100509b185cd0c699cbd8611c2a27c9d,2689,FALSE,3296,607,Radiant
cc60f601a8c9ea4b4a0e94075b67c43e,760,FALSE,1811,1051,
b86f5f402c09e765afcea72991fe7f2b,2104,TRUE,2334,230,Radiant
8a02654dad191aa3d48d3b6f42ec848a,788,FALSE,1637,849,
9c1a89824001ddfca7e0bdda617da140,567,TRUE,1880,1313,
daf5594e7cce6024e4d560356fbb57e2,105,FALSE,2665,2560,Dire
ae6b071ff19cccdbdc4e43f8b63b06ef,2233,TRUE,2398,165,
0a4b368ca9f7a290e5aa5b7f2f33e0d1,263,TRUE,1865,1602,Radiant
39384edc8fb8e28e3bb87ae8d99dbf85,648,TRUE,1558,910,
261e21841c07a56412282dbaa3001983,400,TRUE,1930,1530,Radiant
5eaae8005d3f2bf99ba7d00841e820f4,705,TRUE,2611,1906,Radiant
42ce47ba08b93004d23a8c9fbbe79bd8,1441,FALSE,2399,958,Dire
be2bc8258f12da0ff9d244a6c8b0e7bc,2104,TRUE,2351,247,
dff0e75a55f116a890f5c345ae96a03f,1384,TRUE,2491,1107,Radiant
a3c6de39f6ba1ac614456c2c377fc79b,364,FALSE,2514,2150,Radiant
b5f82851b8f0019bf422216e3c9fd7e4,292,FALSE,2125,1833,Dire
a4d9c6a7378fe04f935e0c02450b5bf7,674,TRUE,1868,1194,Radiant
3ab591c2417a34b9830481fcb97ff217,1552,FALSE,1738,186,Dire
6daede16bc4e93b6f15f91b2a7e12469,653,FALSE,2106,1453,Dire
02506591e78d65da1120269aad65fa7a,1398,FALSE,1688,290,
28fe62042809f082a688f32cf72f90d3,221,TRUE,3672,3451,Radiant
25fd5bfb53c6f326d85ae013bd70815e,394,TRUE,2016,1622,Radiant
40801fc21d70a9680d7cb20a57277631,1515,TRUE,1871,356,Radiant
ac4f64520a81eb1e497e31f6b3a05f74,632,FALSE,1276,644,
73e456b26b20cc2181aaf8fe773d667a,2677,FALSE,2897,220,
daaed22a3163f1ac8105c311ac7c5d64,308,FALSE,1877,1569,Dire
be0f137f5f36fe92538bb76e2ed684fb,1111,FALSE,2277,1166,Dire
590ce6968c523539a3ec9031451f6054,773,TRUE,2422,1649,Radiant
12cf6ce8a8b5514e65065db72845c7b1,2246,FALSE,2623,377,Dire
3355db6c05a51597b81bbd58f00f6fe2,427,TRUE,3717,3290,Radiant
7d5e0ea65ddac1a0c57e67c7f9ffdddc,1108,FALSE,1767,659,Dire
480816c5fa2ef23fddd9deadc0540d6d,2602,FALSE,3341,739,Dire
31229d4c27a34cf03509a61984cc3799,392,TRUE,2486,2094,Radiant
f340f32185f9d7f665ee4447ffb5a0d8,2357,FALSE,3492,1135,Radiant
47c74340014bde735c5674e46ac979d8,1974,TRUE,2089,115,Radiant
1046ced05c0f8b99b4a9546ba09e4a07,312,TRUE,1277,965,
87143a0ebb0c5511fb1fd9d7ef66439a,2045,TRUE,2904,859,Radiant
427f133de80bbbbd29f5a60202efd0e6,359,TRUE,2492,2133,Radiant
6d898f8827bfd51bde697ffc19e42240,428,TRUE,1543,1115,Radiant
f844f9826d48141144c41d2fe54dcc23,339,TRUE,1336,997,
cac2758005eba97c362800ebe9f87d90,172,TRUE,2063,1891,Radiant
07b3cd871fa15ce323a1bc52b64c74f0,1307,FALSE,1560,253,
abfcf26a262f6758fbf69a4ccbd09234,2848,FALSE,3535,687,Radiant
cb981378cf6c76dcb42359e601647744,743,TRUE,1780,1037,
390d730d01e526561b0ea93f0938f46c,2086,TRUE,3581,1495,Radiant
e71db77472bb90e159b01977d6c5210c,2421,FALSE,4305,1884,Dire
d404837d45122b06a3faa3bbc116163f,97,TRUE,1797,1700,
a4ec95b00abc9277b4833f5fd2526972,397,FALSE,1783,1386,
9669c5688b4fbfae8c7dce69422e4f95,1826,TRUE,2784,958,Radiant
bf76eb33e64d024b6fcfe0c86885afbb,232,TRUE,1885,1653,Radiant
ae249ef1a8071a496fae81647063c9a1,2358,FALSE,2986,628,Dire
87638b800190c8f8d2dd781a5540c1c3,19,FALSE,1757,1738,Dire
54811944810ac92cc7dcaf172c228e08,1423,TRUE,1741,318,
a17e777fde78ec2b740f9c13db396a9e,1207,TRUE,2354,1147,
3131ac43a59247e4fb4bd5c2681dc791,1116,TRUE,1271,155,
52611eb434d22157cd9f66c6f5ca16a3,856,FALSE,2356,1500,Dire
07e90905418d024dd98249afcaa80eb9,978,FALSE,1304,326,
04b543db623937c65dc395bf16567aa4,589,FALSE,1656,1067,Dire
a54fdd2c69404f864e3bb068ffcc121f,1619,TRUE,2008,389,Radiant
1701c6e503b425122fe2f23e91987917,836,TRUE,2119,1283,Radiant
0fe7572b28869cd1d4164ad9376aa154,2535,TRUE,2623,88,
48ef96292360c3e4ec47ae23b4e5b2a4,703,TRUE,2490,1787,Radiant
3ebfee1738beeef711f5c6d96a8c32a8,464,TRUE,2292,1828,Dire
e20e5a3b4c9bc69a4fe6bddd47bfcf9d,1443,TRUE,1589,146,
5d3ab22a9decee5316f3a1e0ab28c4e4,975,TRUE,1075,100,
2f31b88872449875206d0f1c3776d135,1922,FALSE,2837,915,Dire
59ca938c688f4eca858966482d2389d9,233,FALSE,1610,1377,
41c1315b04515220fda77dc667ea92d5,592,TRUE,1519,927,
09c5f97202236ff6bfaf1f3f6917ff33,1350,FALSE,2130,780,Dire
fe9fccfefd3ff9d4218d8b764a8c10b6,1095,FALSE,2033,938,Dire
728fccb8d134424b0848d9c3fc034ca0,1881,TRUE,2280,399,
5868a2764e2b8a30398c47f0cc8a2cc2,1042,FALSE,1445,403,
105a4ddb960418cd77fed59e3f2c111c,671,FALSE,1949,1278,Dire
baec9543ad806820a18991a5f9050356,1225,FALSE,1308,83,
d7aa057d2956578b01809b79325141e8,1208,FALSE,2098,890,Dire
5b7ed708060c8518c8c590fb30439311,3007,FALSE,3110,103,
0234d655b4e24e8007637783d8f8fc4d,150,TRUE,1315,1165,
e204e52e7ccbebad672ee6c8716a9cda,428,TRUE,2220,1792,
61c61d8e9432b99e5ebff9dbbea01ce5,864,FALSE,1476,612,Radiant
a3de228b24b2f0a48cc3d19d39c40fe5,975,FALSE,1822,847,
4f6c6e04664659566171a749ee7bdd15,175,TRUE,2407,2232,Radiant
c4d63970c97b3e3e88cc002f9e5594fe,272,FALSE,2510,2238,Dire
c6fe512f4a10540094117fb9022d8d6e,1048,TRUE,1680,632,
0a5e5982423b16578d5fe76b00bf86db,583,FALSE,2225,1642,Dire
d9aeabc63a9aa029ee21bc391fd60493,221,FALSE,2331,2110,Dire
18d7f8026f972e261fcbc99f2a7f7596,466,TRUE,2939,2473,Radiant
3169cb2f9b4e2708c5efdb5378446e29,2305,FALSE,2546,241,
09437acb5fa2ce8f0bfaa5b7811749cc,1803,FALSE,3148,1345,Radiant
0faa47f8a44e3faafa8986487ea9ec0e,882,FALSE,2153,1271,Radiant
3e5bf4c18da10f9e6414c6b4ab17ce8f,1505,FALSE,2085,580,
3cd09ab517eae90d75e642ea2010a6b2,3040,FALSE,3156,116,Dire
7081dc74b844f669cf56527b27cf8b74,83,FALSE,1856,1773,
e2cea7290e0198f56fc2b3c925936d16,1192,TRUE,2081,889,
46c2902d699791c0ceb06d7b468a8310,341,FALSE,1462,1121,Dire
f049937388d8315a81a35d7ff9f45c18,152,FALSE,2180,2028,Radiant
1f47720a47398d87f33256529b36ae7d,1628,FALSE,2625,997,Radiant
09cf82c6adf9f486a497c0488bf0d98b,52,FALSE,2432,2380,Radiant
675552bf4177b589507cb6684345d591,788,TRUE,3098,2310,Radiant
46e7e2792d484bd60b258312811c9bbc,138,FALSE,1848,1710,
8c2e885c815af681dc23b653f04cd842,1152,TRUE,1722,570,
cf02570b1378d994d8e005a02bb51f20,2275,FALSE,2363,88,
58952f962ad60ef544736da514afae89,874,TRUE,1851,977,Radiant
6bbd74f8cfedbfc5be736ef0feea5bb7,679,TRUE,2260,1581,Radiant
5da1ddcb5f09a68cc5cab39419c0b477,1326,FALSE,2592,1266,Dire
7cc37cbf9cf114d2d816238be7468590,1614,FALSE,2570,956,Radiant
0cca896858c2f503643cb859b3445a38,1265,FALSE,1935,670,
9dc96a381dfdb4d3dd1732ba208bcb2f,58,TRUE,3030,2972,Radiant
3b21e8a8ae41eae92065a50951cb0e79,917,FALSE,1900,983,Dire
2f5bfda6dcc576ab5ec3135de794c4e3,1099,TRUE,1975,876,Radiant
abd2d8649a70a0c113183120ad9f2282,1243,TRUE,2643,1400,Dire
31f7f56a10b10af8c3a356ce2e8accb6,2944,TRUE,3338,394,Radiant
3cd709c0251f921a283d27c5a4e045d0,394,FALSE,2218,1824,Dire
a5a8ee9d3954c1f7691e14c39ef6c156,729,TRUE,1551,822,Dire
dd0d1e1048295eefbec9f8f25d657280,69,TRUE,2988,2919,Radiant
5c0744d8dc453a66ab432de42d67797d,2053,FALSE,3594,1541,Dire
128099d456001d698badbd6369fd75a3,260,FALSE,2116,1856,Dire
4d8101569c9afebceaa53652093e673d,842,FALSE,2461,1619,Dire
ee6ddefcd7803cff4cafdb427ccf1b30,2848,FALSE,3673,825,Dire
881f785cb85563877cf289184fb7cc87,572,TRUE,1584,1012,
57745e8651cecbba95259bb4152eeecc,1220,FALSE,4511,3291,Radiant
d5a31dd1cc83c21d6cb0d759ca4c4047,812,TRUE,1707,895,Radiant
b3a2fc14a12200ab87f2067feb6ef076,209,FALSE,3211,3002,Radiant
f59f49c28f21f2f0d8b8353f3a79abd9,604,TRUE,1935,1331,Radiant
202195efc19ca5e8a70b61b2cc2936d4,423,FALSE,2521,2098,Dire
5b2cb30ffa823df103736509ff6f9090,3206,FALSE,3350,144,Dire
62e6307df4d0906464ba3ad7deecfe4a,307,TRUE,994,687,
4823110d33d7d9321385c11e7fe339ad,496,FALSE,1876,1380,
95e281db5ce71ed069ec0f78562a35b6,160,TRUE,2256,2096,
77c3652d0ecfd9dd08c0d17191cd835f,413,TRUE,1619,1206,Radiant
184af821ef13359272a5c86bdf02c054,1551,TRUE,1693,142,
a46f63698001ecf43bbfc14b62d3d0d7,1037,TRUE,1349,312,
f05907184a72c7ca723a498ad6aff389,822,TRUE,2367,1545,Radiant
cf15b89a61823c746bcd1e72915d207d,21,TRUE,4576,4555,Radiant
615369fbf4a3feb966557b903c57ce98,1643,TRUE,2598,955,Radiant
581ac4bb93e7a02f5ee2340f6e2f38c2,1684,FALSE,2478,794,Dire
7c5b4d08118e860eff69ced85d28401d,338,FALSE,2463,2125,Dire
e184130d5ca432ad6cb6cbf8a2b765d4,337,FALSE,1755,1418,
2098fe374340d1ec9928f2024792a477,2702,FALSE,3439,737,Dire
1ec5f8d24b0f30bed0815a1658c89da6,236,TRUE,1891,1655,Radiant
e4767842031834e997ceb29cd7586d25,2819,TRUE,3071,252,
319c0fe096f4f00145ba12fcc10c5f31,280,TRUE,2206,1926,Radiant
62fa5d2cc13d30563e327a2e99228359,1501,TRUE,2529,1028,Dire
df1a4c97f3adbedfe077d2356e8c21d7,27,FALSE,2534,2507,Dire
fe59ab559d455edcdd786bfca88657bf,2017,TRUE,2395,378,
9f2148dae31e2bf1f19e06e0a1a36d3a,918,FALSE,1844,926,Dire
eb838716bb9d5e677673ae091f611753,1659,FALSE,2736,1077,Dire
930f6d4b883b6b3f32028cf0cfbc4669,900,FALSE,2700,1800,Dire
b1612ef25cc78bb4d1247e3ab61cf11c,416,TRUE,2159,1743,Radiant
a9cc1e0a554043a5143f22143ca703c3,1954,FALSE,2236,282,
586a12a3a96ae1f323ec3b8826023608,1024,TRUE,2299,1275,Radiant
45a3780beb56c7c5ed0bc5f30c9b2621,1271,TRUE,2993,1722,Dire
dfbae52832d950891c4fcf41c828822f,1896,TRUE,2998,1102,Dire
76b33decac56f617b3f4146e1d6658c0,347,TRUE,2563,2216,Radiant
ea9e8f0e6aeab99e66ae02ab235858b9,1178,TRUE,1816,638,
8dd9744054138d02f40e790f03c439b2,1206,TRUE,1685,479,
4f841c82d595d8d308d464e31d95f995,893,FALSE,1901,1008,
d04d3bb4c621d606e54edf61a5ea798e,1391,FALSE,1704,313,Dire
b03e6977c33c3e2dd9f248d5030e61e3,954,FALSE,1859,905,Radiant
599dd73d15d6fe42479cba5a6c5d665e,159,FALSE,2024,1865,Dire
e995ed1e356f272a4640035a9c9283db,298,FALSE,2206,1908,Dire
ceb66836c0e433e190979fe7f67f146e,1365,TRUE,2123,758,
dab5589e253bb2287264552a6dbcd317,547,TRUE,1638,1091,
98525f32f417fdf7526bec21a7719099,1347,TRUE,2610,1263,Dire
0450d8b3bc372acf9d1e963671418c14,1617,TRUE,3660,2043,Dire
8ce2a036b062186dd73024701ce34108,1101,TRUE,2666,1565,Dire
97b68d2bbf993a138ff03497d5826e68,158,FALSE,1392,1234,
270a09b95232ea720f4ad6f9165b39c3,1560,FALSE,2506,946,Radiant
933170ba1af0b272a7d55e59655972c9,3828,FALSE,3942,114,
9d49928346b3451e53f32786fb95cd0b,2201,TRUE,2735,534,Radiant
75f42bc251b8c7937c2efe88a155925e,1916,TRUE,2021,105,
99bc5fa289d34256cc78dc109300f86a,636,FALSE,1698,1062,Dire
35404e0faaa182535a6c288d8e5ba0d2,1961,TRUE,2427,466,
01831ac91fbbda4b45cb0037a8991f42,714,TRUE,2123,1409,
cb637eb9bbf59202597f0d7eccc7064e,647,FALSE,2150,1503,
c77b7ef8245e4d076bea52f0c23831bf,1957,TRUE,2823,866,
bf574d5c932cec342f19d544deae8a07,409,FALSE,2904,2495,Dire
0334b93da9267695304afea974f1cbdd,1941,FALSE,2671,730,
fbef77022a5594c62a541a0f0c2180c2,673,TRUE,2003,1330,Radiant
da1f9f688f5c2d58f275bc0be0ea92f4,2273,FALSE,3755,1482,Dire
e3278103908b0c809c8ed9ab3a28f73d,1032,FALSE,2002,970,
ca2b6596af4b968c333c088ad0bdeaf3,106,TRUE,1600,1494,
e724964e6d8de52bf52d8819a377a7d6,2905,FALSE,3290,385,Radiant
ab1da7424d75326630b8adaa72319324,1868,TRUE,2423,555,Radiant
ea64c2ae8a1e98bb0e11dc14bed599cf,535,FALSE,1008,473,
305f1eb8d06ccab9674d03f077ef80fa,442,FALSE,1861,1419,Dire
90d0fd52fe6cc6c4819712fbce70038a,1716,TRUE,2105,389,
9b64857324a1126cb8cf5a8db51bb816,1779,FALSE,2545,766,Dire
5cc11cef3b588d1e686a9f8a2c45b2e5,1370,TRUE,1663,293,
2608683d981e8048855c8e3273ca5ce9,427,TRUE,2310,1883,Radiant
fb9528749ebd4b6a56b12defe8f3710f,661,TRUE,2353,1692,Radiant
ff1c41fd3483394a7795e4559ba4acdb,1784,TRUE,1973,189,
ff7e97785b22af78d97aaadc261767cd,159,TRUE,2597,2438,Dire
75092c6e30735d022355c588972be1c7,1845,FALSE,2063,218,
924200fa9f942bae2647ae5c18bc3a15,650,TRUE,2569,1919,Radiant
ef262f2608bb1b5e433a83b8904766bf,1882,FALSE,2971,1089,Dire
0fcfde7eb289d0b7b710ab3ea464a5c8,1219,TRUE,1567,348,
bc95eee3334ed04a3223720be4340501,1448,FALSE,2731,1283,Radiant
28fdec3d72adb5826fb6fa2b53418500,134,TRUE,1974,1840,Radiant
46413e73debf136a1ed648c8bc02630d,1032,FALSE,2913,1881,Dire
51e39170c34b48618f96014637146aa4,1425,FALSE,1948,523,
d63b719a93ffd211be5ab082f071c4fb,768,TRUE,1357,589,Radiant
581420355dc89b4b2e6f886cfc0183cc,1375,FALSE,2898,1523,Dire
6d24246869557a3c02f87bc49b53f01e,1075,TRUE,1565,490,
bbb0e9b0120869313ff433415e1cbd93,294,FALSE,1154,860,
3180e96801ecb3f9b458f393978bb9e4,1055,FALSE,1584,529,Dire
2cfbf32934d72ae17c9dea487007c21a,1291,FALSE,3056,1765,Dire
a5104f1270bc8c4deb25fa06ac6a0cc0,1376,TRUE,1798,422,
f03c9d7e55192f6b3e06ec75ee420b6e,1259,FALSE,1331,72,
8714160ef2f8c07d0d1ede37bef67112,980,TRUE,1916,936,
4f630f024311450d2d471e4f45deb8ff,1482,TRUE,2058,576,Radiant
c66cf845b6f889b3d878a74926b922f1,2279,FALSE,2888,609,
4651ef87934b9137fc2357edb8cfe884,566,TRUE,2591,2025,Radiant
a073f935ae0616745b45007d393234cc,629,TRUE,2239,1610,Radiant
38e97ddcac18d4c5da0c04656827d80c,2303,TRUE,2427,124,Radiant
a67936ca15898ed9d2b935f494810888,59,TRUE,1643,1584,Radiant
67b306c2e19cf1dc7bf24be8e565d1d3,1673,FALSE,3058,1385,Dire
2c17244a90c3b075ab9681cb4d2b7b76,733,FALSE,1917,1184,
96cce26135279a3f26afaccbc94e901a,975,FALSE,1364,389,
47760845cba9539fb5d91e7de07d119e,2499,FALSE,3035,536,Dire
20a42fdf6aac7051297649fc67b83c4d,554,FALSE,1916,1362,Dire
fe3506da8d90c8e755d21cb4ec5d018d,1698,TRUE,1955,257,
b8fe6431b3168798773991f64eee9002,2290,TRUE,3469,1179,Dire
dab0146a65e4888e68d4b007c1e9fe7b,548,FALSE,2916,2368,Radiant
da9ed2d4dc6b4283a7568bb71935e1a5,1184,FALSE,2807,1623,Dire
c34ed5defc68d275f5cf256e909df961,1527,TRUE,2539,1012,Radiant
6c9add7dc5a8606f06b995cdfe777c2d,2459,TRUE,2687,228,
71f5ae18bccdb1e1eddf9048476c051c,1707,TRUE,1960,253,Radiant
a826e078c5c8cf1319d622919a7e82f2,181,TRUE,2005,1824,
4dc6e3da2a44bd84f180610c636bfe8b,24,TRUE,2582,2558,Radiant
cbd2cf809b57b4a100d0a570774c5761,1002,FALSE,1439,437,
4bb6dd99f3c068b34b98de121be38230,563,FALSE,2172,1609,Dire
12a8699d369fa1595f27e9b99eddfd8c,1052,TRUE,1527,475,
d9cf0a69c630468e890ed2b89a05e2da,606,TRUE,2533,1927,Radiant
e5a83d77e5c98663abbe292b6421f2c0,1317,TRUE,1583,266,
06107e2b50fbb14a7d57daed0953635b,2301,TRUE,2505,204,
27b3677a9b00ddcae23043ce8e33347a,361,TRUE,3465,3104,Dire
38d8f0b5f93eb3e66206310ad62b8f89,248,FALSE,1997,1749,Radiant
16e5774a5345455993caf67cc7f1e060,584,FALSE,2377,1793,Radiant
258e9d31265bf7835f63f8f3eb72eee0,793,TRUE,3248,2455,Dire
6af304591b838ce5d13279e236675478,1907,FALSE,2253,346,
9bbfcc77428c4a9f815abe94af9b304a,2727,TRUE,3265,538,Radiant
fb0287c0a0d061cd6f45f459f8e3e8c9,825,FALSE,1850,1025,
0622b775613315b59ed40ff7259c0370,286,TRUE,1232,946,
23a863a7191b02c2f7fd9f6e46db8414,2717,TRUE,3105,388,Radiant
3f25d2e43d4aba319ebb059fac1bad14,2525,FALSE,2639,114,
9e1f70f783d3aa6a53e7f1314fb87c57,1308,FALSE,1690,382,
e53ef7461c0f16e256c9acce888fd685,921,TRUE,1637,716,Radiant
d6f1fd9e43b7d37ed887bbaa16688fa3,1736,FALSE,2024,288,Dire
f1f85338faa5f97e450ac357584a6eb1,49,FALSE,2089,2040,Dire
368570d66b7fb9b6ffb1baa18a39f0b5,1382,TRUE,1858,476,Radiant
c1786043872f28f5287f1066ae063ce9,550,FALSE,3700,3150,Radiant
f70a59fa28a4a260aa09acbc31188fd9,729,FALSE,1226,497,Dire
1002a2b9608c109978ac423e45d173d0,1783,FALSE,2491,708,
c93f746764587e4457dd26a4bf6ded91,179,TRUE,1861,1682,Radiant
8d5e49812f3223624e4b39ee6df113d8,567,TRUE,1758,1191,
46d627cb2f481e7dadb7e26dd3907886,494,TRUE,1484,990,
7b9352257ed69e9ea47e463a328c35a0,1014,FALSE,1397,383,
49863b239abea0b2aae5fb64cac90ab6,1258,FALSE,2039,781,Dire
3515a13b8cf0d33629f2d0fa0169e998,2,FALSE,3181,3179,Dire
82256110f49d0cc9c10eb397dd9ee98c,797,FALSE,1350,553,
10320d17731808eee575f283ce903ed9,217,FALSE,1679,1462,
91ebb02ec950b43acf8593f2456c28d8,3058,TRUE,3413,355,Radiant
ae0fa53aea7c711ff6ae03d56ca2056c,1882,FALSE,2630,748,
8d8137a39a7e60e4bbc6feafada4325b,2383,FALSE,2450,67,
a28a050b5eb738f8fe795fa64622b758,110,TRUE,2439,2329,Radiant
30565cf9c976ae63deaa548328299c04,1050,FALSE,2996,1946,Dire
b006e3093d585f3598a6418c506ca4f5,1876,FALSE,2221,345,
f38caacaedd6efa0a1f3ea3e83e6d1b0,408,TRUE,2472,2064,
d5ab0d19cb9a13a9f048da7726cf2a6e,2551,TRUE,4279,1728,Radiant
6b5492e0fb07319bc46e5bbf9a729006,1418,TRUE,2579,1161,
702baa5f384e7092b3d6579d302a916c,674,FALSE,2097,1423,Dire
13e76f0895cd672224ac8867133bcbb9,1393,TRUE,1707,314,
02463fe2ce077d6d2978fe8d78195eef,2122,TRUE,2651,529,Radiant
2033b30867b4bf4b35ed9178af597c29,563,TRUE,1564,1001,Dire
8f965add26599a2bd082d169b4f8b40a,1165,FALSE,2789,1624,Dire
6b791d531526ccc078e24877fca1238a,2511,TRUE,2881,370,
b0ad5fe7dc119125459f7524b5124acf,443,TRUE,1913,1470,
30dd76d44fd393b8487436223c2866bd,2258,FALSE,2645,387,Dire
9ba493be838c966fbbca747bfefe349d,969,TRUE,2312,1343,
70d13680c173712506da43ebb4146122,822,FALSE,3144,2322,Radiant
3397cee7a231bafa353bbe8b952ba843,738,TRUE,1360,622,Radiant
f6dabec9b28bd38e080d627de150077d,1591,FALSE,2557,966,
627970b3c2f74e8583cfa476169f844d,1265,FALSE,2490,1225,Radiant
3120e514530b13a7db364b60e71da8cc,117,FALSE,2524,2407,Radiant
9ce45ae4cf28098d339270a07a1a7dad,1227,FALSE,1388,161,
3ac30f17ccaf463418d900226e5cf5b8,1014,TRUE,1339,325,
a745f728e06e4e22fd3642bbc599636a,2142,TRUE,2202,60,
05c601dbe8c0385d5776e81e42677a6b,1787,FALSE,2810,1023,Radiant
cfb183c816b5221588b82b6da2b4f723,1397,TRUE,1783,386,Dire
803c7de1fb8eb3280de6937b6305ae5d,1257,FALSE,2287,1030,Dire
3eca17cde97a651e2647d9b254ed6a2c,36,TRUE,1974,1938,Radiant
5a28cc7ffc15aa6de95e3b1cd51a3e90,2176,FALSE,2597,421,Dire
df0e00eda5557c76c76bd9f68dcfbdc0,659,TRUE,2794,2135,Dire
fffb0d9f57cd32d13f022b17f2d6837b,2800,TRUE,3270,470,Dire
b424c09f44b8c915d8590e6864a61144,575,FALSE,1316,741,
78b14c6f3b6083622bf8b211a509e1cc,1415,TRUE,2124,709,Radiant
1564de6459fbe95272deacb6c474551c,1092,TRUE,2468,1376,Radiant
8eee993be0ca17cf5cf691f0aeb8f13b,574,FALSE,1976,1402,
d569b5fcdc5e1743e53f39b05fe721a5,1492,TRUE,2501,1009,
4137525a847c832a1c553a0dbeb7da3a,1915,FALSE,2539,624,
b90e1703bc2b03b87447b6a02ad1e4ba,349,TRUE,2040,1691,Radiant
164671601cbda7741aab34420ad79c71,2351,FALSE,3729,1378,Radiant
465f09398c3a3d7dd1c7ba2eba8dbdc6,1643,FALSE,2650,1007,Dire
168e2fed7173c86eb6e5e3ecd00e6972,364,TRUE,1646,1282,Radiant
02ff570bdfde7f210adfd8968332f3cc,199,FALSE,2173,1974,Dire
aa54e34a552c9f28399a9d22244e626e,456,FALSE,1941,1485,Dire
9cd93db74ef9f09d393c4fef32e9e9d6,680,FALSE,1128,448,Dire
31b7f4f7b1abc326a3fe9281180462ef,2473,TRUE,2550,77,
f7ecfe9c1645c583d4e9cc811cdcd640,795,TRUE,1861,1066,Radiant
6cfea979c91b54dac4fa67027f70ad16,1837,FALSE,2005,168,Dire
b40e6053e08ec9afa8b7776945cccb41,845,FALSE,2130,1285,Radiant
1bb4908214a158589e703fe67bd826bf,107,FALSE,1450,1343,Dire
10fa2b7a263bc200a5102afd4a9f40b6,178,TRUE,1505,1327,
994b3772e00017a29fa8eab1bc689c7b,924,TRUE,2781,1857,Dire
2db1030092a202df27a9b64a7bbabfe9,526,FALSE,1558,1032,Dire
c871d5538bd0309226cbccd753965ef9,200,TRUE,1744,1544,Radiant
05be2ab693e93787b13d56a0276cccab,879,TRUE,1134,255,Radiant
4274c9876dc63d1627dce8ce56f21274,2065,FALSE,2955,890,Dire
04ba9aa4ffddc20bfdeccc00ad241771,1050,TRUE,2055,1005,Radiant
e1e9314af81d8623acf69654d61bda1a,1481,FALSE,2878,1397,
6ec225b8f863ab6bbceb281871999f29,1556,FALSE,2645,1089,Dire
5d21ee3720ddf83cec1013e7d8ec5d1a,249,TRUE,2370,2121,Radiant
f820813de05714eddca6f65d7b71fad3,1120,TRUE,2206,1086,Radiant
34d5b781699aff669bf39a7db004787f,1550,FALSE,2339,789,Dire
7c0ed1c59974a91c6113e69654daf370,778,TRUE,1955,1177,
35fea7af67f8cdd430833e9842fa491d,1065,FALSE,3171,2106,Radiant
1e14df0398686f94bf97cb6752cce7f3,1796,FALSE,1920,124,
0a67899ff493ab983815f185e55818a1,1589,FALSE,2250,661,Dire
61628aa32605b9240cdf06993a082476,2090,TRUE,2395,305,Radiant
e07faf80fcb73f6dbc8213609b140401,353,FALSE,2657,2304,Radiant
d4199704704aea4ae5843f926e1c24a2,131,FALSE,1908,1777,Radiant
295db84bb6d3f95e0940734ee8962e2d,3646,FALSE,4277,631,Radiant
874873957c75345bd88219bf6e6d3da8,849,TRUE,2812,1963,Radiant
e505d6139b65dd0891e24ce710b44211,442,FALSE,1593,1151,
b65d32dfd646bf0e98fec7c336910f2a,557,TRUE,1999,1442,Radiant
85015b836532e835bde79f627183c9aa,1789,FALSE,3638,1849,Dire
d76387622db3c5c07969cbc81bbb026b,1294,FALSE,2601,1307,Dire
c942e0b8eb29e03d130ce650b368451d,13,TRUE,3034,3021,Radiant
7e9d6d220f12ab64e7cbdd35616e448f,1196,FALSE,2812,1616,Dire
d8ba8303a357abb105400fb43880c563,150,FALSE,2515,2365,Dire
a261e08dcfeaf15c817b4b18123ad89a,1847,FALSE,2582,735,
e65b7e815ef5381698582481b8334ec4,2571,TRUE,2658,87,
3580ef4c31da3b82069c0a3f056ea20e,229,TRUE,2156,1927,Radiant
0921166aa9b7b4c0761302a2ae3678b0,2468,FALSE,3794,1326,Radiant
9b7de84153516fff632d0a46745084e8,762,TRUE,1792,1030,
9304bdac9c3272a05f1ad6cf5a4fb5e2,383,TRUE,1387,1004,
9f5ae045e2f79fbcf7f2962488c37502,256,FALSE,1975,1719,
0210e5e8e7c45d56a346a3ec4562b696,201,FALSE,2585,2384,Radiant
b0254856741012e9b6459591c5a5ce5e,742,TRUE,1174,432,
26dbefb8042a2b27c74c6a60d93e05f3,1195,TRUE,2415,1220,Radiant
95e63ed88fd535abe11a5f89922e1d45,886,FALSE,2209,1323,Dire
14711dbdd14f2a0d80655d79777fe5e6,1136,TRUE,1488,352,Radiant
81aee4c91865a475dc216106db031f77,669,TRUE,1266,597,Radiant
c17a4c1035efdcdf28dbc0351bcc864b,464,TRUE,2303,1839,
d9aa156282ae781a9218a5beb44cc9ef,806,FALSE,1671,865,
2033946451fa063472195d692c8d6520,128,FALSE,1863,1735,
2952d52f5e0ddfcb6d56f8e941e41c5e,1663,FALSE,2362,699,Dire
e3f1bd1507604457e5ff8d038a0a7efe,1225,TRUE,1581,356,
18800b9c4c342064d465c6eccd9db38c,245,TRUE,3015,2770,Dire
6c9e8fdabbc71cb04ed390146480244b,2362,TRUE,2907,545,
1d416a08cc63761a2645edf1b33b13c0,1490,FALSE,2301,811,
6bfc5e8901213f1ce1a351c4a04b7274,1105,FALSE,2846,1741,Radiant
aaa2b523142b1d36f19d14a66ea15a48,1615,TRUE,1993,378,
99f68c7d863fb07f24b994c43000689d,1380,TRUE,1730,350,Radiant
4e1906c4a164fd884395fe1a23cb6138,835,TRUE,2311,1476,
346526fb4f15f13770c121f1a8a0b634,199,TRUE,1196,997,
b5f11ebf8300719af168b47d4a37f0e2,2324,FALSE,2726,402,
87e3f7e16fca3c0297cc86473d033800,1166,TRUE,2909,1743,Radiant
488496edf4460115b6d167530250b45e,959,FALSE,1900,941,Dire
d735439b4aaa890dd95de455f5661ae9,1725,FALSE,2421,696,Dire
e3b40c6e4dd361806d25d77b93e01eec,1780,FALSE,2922,1142,Radiant
54f4b9467322cd7e2d203e1e951daf35,2047,TRUE,3197,1150,Radiant
2b0f903742dfbede830089fb3bd1797d,347,TRUE,2313,1966,Dire
4f46d548ea5b5368659b832bd3b8e815,950,TRUE,1678,728,Dire
e59e35d6cff7aa70d443654ea7b74b42,636,TRUE,1909,1273,Radiant
8ea6c69064d42c5da7bac9571e271ec7,257,TRUE,1493,1236,
d03cce906915acf7635e56dc9722c343,964,TRUE,2303,1339,
43e36518d515b2c3f11890264cf48b35,386,FALSE,2630,2244,Dire
4e972c7da7058adc969f9444f7f292b4,2004,TRUE,3958,1954,Dire
1c64579e9698a99e8bccd33f2e1ef83e,747,TRUE,2587,1840,
41c3040a01efda9e2ffb877547f2501d,1791,TRUE,1915,124,
5401c37fdcaf0d46c34a9b3ee70173d1,1190,FALSE,1593,403,
b27987cebf34709e0e3fc318c4aea4d7,1444,FALSE,2005,561,
db5054bcd49d4aa99c20cb5427430b15,1085,TRUE,1495,410,Radiant
a91603fdfb4c51dba791a963f0c8b291,191,FALSE,2619,2428,Dire
8f98f8800d375549f189a8845f05aa12,1947,FALSE,3020,1073,Dire
4a20bffbf52ac0ebb633e44ac85a981c,652,TRUE,1954,1302,Radiant
2ebcb25253525a94f9140c60957a3187,541,TRUE,1075,534,Radiant
591ba97f649fd224810ac82255b1223c,1112,FALSE,3070,1958,Radiant
6ac9b2b81015c354e209c1510eb54cbf,722,TRUE,2071,1349,Radiant
67019c495900111d0d7bea38c75275a5,874,FALSE,1945,1071,Dire
2e2afd366051eb26ad61719804021b6c,1419,TRUE,2255,836,Radiant
76d5cef1ec1e88dd231c84d4ae801846,956,FALSE,2868,1912,Radiant
0ef7787aca21970e23a82797a8a55ce3,257,FALSE,1954,1697,Dire
a6fe4169ef5f57e8505b224b619ffd1d,1305,FALSE,2397,1092,Dire
52a9eb568514d3a2436a3ff7ec6dfb52,445,TRUE,2434,1989,Radiant
0a9014571cac8c8f86c346e88486dbde,197,FALSE,2553,2356,Dire
f507995ebedae327ba6eb6c795acd1c3,2226,TRUE,2346,120,
aca16e30e0b16da811b280d07787c56b,18,FALSE,1883,1865,
1bbb80c2ad724a14cc1263033a79d624,1774,TRUE,2872,1098,Radiant
396dff7bb531b99c818ad61479d29ca8,498,TRUE,3689,3191,Dire
040135acee4afac53e33d4c151c76a13,956,FALSE,1112,156,
cc0a1fa8477c58e54a9294501938e1cc,1010,FALSE,1122,112,
4d23097edbdbc72d115fdfe82563ccd5,234,FALSE,2624,2390,Dire
a9cc3605d9ce702762909f4c79561f36,529,TRUE,1877,1348,Radiant
76df2e88812a7bc1182d024131a28cbe,2631,TRUE,2951,320,Radiant
7d01e4525f7378452b878dbe37ad96c4,968,FALSE,2151,1183,Dire
bfb600447d8091f8f679cf3650e85437,1468,FALSE,3426,1958,Radiant
1c697661d3ec25c34a66a310048cb96f,1587,FALSE,1672,85,
4eed12c5e037472b2cd651cec555a609,814,FALSE,2077,1263,Dire
2cc09c33f0ea3e4e4b942170201ab411,134,FALSE,1723,1589,
43ae91c520f900c39e95917bd425be77,605,TRUE,1119,514,Radiant
a8d5ab743380910bbb84d8b73431b09c,1112,TRUE,2155,1043,
9dd2334350f81c29c04965a3d26b16c1,87,TRUE,1616,1529,
485a9bf02a0803ec91e58f12629f298b,851,TRUE,2250,1399,Radiant
541ef57967c66e13a9ebb5d219ea341f,788,FALSE,1531,743,
11b2ec91d9c8fca57f15b4f9939bc57f,813,FALSE,2492,1679,Radiant
c79624fb655573372b9c5f10ad94fad5,2232,FALSE,2513,281,
cd385b7472e1eab60461e0d43ce0abd8,1734,FALSE,1903,169,
480a0c20ce9020116a517255b9a98bd4,1469,FALSE,2507,1038,Dire
2513c09a05de969f97ec7e66ee739b41,558,TRUE,2564,2006,Dire
1026410e91664f15f0a3b84e129742e2,1489,FALSE,2121,632,Dire
dee4e4a35170511e53c277895b412359,1443,FALSE,1591,148,
5f9f9bc0644e9ebe2ee6b87c0231e93a,380,TRUE,1870,1490,Radiant
fc39115b307f54758547303fe414e420,730,FALSE,1381,651,Dire
f34d4753cd2a08df65c3888c6f754229,1233,TRUE,1876,643,Dire
584d155108f60ef0272360f4837cfca7,1340,FALSE,2391,1051,Dire
55516de252eb3d489ef48a77b02f3af0,190,TRUE,1298,1108,Radiant
46823217d8bb2acd203b415d71f757a3,1205,TRUE,1737,532,Radiant
ef3733b04209847bda9313880628aef5,2076,TRUE,2321,245,
e960bd2c90de22e8c0987dd3be4b34f5,2117,FALSE,2281,164,
cc050a40891e45baf3d6c79897ae569f,1502,FALSE,3076,1574,Radiant
a37890d73f2d624290a1a71819ae0028,2687,FALSE,3185,498,Dire
b8408e8aca07ca0c2b06cbdba352d8df,37,TRUE,2924,2887,Dire
d58a7476eec949cc971f39cf4e94b14f,693,TRUE,1194,501,
190b3885084b3724ac70c1fee59bb8a4,109,TRUE,1946,1837,Radiant
7b9815b2c5f0772f64f7fc6c986a0e79,1553,TRUE,3402,1849,Radiant
beadccb851912908775475987efb91d6,980,FALSE,1934,954,Dire
f5ec6930783f56ea4f935641e7a2f83f,570,TRUE,1988,1418,Radiant
899d1108195d232779661ca4e04fd76d,1923,TRUE,2619,696,Radiant
6bab1501ca66c1e29de3d259ce9cd9ef,502,FALSE,2782,2280,Dire
71b8401e73f0a6f7ff46dce717c273af,1808,TRUE,3169,1361,Radiant
2e8cb5ff6aa47cf616b9c633f1324f94,4282,FALSE,4456,174,
ea1cd4adcd8d42f8f98a676ba329e8d8,898,TRUE,1944,1046,
75905d580e4fd0ac1bc786a1d32aa33e,1880,FALSE,2539,659,Dire
7654e44048369f5643e86e77527e9403,1373,TRUE,2397,1024,Radiant
b4cbdd4831457ca39e413759ac6ee2f8,1316,TRUE,3255,1939,Radiant
414f339c960a72fd478f95c46eecb6af,908,FALSE,1913,1005,Radiant
d2c9d4583515dd007ded2b643bb28136,221,FALSE,2610,2389,Dire
4104bb83f4ecfed4beb868ad25a59efa,1925,TRUE,3777,1852,Dire
52df831c95300f9f4221acfb05694f17,1038,FALSE,1167,129,
164946c7a31a141a1bb2ad44a221d349,1139,FALSE,1190,51,
723008c42de2c2625a1b70b2ea111edc,1063,FALSE,1381,318,
d45dc34fb3b726dd3da0f0932473ad85,978,TRUE,1705,727,Radiant
a42b265acdaf273e60dad58bf082cadb,1010,FALSE,2210,1200,Dire
bdf71e749c8b92e9f35a9ba9513f570f,33,FALSE,2497,2464,Dire
202a9e4cab3a1cbe00d62a1ae5fe1457,1012,FALSE,1235,223,
8db482d55de014945b5073912d8815bd,1924,FALSE,2527,603,
1785cfc9956e786a9ec1afcb530831d2,1459,FALSE,1794,335,
9594618ccee8140c0a58f5b843bdf89a,1325,FALSE,1694,369,
a4b03adfdee524186da44bc6224ee0bc,1449,TRUE,1801,352,Radiant
e3545c3206dacd85af47f8b066f7f9db,1615,TRUE,1758,143,
7f86b90648a84295d3f3a21e4bda1ac2,800,TRUE,1947,1147,Radiant
3b13bb3cdc8fe20f29d615ff93b8ea36,255,FALSE,2145,1890,Radiant
e8852e2335df4e1cf435542c412f0252,1047,FALSE,1947,900,Dire
a9b520d2c1e021f451d2e6a789b5d804,1328,FALSE,2303,975,Dire
8327e132e92d2c1c1ced2a3e5fca601d,850,TRUE,1556,706,
a06b0c5a53e2f5d686006da3c036855c,1684,FALSE,1877,193,
61db7d3616e614fd63d7b25695030309,2612,FALSE,3018,406,
48ef863750f2e16b54c7a425657f409d,644,FALSE,2454,1810,Radiant
68a8d56d3fd1b970efbc40b9588ffdf4,1247,FALSE,1911,664,Dire
b5a997d348a0cfdbf959327ae562124a,1367,TRUE,2358,991,
bfd3c8fb3fd980d0e61657c670583852,1745,TRUE,2334,589,Dire
09235f7355ba62b916a16a62e84c81bd,2079,TRUE,2534,455,Radiant
3d7c2d3b83eecf33bff312d129630110,735,FALSE,1531,796,Dire
1f9df840df9aa4dcc7f6d1b31361fc75,2618,TRUE,3201,583,Radiant
fbab9d4dcc2b2180533f738a99a93919,2103,FALSE,2203,100,
969a6cc5dc92a91ccb346d5146b11808,2841,TRUE,3942,1101,Dire
89c23528c585e80d6401224a388c3b6f,1043,FALSE,2664,1621,Dire
cc3b0b8111e29c1f9145f5d488d81fa7,144,FALSE,2632,2488,Dire
5493e9cfa622980c3442c62a713486fe,996,TRUE,1380,384,
87fe44b79fc95dd2fbc9165e6a719019,2455,FALSE,3432,977,Radiant
24275b7ecddd78175652347dc6e61165,227,FALSE,1615,1388,
af640c3ec913d85ff173a6dee3a1e27d,984,FALSE,2918,1934,
722f91d85df1e4edc67afa5176d384fa,617,FALSE,2271,1654,Radiant
21592d082aa413261239f59a5f9d59bb,2658,TRUE,3311,653,Radiant
7b7281ee9c15e318537a93de4ad9ecf8,461,TRUE,2107,1646,Radiant
b32c48bde4cb5fa95ca613917c0f17d9,2695,FALSE,3374,679,Radiant
4b2a997705612563eb3bdd11802b7ea9,428,TRUE,1681,1253,
5750421c44b9f20ddeb3f6cfa75a7e45,1107,FALSE,2046,939,Dire
2e7a3eb0a57a54c625a2fb68224fe19e,873,TRUE,1594,721,Dire
467ebc876a318a3d6df3ecce591b3d3f,1210,TRUE,1896,686,
9114308336e702974dbf4d40abf70d26,728,FALSE,2495,1767,Dire
20139c5eb99d69ad6cc00137669183d9,567,FALSE,1640,1073,Dire
342ecf216c15046466475e8eba1662b1,595,TRUE,1884,1289,
f12d0790cb7a1c64891e700b9fab1c41,977,FALSE,1175,198,
772c546fafefea20639e1aa557122965,1288,FALSE,2373,1085,Dire
1e4aeae0c55cb7f6d2b80b69e5cb924c,1343,TRUE,2708,1365,Radiant
9ccfdbcb7d9692e2b3ab0be9f9ea80df,1206,TRUE,2502,1296,Radiant
708f376395b325ec1d9c4d6f17c8fb1b,522,FALSE,3438,2916,Radiant
89db2659ed37871f61993e922aae9ce8,1703,TRUE,2265,562,
44d674435c2ebdd8a1a258aa620e920f,2142,FALSE,2465,323,Dire
dece776cf8083c90fb4f540288f304bb,513,FALSE,1678,1165,
024082704e4a8d7d8d2da81cf26af00e,327,FALSE,1967,1640,Dire
8ff55e7267c9d46c0a92f945d9e8cb2c,1757,TRUE,2181,424,
28a5e7816f5a28b33cdaed3c04939301,2416,FALSE,2751,335,Dire
869d45cfe662a065f7f1a86a81e1d846,2167,FALSE,2249,82,
6357012bdab55873e7e9a1a899b8a7f8,1146,FALSE,1337,191,
cc5067351834c64c55144894f4f83d64,1136,TRUE,2728,1592,Radiant
ecc2395287ccd8b6cbb0398a0084d1f6,240,FALSE,4283,4043,Dire
d5ca90bf7b4f4a3b839210c4d4dfeedc,255,FALSE,1182,927,Dire
3443b0a6eee1af3cfb5c5f84c9a43374,895,FALSE,1734,839,
ba4465002fdda0bc8f155fcdd9914371,995,TRUE,2419,1424,Radiant
ae28e20af53916295d8498ee78813230,1673,TRUE,2054,381,Radiant
cc17af4261826d476675396be3771167,1558,TRUE,1780,222,Radiant
5d5e71c87f69f5f1913f2eb474260092,1441,TRUE,2655,1214,Dire
7b55b72d412bc178c3cafe20ddbe8167,1714,FALSE,1871,157,
06f01e14b8067e55249ed6a0e143d1e0,2196,TRUE,2368,172,
33d6a3869dfbb74b2dce40645a0771bf,2471,FALSE,2552,81,
9dcf1e532486f60b70463f2bae3f3561,530,TRUE,2576,2046,
8d96baabe63c67a7f42024e230dba078,930,TRUE,2332,1402,
14606fb4b4bf60486bf80e46047650bf,874,TRUE,2133,1259,Radiant
7385f80e77c53d6416246571565c3bb8,589,FALSE,1709,1120,
8f28c5ce601acec6abd7b3c71f5af808,813,FALSE,1719,906,
2a5eb2e69de29aac15ced7cb7f7ff2e0,1589,FALSE,1979,390,
198dfdbef22c316d4bf84f9fbacef416,571,TRUE,981,410,
b994eefe5083d429b4d16d6b251948f9,28,TRUE,2829,2801,Dire
bf260133cd569f89ec8d18aa9c75f0b2,1671,TRUE,1974,303,
382bb7d408c70ed670a7c14a64714b1c,1177,FALSE,1429,252,
b2a6e8af345b13fe73215678f828e50b,626,TRUE,2429,1803,Radiant
e2341748589553c203a2e515b80182ac,513,TRUE,1987,1474,Dire
b8bc007eece2e7f3a2a88627bb4bae96,1714,FALSE,2128,414,
8381f92843181fd545cf0a4a7a5c923b,143,FALSE,2263,2120,
141ea9aaa528ff40135f7e9c8213870e,1205,FALSE,2569,1364,Radiant
6221dcdcf84a0761346404a4ba76f097,1266,TRUE,1807,541,Radiant
bb85ae334235bcc05f2e205487f3fe74,1503,FALSE,3206,1703,Dire
56f99c1bd40ad563a38057df72f0b015,1645,FALSE,2250,605,Dire
f100833078910666487791e193a29325,1850,FALSE,2387,537,Dire
558b360d136ce3fb99184ad3eb50f38a,57,TRUE,1627,1570,
d49d2c787af921de72d07813e123ef75,2119,TRUE,3205,1086,Radiant
40b1aa35b51d2e7fdefee7dd9da80f22,1249,FALSE,1636,387,
09b96cb7f9f05a16477a67d61ed1ee9a,1545,TRUE,1863,318,
c54ef161dd185a1866c12c0c5c9f3d5d,1152,FALSE,2656,1504,Radiant
d2eee26a5510b36caee739122cc7bd4c,1102,FALSE,1687,585,
6175e1d92ad9af95dec99b0db7d82ce6,507,TRUE,1651,1144,
297be4e74a8babeb22f27f7947ce55ca,1139,FALSE,1571,432,Dire
ce2f98fcaf3c4950aff8f5fdca84afbc,1181,FALSE,1841,660,
096366dc7cde4ab7679831d4f6047279,697,TRUE,3664,2967,Dire
dae225e0f6766adf29766e51595acd61,1016,TRUE,2455,1439,Radiant
4cfe7554c7355c3aa2d94a8239155c38,256,FALSE,4061,3805,Radiant
280b16fa83e26414df33dbb9a3d01f8c,1680,FALSE,2276,596,Dire
acc0d092a890f2b9ae1428cb0e319999,1102,TRUE,1529,427,
a3d5112b7367863478d41713bb6e8221,379,TRUE,2455,2076,Radiant
a27066401d448ff4a3ff1db976055bde,1290,TRUE,3200,1910,Radiant
b1079e12580a8c1255f4ac55dcdc5195,873,TRUE,2528,1655,Radiant
4987740d20c61439c21f945215c5b4bb,685,TRUE,2660,1975,Dire
691e5a3c0dcac0ced8758115b38d28b3,1123,TRUE,1971,848,
458c3b4949098f451e3579e9a7ad248c,1068,TRUE,1197,129,
0dc772b22a596a4ba8fcdaa787c69e11,1070,TRUE,1687,617,Radiant
4bbddcb6a8f45bd6b9e3654941498765,349,TRUE,3091,2742,Radiant
b2d4724fe820edcc8ffa61bd39e392fa,2242,TRUE,2693,451,Radiant
4ba20d9062005f1eab813ff45422dad7,2628,TRUE,2842,214,
ca7a1858c5bfeedd6cc09375cce33587,1245,FALSE,2000,755,Dire
9255988ec058d35b83a7b5e3f6522f1e,273,FALSE,2397,2124,Radiant
52418e14fe417151e5e447d1ffaf60d0,2635,TRUE,3122,487,Radiant
c26fb8d923dccbfe876978e3ee470917,429,TRUE,1270,841,Radiant
4db0b538b50359d2d3847bb94172da75,660,TRUE,2218,1558,Radiant
3dd3dc38aa7cada9bcd908252a924adf,766,FALSE,1195,429,Dire
801069d3ae9df2be1afddac0b93c97aa,1534,TRUE,1576,42,
c195976650eb22fed29920582ec4ad2d,426,TRUE,2530,2104,Dire
8b42662fdd97df6ed98800cdf9d96b6a,1137,TRUE,1392,255,
c082b0ca1b04ab9f86aa9fe1abba3945,699,FALSE,2180,1481,
20cf54f5029180c5d6d7b69aaba9381a,1523,FALSE,2020,497,Dire
328783d5ab7cc34194e89399d55d85fc,258,TRUE,2253,1995,Dire
ab11ad26c1624672a2365bd54dae8974,456,FALSE,1775,1319,
f80782f9cbf0b34879f03d1e80761329,1030,TRUE,2268,1238,Radiant
961a21686110215d0e70f87d1732f715,611,FALSE,1870,1259,
c5b123fab443686c4c6d517ec0839c85,2339,FALSE,2537,198,
04fd54c9420f7f10f6e3858ebcd761db,2425,FALSE,4170,1745,Radiant
7fecc77ddd469402a3ed939145837aa3,1788,TRUE,2800,1012,
aa504b32bbaa6a3ea3d628908de21d0c,407,FALSE,1698,1291,Dire
ac32c3c8550306b099863c92745f3ad9,3632,FALSE,3923,291,
135ffc906c82b041735260232c8ce210,290,TRUE,1192,902,
aef5a1c7f3a1b7a0633e82a6fb6458aa,2202,FALSE,2475,273,
ac13c5640826ef11bd80d309855cc9b5,1758,FALSE,1890,132,
545fc128a606f4d0469730fae6bee01b,1175,TRUE,2262,1087,
b90459202c40b8c9886351d684d04714,1468,TRUE,2226,758,
d040c4d82c205438ac2f34f256e2bcff,229,FALSE,2335,2106,
8548df1cc6e80c75c8f76d7f6ebf6696,312,TRUE,1504,1192,Radiant
2eb2ce35ed3dc6249b32082d052cb9dc,0,TRUE,1937,1937,Radiant
b9ef8521136b193ba418373a7901d7bb,957,TRUE,2081,1124,
43191449f3f7d77c047bcdc8cb1f5b82,638,FALSE,1880,1242,
b397bd7a7167198582d8be96cafb9908,1237,TRUE,2179,942,
0a92cf5c7a0c5bb667fc827d0ec44bc6,1594,TRUE,2804,1210,Radiant
9677c48a00868d12d46bfc6f1d66b2e6,526,FALSE,2182,1656,Dire
2d4598e1d4a13febfe0444d3b0dc1662,704,FALSE,2247,1543,Radiant
cef34f97c32c78a11769cb1ea1208f47,8,TRUE,2486,2478,Radiant
a9911333dceda8212b5c0e1c9858e1bb,1427,TRUE,2680,1253,Radiant
fd6196f1bae1521db8367bb879831ab8,1227,TRUE,1975,748,Radiant
b644987758d84c333a4e2b9b66b82058,1918,FALSE,2931,1013,Radiant
9196fb6a36cd69e5dd7c77b29e76e633,191,TRUE,1566,1375,
c566292cf3e27b8dd4f353f80521ced1,942,TRUE,1353,411,
c48ae91a70f02566d932405aa1f9df72,2209,TRUE,2293,84,
7fb39ebb5c105d76654668efe80f9376,886,TRUE,3456,2570,Radiant
bb01981bb2a946cc2e38693b399576d4,969,TRUE,1408,439,
83a8c59f78b98d8ce50e76f011207bcb,401,FALSE,2838,2437,Radiant
75793b7ce6b1b2dffefbc090d280e7e1,1937,TRUE,2161,224,
e33b35f23aa4a8066098f15570be7951,1332,TRUE,1756,424,
b0873c4cfd0ba90a1f004872ec33aa1a,646,TRUE,1784,1138,
9da873ab189e4bf9c0639814b1aa9038,1732,FALSE,1829,97,
be618917e44e8c2172fa0e7d99ba864f,2802,FALSE,2862,60,
d4bab162e1f9ab7d829759d4b13938a0,1561,TRUE,2293,732,Radiant
4494a6cd3e230a080f2c52752b045f2f,1072,FALSE,3436,2364,Dire
b753fd6d59056bc899705731bc1dfe7d,319,TRUE,2569,2250,Radiant
4dd056a95221c4cab7b7710855dcc5e5,140,TRUE,2070,1930,Radiant
bdb796386881a627e6c3f74e3687f808,233,TRUE,2473,2240,Radiant
5f351dccb4ec6572336bc45c2c4d3a46,1409,FALSE,1660,251,
1f743227f8b4d4f69108499a05061c1c,1407,TRUE,1847,440,Dire
1860f9b49ff1f20ae580c9f65e8f6021,1068,TRUE,2856,1788,Dire
451c4db2d1ff23862f45dff34c0b3a68,624,TRUE,2972,2348,Dire
ab8188d79587fc84102fd8e9b6ede872,967,FALSE,2850,1883,Dire
e38240d31b0249dda8b96013fe5c7d79,824,TRUE,1866,1042,Radiant
e5f3407b9d71453c4c94efecad9b284f,1056,FALSE,1352,296,Radiant
5115df0da1219f123a309a14ad3c3412,1858,TRUE,2158,300,
0f2a7ec19b86238cd49e40e056579bb2,1737,TRUE,1895,158,Radiant
308a0af6455abfa4a06144f4d3959ebd,1534,FALSE,3213,1679,Radiant
d58fb7f33942c34a3161e47c4ea82de4,1951,FALSE,2160,209,
3f30e9075a6f0ee9a7885470e63b1372,380,TRUE,2912,2532,Radiant
a65925935fb2fa3118fd8ae950139f5d,42,FALSE,2199,2157,Radiant
db5d9cb64603e1455fcc14a387e421e5,899,TRUE,1820,921,
944c743b76ed61e54066b6c18599c189,773,FALSE,1924,1151,
795594c60ad507f3723c79b3223f8b3e,1192,FALSE,2194,1002,Dire
fa09bf48de59d8998e912aef190aebcb,747,TRUE,1428,681,Radiant
007f29af40ba84d8a0d32f95b133a3e0,1731,TRUE,1951,220,
3f3f8985c156c87861778522cb23b152,1897,TRUE,3145,1248,Dire
817044e1cb78ab0d1107c7c76c3be4c3,558,TRUE,2718,2160,Dire
5f3b1308767a6ee3849cab9564b3d2d9,2404,TRUE,2834,430,
2f09e812e1ff9519de6885a1e79684be,558,FALSE,1295,737,Dire
75adc6f57c4dd432d95cc903e5e5a177,2283,TRUE,2370,87,
d3896eec37594ecb95707d590986ff97,1988,TRUE,2720,732,Radiant
637d118614945c9f0fe7069ed12e6d96,1112,TRUE,2824,1712,Dire
19254982f4a121f282ddfd6c08ff3d6b,1151,FALSE,3456,2305,Dire
a6906e7c2e5b82fade1901fe124d974e,125,FALSE,2784,2659,Dire
5d90f8d3a739c1b54211cd29dd9e2018,1924,TRUE,2345,421,Radiant
aacda5913ffc3fb8c80759b5e6c9ca00,2334,FALSE,2582,248,Radiant
a35306bb91a82b22eb1817814e698aee,529,FALSE,3294,2765,Radiant
088ae131fee18bf1fae7477755945bd5,679,TRUE,1777,1098,
6a3b0f77267a049a0b03d050ac9a1c8a,1724,TRUE,2650,926,
58e0c2241a3d89feb029af5f1c47727f,1419,TRUE,2559,1140,Radiant
eff36a90739bd9b0bba98b35dde6e5a2,1537,TRUE,1641,104,Radiant
7bc84272fe6fdeb4c27a358efec7140d,572,TRUE,1211,639,
34ebcc153dcfa6bc39d83550577fd2bf,1569,TRUE,2082,513,Radiant
7d8aedd5eec22941aa9de05722771564,937,FALSE,2682,1745,Dire
44d14afc7edb200613199c04e84317a5,495,TRUE,1549,1054,Radiant
496809b9ac4a5f745a17b29ae921cdd0,216,FALSE,2110,1894,Dire
e5f36a4c26a4bf1525cd9d44092d1dd6,955,FALSE,2192,1237,Dire
9ee7f3e018924889572a1fc5122307d5,451,FALSE,3761,3310,Radiant
254f2460846b448fe4a45d4f304ab972,2003,FALSE,2631,628,Radiant
c1a2660387b0eb679639895abfd62c2c,2404,TRUE,2597,193,
fa59e74f5683130b4d75eab067c487c3,678,TRUE,1024,346,
8191f0a80bc08cfc48e83f74389dd656,3345,TRUE,3446,101,
3917624865025d38f07f9754a0a35684,731,TRUE,1050,319,
1d09bacd5a720f7ee5d90da62bbb3bf5,1162,FALSE,1967,805,Dire
2b42976cdf5b621eda302737109bed80,1507,FALSE,2017,510,Dire
0f4ce38e2c6f87d9962e89d2512268f9,1420,FALSE,2069,649,
adc23ead5d54e8cf6a1ccb3bc5b09dd6,869,FALSE,4532,3663,Radiant
1226650c4a054de1c889eeaba3bdeecb,493,FALSE,1428,935,
8816a2d1fa495afbf29a6d255f7d14f2,120,FALSE,938,818,
47070e5790f1605c0a2a82e5a9d0ba5d,1900,FALSE,2754,854,Dire
ffa3cf601ed37c2bf1cf84a4ad4e079e,368,FALSE,2002,1634,Dire
2113d9d8bf24bca6caa1d2d0ae8329db,629,FALSE,2547,1918,Radiant
cc829a8ae2d853fa8dca922de460c946,771,TRUE,2002,1231,Radiant
97cb3fffe974b1e1f51d57012d1efaf3,1165,FALSE,3797,2632,Radiant
489fb7c6dec692bed590a60df1073332,1130,FALSE,2282,1152,Dire
f372855ad792877afe3e3d0d027888dd,114,TRUE,1197,1083,
bd44d7161c62134a7ee563e6cfc1b796,1985,TRUE,2490,505,Radiant
0231fdcae2ed0e3032d57d4d2c1e79fd,864,TRUE,2465,1601,Radiant
4b219b56cf3a48af99e27a1c5b140c9d,1006,FALSE,2640,1634,Dire
bb77fb8b001a75eb73badb43d85e8744,182,TRUE,2576,2394,Dire
be493d7110089e53b429e86d68533cbf,556,TRUE,1972,1416,Radiant
f2d00938699bc39033f8fe2c3ef9f12b,2054,FALSE,2708,654,Dire
cfa0a0dc8aeb4fdca878535df37eb3e2,501,FALSE,1998,1497,
943a340412e6c1738dca13a8bc6b7fa7,384,FALSE,1953,1569,Dire
1cfff209942e6e43552f2761ffb5d681,1098,FALSE,2001,903,Dire
71c45b8f00f0d805566dc37661b7073b,1297,TRUE,2281,984,Dire
84412c495a725c163d0083cdc2388f85,1560,FALSE,2501,941,Dire
b5bd5809f588ddc663cfc0abf1cf98f5,1917,FALSE,2587,670,Dire
3742c81bf642e9ce3921bbdc0f9029ea,103,TRUE,2685,2582,Dire
8d15022249d16e272b01385bb84f9902,2392,TRUE,2488,96,Radiant
12384146e193b741c32f3a468a17a00d,441,FALSE,1545,1104,Radiant
2fc60612bf64c02542de3487a2b3422c,1271,TRUE,2841,1570,Dire
87281a19dd7c942cc3fa0d1a3800f420,1728,TRUE,2706,978,Radiant
ecbc51e7c4e2e97dc21f23e3d83fa931,110,FALSE,3518,3408,Radiant
5d046ea70673c7458795e8eb9f3d4ac7,1267,FALSE,2865,1598,Dire
b24ec55479a166e57cb0e35598347962,406,TRUE,3124,2718,Radiant
ca7090e16f7cf00adad97948d47f1e48,1751,FALSE,2518,767,Dire
e15714a3952c2a201b44c45c6ff5ebee,1651,TRUE,2088,437,
6fd84260c0989e351d0ec28ae420e283,2826,FALSE,2878,52,
65e662196dc640d7bb4b88101510d310,773,FALSE,1481,708,
cfec5058180c8485005673cd50439e2a,2132,TRUE,2413,281,
ccba8feedb9a24e970b3275e3e7e4f30,1981,TRUE,3632,1651,Radiant
e23872ed7454e6a890ecb24a1574422e,2779,FALSE,3144,365,Dire
3173647687026c6e5ffaa93b67383405,771,TRUE,1164,393,
9f5c83c0f8b59df207215163bacbc309,231,TRUE,1701,1470,Radiant
07081fd3b2927c05347a5398b550d261,198,TRUE,2204,2006,Radiant
c6753fed550b7cdfc781dc392de90980,986,FALSE,2036,1050,Dire
c3bb45e991deb3729f71171637457c0d,435,FALSE,1588,1153,Dire
962682ffc9ffbd150d52adff6ebc101e,1505,TRUE,2547,1042,Dire
f876b3377092fc72370226f69766b58a,2215,TRUE,2805,590,
9724a273d18ad9cf01460cf2cf198c7f,1617,FALSE,2493,876,Dire
22cba8615d0378242bb5375d3807bb90,19,FALSE,1907,1888,Dire
306c0b68b55755d6635f13b32f0e7415,422,FALSE,2534,2112,
fae0b4fc62b8cb8ad1aff2c8f661c5cd,1402,TRUE,1678,276,
24ca6a1677e8919ad56d9b8e8c9ac0b5,74,TRUE,2404,2330,Radiant
3408949620d3103793cae6650dd8a8b4,2035,TRUE,2791,756,
ab33cfcbdb10ded8ee06fb01b9dd534d,1775,TRUE,2438,663,
48bce0074432ff0145eab34757027551,1332,TRUE,1861,529,Radiant
f1f93436bcd669f16fb234551d55d52b,1079,TRUE,2045,966,Dire
3e99c421f364a3f1374c4c2ddd1fa4b3,986,TRUE,2757,1771,Radiant
0a943d10a5bb6038c1c7c66a4e76547f,1580,TRUE,1880,300,
a5941078efaca2021f0eccb6b74f6f3b,1774,FALSE,2195,421,
22ad3ba8212b20f742668934c9624173,960,FALSE,3447,2487,Dire
537b9d70bb48a8f542a5e9995e9030c5,718,FALSE,1639,921,Dire
3377d7217f4f4771fe1747a0818bd1ff,2612,FALSE,2822,210,
9a00b37c858ff512f6ef47e7390d4dc1,1757,TRUE,3047,1290,Radiant
e79c1b0ba179001ac9797b08cc40eaa2,540,TRUE,1702,1162,
d733f1726c462ca169f7b77675dd8bbd,347,FALSE,1443,1096,
2c5c891975b40f13e5d8ae4cdf562d74,2684,FALSE,2855,171,
cd73dce95f6b9af00697be9d75a2ec2d,2471,FALSE,3903,1432,Dire
562eb80454aa85bec3d7e9a7479cfdea,1376,TRUE,2495,1119,Radiant
3d3096b5c04bc8645ccf748f03a4fd1a,1313,TRUE,2801,1488,Radiant
15f3ef750f9dd9adb5b9eab1f35ae3ee,51,TRUE,1971,1920,
4551bcfa09322cf4832e9cac3e74127b,592,FALSE,1943,1351,Dire
f1475adefbf95051a209103e193655df,1885,TRUE,2957,1072,Radiant
3e05a9009188d977e969c45868b1c67b,1461,FALSE,1955,494,Dire
a629b112b1d76816148bb5c6e0e4a08e,1132,TRUE,2498,1366,Radiant
3728d22dea9c6d2b1fe10896a3ca4357,1159,TRUE,2426,1267,Dire
2874f6b8348d0d4562a032344252487f,843,FALSE,2092,1249,Dire
83420257ce6a1eec505071f8e0ae74ea,340,TRUE,2265,1925,
8b278ec57fbc01d7dc8f1ad50e41950c,2,FALSE,983,981,
d7de356af63b4eb8462f1f580023dd64,1318,TRUE,4515,3197,Dire
9d5dd1842676b9e2c77a75d855b4c3d1,2817,FALSE,3404,587,Dire
b6be3b59145f831e8768daea6542e829,2744,TRUE,3234,490,
968ad738eb9d59f3148bf8515968b9f4,768,FALSE,2342,1574,Dire
53d4af884f4442dacfb5953a49eb0236,1400,FALSE,1961,561,Dire
149efdc5e74944af295ec6ab055cef91,706,FALSE,4234,3528,Radiant
9b05f5bda7643ab87a8f058a50843c01,551,TRUE,1790,1239,
fa4f867914ea5117f0f785b73f1f3ca6,652,FALSE,1854,1202,Dire
413aa641b47d717348926eb991c091c5,1077,FALSE,2476,1399,Radiant
c54dcc2fbeb756ecd0dcce7689f0dcd7,1813,FALSE,3707,1894,Radiant
492e44bc4a4c2c25816f9d2d3ed527eb,1701,FALSE,2132,431,
5c3219194a7b3a161db7f4976407d253,792,FALSE,1663,871,
24c6d6f417dfbbb75dffe66573426afd,1744,TRUE,2683,939,Radiant
bbf931d6f2543a97495eabce417f1ef7,834,FALSE,1583,749,
771247ec23c9fae2ad75a7faaaa79361,1662,TRUE,3857,2195,Dire
b2e06e8530739f15905dca14e76c280a,471,TRUE,2130,1659,
0c561e8828461206606feb281308038f,584,FALSE,1282,698,
d0bfd08bd5560e2431afd366b7d8b518,1647,FALSE,2666,1019,Dire
a104c0df2f52529b1e8a66e8279d07bb,2760,TRUE,3519,759,
27587504145ce90773524708a3935bda,576,FALSE,3017,2441,Dire
89a1f6d09142e2356dee8d8fd08d478d,1444,TRUE,2011,567,
26a4045ee1f11f0c9ed403c6d0e9db63,1523,TRUE,2393,870,Radiant
41c104e8cb4275b1e7ee1b6b4856c52f,800,TRUE,2644,1844,Radiant
883259627eb3ab80002936672d3c2b53,1697,FALSE,2832,1135,Dire
66dc7a38f9e380cb2e3ec5ad908732da,3020,FALSE,4267,1247,Dire
25c028dc0ccb0d7480390e24de70bf02,1780,FALSE,2191,411,Dire
d77d93d5f4268b495614fc3f486c37cf,1025,TRUE,2266,1241,Radiant
257d2d9a98a55805b4a676320a652940,1634,TRUE,2380,746,Radiant
6bd35173e8d87505d1678cacc4b2c113,1511,FALSE,2094,583,Dire
acc19c00969a538f86ae50e0d76aac2f,836,TRUE,2618,1782,Radiant
2ce30e7b481052407ec63055179deb4d,1495,TRUE,2928,1433,Radiant
375c158c7c6f22f98b4abce92fc38cf2,1066,FALSE,1660,594,
1b703d187d2c26f24fb73306fb4d84f2,1512,TRUE,3028,1516,Radiant
cac665e79c20ecbb188c14d8666630b1,2115,TRUE,2543,428,
6a1919812d59e3ea01830bdfa34c2d9b,56,TRUE,2183,2127,Dire
3c607bafbb3d91842b1152fbca67967e,1557,FALSE,2798,1241,Dire
89eb1797a191262b2bee3d1296fded29,2110,FALSE,4522,2412,Radiant
493bf56a554c3baa64bc1a4e95d2a39a,1489,TRUE,1748,259,Radiant
bb5d3777c3c3b717be9dacee3f30addb,1735,FALSE,2620,885,Dire
802f5881e14973e50f6eb53967ff83b5,1727,FALSE,3286,1559,Dire
9d1a6a22ef5b17285c4385481b81d750,3268,TRUE,3375,107,
f85f0af9cb44aa478a2d92c95afa99f0,1051,FALSE,2609,1558,Dire
494321fd091f98c422a26e44fc8a747b,1436,TRUE,2074,638,Dire
383a223d813aab7a00111157a8b22ef2,1493,TRUE,3371,1878,Dire
e984c21cde9fe65788dbf323cf123b48,172,TRUE,1746,1574,Radiant
8c754ba378aa6b65e38a1de04ef22d04,1223,FALSE,2840,1617,Radiant
628fde3971df13cdbbe43e872c43df98,346,TRUE,2307,1961,Radiant
5035eecf5d779bf4b650e835caa83325,1800,FALSE,2627,827,Radiant
db161f3fbfd2311a4e663a60a0d38ff7,1065,TRUE,2127,1062,
f00b03c9166e872f6340a1c228a352ff,238,TRUE,3306,3068,Radiant
e059d26a3cecd6e03846ad2ef3e49983,389,FALSE,2453,2064,
96c949f1424a254b77810790603f6860,469,FALSE,1680,1211,Radiant
258f3f3f5a7bf2d2de45495f67619df8,1020,TRUE,2668,1648,Radiant
e8a40ecc3e3e3bd58ff65a3532a853f9,776,TRUE,1061,285,
c2e4b175ef8b4f2bfcc03ebe416b0113,523,FALSE,2168,1645,Dire
55d99b94194bfc2afc595c9b1378b3f6,1640,TRUE,2357,717,Radiant
3e6ad5b94c32989c49c7791ada037fa3,794,TRUE,3473,2679,Dire
df9476838d8f39e6e3fd96e3784b5b8d,1974,TRUE,2397,423,Radiant
a70b64670b7142722afae1692a3dbc67,735,FALSE,3224,2489,Dire
3657ef1fbc79bda817ca34463d5c72ed,814,FALSE,2810,1996,Dire
de26d2ebcb58908128a551b9219d9f35,1122,TRUE,3416,2294,Dire
e982daaf9aa8e15921a5f113b4ee9657,367,FALSE,2236,1869,
9a9a4b58d60c12c7a7e31c9ee143bba5,1054,TRUE,1780,726,Radiant
5625739b2fb0a8f9f39ef8071a85186a,719,FALSE,1993,1274,Dire
95b31b2213d6c9e5f64ba054adb86275,2193,TRUE,2246,53,
b833ccc4f2db970d758ff70355244777,1095,TRUE,3502,2407,Dire
b0b1ce6f1086fd4178a5992cd2ce1a39,2157,TRUE,2890,733,
36ac5f087b01522bacdfc394edf0cb70,79,TRUE,1639,1560,
73747e48d15f7598eeb4784e70f2941a,1278,FALSE,2391,1113,Radiant
1e681cd0ba789ad01faadfce916f0c35,847,FALSE,1388,541,Dire
5355cc33d123a9984cf3001da7afb4ea,925,TRUE,1448,523,
ac790ef7ebee0cafdf2bb6c9ca0e96fb,183,FALSE,1943,1760,
6a6e1a306de4c5ea4f3ed970318a7934,489,TRUE,1725,1236,
43f97f8c59c983388724ccf9ab16c4cb,454,FALSE,1337,883,
50523c618448f2337954869903ba3321,2117,FALSE,2770,653,Radiant
b39e7fb9b02ac5d592c9575d55ed39c8,228,TRUE,1375,1147,
11bf3bc9e1f646494fe92d1b04c75823,1015,FALSE,2310,1295,Dire
13c20f18bc74e7600da271b524740157,33,FALSE,1269,1236,
e0ba87af5490817ef1dc043d4522bc31,410,TRUE,1602,1192,Radiant
54ccd844c7102cada01a9ead0eaa2104,1775,TRUE,2454,679,Dire
9226079913789817461e62e6f4369c4e,2531,TRUE,2769,238,Radiant
304c2a2e351f332d4445dfd84c0be09d,886,TRUE,2393,1507,Radiant
2a43d7f0611bd90cc780c090734722b4,0,FALSE,1990,1990,Radiant
40a9524950f9bff18244b2f71f57f4f5,1202,TRUE,1360,158,
b3e46a56b6ed1aa7b2710e5ff98fee3f,2355,TRUE,2700,345,
f0a862f1834c4074ae337f894fcb15f5,1491,FALSE,2177,686,Radiant
ac019ba197bfae93ca4482921e2fc4bb,767,TRUE,3433,2666,Dire
ef2ca1057055e00c799670725c58e74e,1262,TRUE,2524,1262,Radiant
d2d2d30bbca4fa8c724b7028f6cc00bb,421,TRUE,1924,1503,Radiant
bc9027c78151fb0fb8606c13bf841dc7,599,FALSE,2868,2269,Radiant
51325cb8a5f864248d6a4b9927ffbb48,450,TRUE,1707,1257,
caede5bf53b2a1084113659b39e8650a,380,FALSE,2215,1835,
ab110868c15e305dc1fcc45e9b1b95f3,501,TRUE,1099,598,
47cfe6afab64d7245dcd66b6306d83ab,676,FALSE,2552,1876,
4bf589284a0d9eeb216662564c9187db,1101,FALSE,1964,863,
574e78f7770663bccaaf2a447998b153,40,FALSE,2139,2099,Radiant
28224c7514dc114b6147698957ad2ff6,1127,FALSE,1324,197,
a5a01b306a8bf4b52f5072fcc5efabc7,1324,FALSE,1590,266,
486bb3dd801f7498e100fc4000639edb,626,FALSE,3066,2440,Radiant
17ffa416edd744415c9cee9194252cd5,714,TRUE,2729,2015,Radiant
da6faf1779aecc435f863d95a42f7cd0,965,TRUE,1309,344,
d25d72ba8593b3f1ea2684bf70daa7e8,1554,TRUE,2643,1089,Dire
68672d293ebf0cc05626e2c671b1cbdc,838,FALSE,1389,551,Dire
d3c98d2436d63f0e15cd4a4ee0213a58,767,FALSE,2065,1298,Dire
2f9cc2ee3ad1d0bedc8ba49d44a14e63,16,FALSE,2261,2245,Dire
b55774d93766444cdda0b71ef8a80172,1727,FALSE,2235,508,
304de977da7c71e970b61f2c2eebd1c4,976,FALSE,2874,1898,Dire
88b55bdadb38312edbaf604c8bbd8a2e,2499,TRUE,2867,368,Dire
bd9237de0a168ac9f649084fdab3df9b,241,FALSE,3213,2972,Dire
39db13a245cb4998f3746bc481a2e120,2055,TRUE,2132,77,
a9f52c509957fd4bdcd76b68257b2bc3,562,FALSE,1609,1047,Dire
6f1a389bd8b17064b2b7384c2234b2b1,706,FALSE,3475,2769,Radiant
c5d441415682f23d4c5b025f5257e976,1966,FALSE,2987,1021,Dire
fc928dcff9cdaf33e33fa7d24533773f,520,FALSE,1942,1422,Dire
06f8343e155a949fcdcb4bf19dff5c75,340,FALSE,1800,1460,
c19837f0e0c6125ef9bebad4a33468e2,1640,TRUE,2691,1051,Dire
5d2f2edcf2c29bf7324b8b35af79c1d1,255,TRUE,2943,2688,Radiant
4c365d8b1f74a4a11f93531911b08e79,1804,FALSE,2788,984,Dire
e76245996f3e5fac31bc568a17898c95,207,TRUE,1915,1708,
9ae3bb6b2db1a610e82fd004d364941d,1413,FALSE,3227,1814,Radiant
7bfa6ba0ffd131fe41fd4310b8e0ff96,627,FALSE,1127,500,
9f2b3949a1cb5cb45acb4569d8740a07,1444,TRUE,1868,424,
567bf68c94d787d247ae76a40f1a6fa8,356,FALSE,2358,2002,
5dea409a1553bd3d9cde823301e0fe9c,1186,FALSE,1966,780,Dire
b3ce3a85fc555a3670eebe91c86dbb0f,48,TRUE,1811,1763,
e0d3fc0e904dd3b23ecef800bab54fa2,1918,TRUE,2224,306,
4606c17a573255a2b775ee97d4de96d3,2415,TRUE,2963,548,Radiant
a5840b3b3993a4d81f23b68e6f5e829f,1144,FALSE,1892,748,
350f6f7e962040ad38e69bcea3691e6a,2298,TRUE,2639,341,
97cb9bd2baa770cb7f25135329d90324,1757,FALSE,2685,928,
e9628e472958315b9719cc1e33d75658,2421,FALSE,2474,53,
572c9574cea96679ee10e71b68b191a6,236,TRUE,2067,1831,Radiant
f7e283220c10d86cfbad0017a658835b,879,FALSE,2635,1756,
3e5e80d303268084331b8e19e05a0b4d,2767,FALSE,2807,40,
afaa28918fb7a85b8e4a9bebb186f713,1932,FALSE,2617,685,
49537e66037ee1a5c51857320158c6e9,330,TRUE,2082,1752,Radiant
7ef9018184a07ef0f5636f2fdecda7c3,573,FALSE,1907,1334,
4cbc02d087b06229b00f20df4a9bf9d5,3024,FALSE,3503,479,Dire
c2e9ea05d679ed3feedbe1ae27d62b4d,474,TRUE,2300,1826,Radiant
0bdfba732d085beb4097bb7cdc4b01c6,849,TRUE,1882,1033,Radiant
bc864e8e3b80283142129ffeb5a5017b,511,TRUE,3405,2894,Radiant
dbd832f5f35be86dff65dd7132dfd32f,402,FALSE,2781,2379,Radiant
11a1f4e500204338424aca8acae397b1,1853,FALSE,3379,1526,Radiant
d1ca9952c344325eec98aa94d4ff419a,468,FALSE,2420,1952,Dire
543c0588777fa96f28a5f719aaf95ac7,189,FALSE,1962,1773,Dire
6dc25aab1e4d3f077a920c08fb5f0ba6,959,FALSE,1692,733,
ea8d373f6606aa04b031781d446019c2,2056,TRUE,2666,610,Radiant
1952a90f4d36ca1f16b2a1cd85476b31,2540,FALSE,3384,844,Dire
c8565e5c7c9c7382f7d2fb1efea98624,132,TRUE,1539,1407,
913dc14ee9ca5b12a04851db199c647e,1481,FALSE,2962,1481,Dire
c5c6f0f7044243f6b7d5df7a5100d04d,2234,FALSE,2609,375,Dire
419dca05e9b65d3a955a8f3f2dc11118,2158,FALSE,2860,702,Dire
6bebfb61e4646ca3552a0df0926f2484,586,FALSE,2480,1894,Dire
a25ce26ea91662ba9c4221f13e96edd8,430,TRUE,2276,1846,
e163af2d05ea74f268d96a2571bf8648,406,TRUE,1069,663,Radiant
77bb6a78362869e43e4237e27d72177b,1825,FALSE,2262,437,
aa52617612c31560eed290fd458f8526,267,TRUE,933,666,
c01c9c060725d4add19e40e6a6dc884e,1046,TRUE,2187,1141,Radiant
9e480530b9c0b81bc2283edcfc782621,291,TRUE,2958,2667,Dire
7428a251bb4b654de310cda219e8ddfc,744,TRUE,2169,1425,Radiant
f38e90a8f20fe0cb4e2d384147e3d87d,200,FALSE,2392,2192,
652aee261d0915096682ff67d594129d,1310,TRUE,2122,812,
275a769a9c2eedc8a0949aac55f279de,55,FALSE,974,919,
ad0f581defad994a66ecdc010c3f54e7,379,TRUE,1709,1330,
1abb02f504f00b64d06f8f8cd3c8aaa4,979,FALSE,1897,918,Dire
830731896770023433d8b7f798d4f3f9,1574,TRUE,2200,626,
aebce9e6c611ee445b0886cb8e82a02c,1496,TRUE,2870,1374,Radiant
2c3e66e6c0a240cab5566294d6b87d6a,885,FALSE,2401,1516,Dire
d92f89b2dfd19f26189c2638034d2bb2,2070,TRUE,2258,188,Radiant
e46add4e8cf3f8477db4082efd067d58,2434,TRUE,2719,285,Radiant
e4b87defe98b255e545bc37f6feaa0cf,1161,TRUE,1593,432,Radiant
47e7b1cd9505074b7d2680111d24a3c2,145,FALSE,1684,1539,
c9293a3187330cffee0363a1373a6779,1780,FALSE,2171,391,Dire
540152d7b7c77db5bb14a7cfc4fc94a6,1423,TRUE,2472,1049,Radiant
ebcec202587726d255c03155b659eaf3,1610,FALSE,2283,673,
28480e4286f2099f51635f6183ab2a1d,1468,TRUE,2872,1404,Radiant
b59410d9ca52f10c020f0a1dc3a90033,2059,FALSE,2243,184,
608d0376c8b15e0c4af8fc1aebd16f33,32,TRUE,1319,1287,
f00b9e4c95ffe467bd9ed7755190bb7c,1241,FALSE,1639,398,
93bccb4a902a5b6ed486d597149c6619,2446,FALSE,2602,156,Dire
130fbae7df251de1c0ef814085c3df07,2638,FALSE,2856,218,Dire
6a1dfca38983114c936094b90c91ee98,1644,TRUE,2502,858,Radiant
28aa3f31aa4b4970759114537644e701,19,TRUE,2074,2055,
f5c9cfa0f5c2acb8e5cb0f7fea9e176c,1517,TRUE,2669,1152,
8f63556b3cd61632f96685463164676d,1396,FALSE,2797,1401,Radiant
fcafc36e916a4fc1f8380d6b98030c40,540,TRUE,2139,1599,Radiant
240475f72731b14034425b374a0d5394,597,FALSE,2827,2230,Radiant
456d9d28d1c5f215a496335b931c758f,1293,TRUE,2144,851,Radiant
7476fafe638ee2a1ab41aacb34632b0c,790,TRUE,2356,1566,
c3b1ae2aad5b07ce951d872c74dfcada,971,TRUE,3170,2199,Radiant
2b3d29ed95572be10bcb8396bdb4ad88,1032,FALSE,3067,2035,Dire
37600eb1cc2ac05f12e9b7e94f3c79dd,1709,FALSE,2103,394,
97507f8f59954a07b21ebc47cb6209ea,511,TRUE,1124,613,
f6ecbb264bbaedb2b0a753115b937d2c,2615,TRUE,3618,1003,Dire
68882db2bd3e2d5da1682bd953613d72,1925,FALSE,2709,784,Dire
a0b5f4c42510b82ce90682f0b9c7f487,284,TRUE,1733,1449,
6641abbaf13e812b7e3d1c00384afd26,2358,FALSE,2878,520,
d1d25ff395d14fc8a740846e6c2d3604,266,TRUE,1800,1534,Radiant
f207522964d47396b51a1e132bb2e0a3,2787,TRUE,3670,883,Radiant
6527ff54834dcfecc7db61c6f0f7dc1c,816,TRUE,2467,1651,Radiant
86d8733bcaabe026e0fab6bfad5b7712,937,TRUE,1088,151,
d87d65d1606a6f2e48140be55463730e,2124,FALSE,3279,1155,Dire
f1c5795f1e93e6237ec91969946aa0f0,809,FALSE,1698,889,Dire
6ebf95d91e69436d3e715d747dbc51dc,1436,FALSE,2200,764,Dire
cdf8b0cd18dc6bfd066375f1cb9f6960,938,TRUE,1924,986,Radiant
acfb69426e58670019cfcc3b40c04af1,1672,FALSE,3288,1616,Dire
e6182a17417b3ce8a1b7930578a83072,566,FALSE,1513,947,
aff5c9874b2de8973866fb6060573649,881,TRUE,1375,494,
f026a874c5a5039019e0a7bc79a7e0ac,1469,FALSE,1941,472,Dire
e633ec0b892317de68f7f55828fa6b36,635,TRUE,1836,1201,Radiant
3feeb9a8deb354dc7d2ee6ef2896da7a,1203,TRUE,2389,1186,Radiant
9480be3952097263a89039ebf73b4472,1911,TRUE,2077,166,
a642c694e071269a68002ec7e092a3da,28,FALSE,2210,2182,Dire
989dc2179a7426e559d11311e6a2d4d1,1040,FALSE,2200,1160,Dire
8bf84b2487c2b9cc653b436372abdeed,1130,FALSE,3214,2084,Radiant
7b7ee7cc7d6926d5105a89f4850f8be1,2697,FALSE,2962,265,
eb0bec2530a5dd898cf810ae58a77ec2,80,TRUE,2180,2100,Radiant
167c3bf414128e1359ba55100de70fb6,1816,FALSE,3168,1352,Radiant
f58a3168803862257245cff4505c6512,1538,TRUE,2103,565,Dire
5b3b1b1f263e3f546d0f2dab9f64aa28,121,FALSE,1529,1408,
d2436d32ac3e3049c13abd29ad03c698,440,FALSE,3968,3528,Dire
969bfd7591bb5818c6873dffb19b49d4,1524,TRUE,2272,748,Radiant
858c3f814279e14c7718f9b3bbd964e9,369,TRUE,2719,2350,Radiant
ca3c09faba5cd65641ac77873b5dd1c3,1402,TRUE,1997,595,Radiant
d62f26f09b050fe2c00b23aa6678c609,2382,TRUE,2718,336,
a53ebc2ad8845d28ba5a94042052702a,1307,TRUE,3335,2028,Radiant
206700d560b9acd60de644d3fb385dac,669,FALSE,2017,1348,Dire
aa542eda579ef541a0c1c9acbf21f3bd,143,TRUE,2433,2290,Radiant
f5934c9c9e5ac96d9b968844729328cc,252,TRUE,2840,2588,Dire
dd1f7c1df5231909856ec4b1791a506e,2002,FALSE,3388,1386,Dire
e30b2fa9939406fa119af010668bd5d0,1494,TRUE,3662,2168,Radiant
865fffaa1975e299063e690ea23e6aa6,1189,FALSE,2977,1788,Dire
28852e965f54da9aa3aea5f26cba3d72,2357,FALSE,2764,407,Dire
8af3cdf0a270027e85112ccb6b46b956,1414,TRUE,2019,605,
835062b527756c00230ed3de41d396a2,937,FALSE,1927,990,
993850e4c5bfe04f35c63c7c6c9c792e,396,TRUE,2335,1939,Dire
2ad125c268bccb0d173a2e273caf95be,2172,FALSE,2720,548,Dire
c5c77d6c434c2da73a3e0ecc851aff18,2350,FALSE,3099,749,Radiant
0969b7b8509d24246b10af9f451a0788,1509,TRUE,3480,1971,Dire
ddbd4fc11f9698f384bbed415e13e593,889,TRUE,2032,1143,Dire
a8ed69273a5cda4f6a8b3ee81fb358fd,2041,FALSE,3002,961,Dire
b54065ffefc969b41852957f996daee7,1682,TRUE,2369,687,
12cb9ed16b191c50a14e203688ee4987,656,FALSE,2169,1513,Dire
e2ef3f27a84951c301ddb87d56948c36,390,TRUE,1640,1250,Radiant
03c2987ab0358fda8ff89748adda2afc,358,FALSE,2463,2105,Dire
b75ccc4ee13f5dcd2bf49b9abeda54a5,1847,TRUE,2119,272,
c1d139f7354279fcfc93211830cc1343,1211,TRUE,1963,752,
8e7d4f7343c1bd3fe947dbe6ffb4b0a8,124,TRUE,1774,1650,Dire
4dc014ace4f589d858ac081a537f16df,716,TRUE,3268,2552,Radiant
1bbb5b76906c8ab1d77ad67c12bbb45c,1987,TRUE,2310,323,
5fa2cf38fbebc59fe0fe4950820dacf6,1690,FALSE,2950,1260,Dire
80794680c9ad6ec18f0dfa047c1a070a,471,FALSE,3466,2995,Dire
a4803da2538f59d157f3683cbfced4d0,389,TRUE,2652,2263,Radiant
c4aa6f381d341543d2b0e387f78d01c1,1846,TRUE,2097,251,
bf716ababb37da29b76215446a24de51,959,TRUE,2248,1289,
a60d7b1c00eef2fca0e2005473b1e0f4,3037,FALSE,3126,89,
0c167ccdbac8972c440ecaf9af93b9a0,332,TRUE,1873,1541,Radiant
a078a24946754c7060820bed9a4de005,1335,FALSE,2252,917,Dire
83619a59093fb74bfed7e6e5bad181c7,1159,TRUE,1282,123,
1350ae89b4fca333a05d2bc9b7a6f6c5,481,FALSE,2329,1848,Dire
d0f9539957a67d41cabdf1eb61afc5a6,306,FALSE,1547,1241,
b4c6a0730859ff5cbad0716a7c23cc55,169,FALSE,1982,1813,Dire
daa8db8788988ef539bec6e6d648318f,1471,TRUE,1885,414,
9a0f11e2d168a4979141f8b5fc3889aa,1360,FALSE,2942,1582,
066eee76ca646e2f82dd74f32c211eb4,2026,FALSE,2235,209,
eb3a782554a2ff2f600ed035df946110,107,FALSE,2495,2388,Dire
e0b55dc332e578fe53b80856604806ab,1444,TRUE,3664,2220,Radiant
acb80e813d9b50c013232c92f554402f,1015,TRUE,2469,1454,Radiant
7af947eb056a43447291af0e6f31435e,499,TRUE,1687,1188,Dire
7332119dd0db26a91c5065b73f5c1ae5,1147,FALSE,1645,498,
95167bddeb6c05d145abd2551e96b6b9,205,FALSE,3053,2848,Dire
2cf5e7496548d4b38a49ddff27300784,1566,FALSE,2957,1391,Radiant
62ada44979a9542cae40bbda020219e5,239,TRUE,2530,2291,Radiant
571a39f7456f9915aaf8f930e59ca1a3,674,TRUE,2629,1955,Radiant
184efa1b8f30095ea219af0191826c84,2374,FALSE,3813,1439,Dire
716e03ca8549a3e7e6ca13b8fef6c4d5,1493,FALSE,1951,458,Dire
e3586c6aee870345ba9cae565659e2d3,263,TRUE,1711,1448,
673148d0e82397c183a32b0d31b6e657,1066,TRUE,2175,1109,
c55abb782800bbdc4d96bc85c2b63b85,409,FALSE,2475,2066,Dire
387c251a674fb83d0c931a571fffb482,577,TRUE,1818,1241,Radiant
f445b3b902f80741a5f7b3c525fea0cf,1218,TRUE,2010,792,
eb68547250faf515b88db9156224e438,402,FALSE,1741,1339,Dire
6e6cb4b9e4f88e280be16ccd70380575,3044,TRUE,3694,650,
cd3a64c7b3f36abe18deca905e7c5d36,62,TRUE,2130,2068,Radiant
e9f74d4bac442f7ff4b49c83a06854ed,567,TRUE,2169,1602,
3f9f41152fe74bc9d13e965b0d7a0346,252,TRUE,1618,1366,
b8103b2daac36e98ac3d3331ddf42458,2290,FALSE,2691,401,Radiant
c98c5e6b17709d28d15a02655d2f4026,2250,FALSE,2545,295,
106062804dc2a0f3b29cbb43c58e1c89,505,FALSE,2323,1818,Dire
9e965c6aa1bb74422c5a7b841ed5c36e,1605,TRUE,2713,1108,Radiant
b4715a40efb3af0cc2380b94d125b738,1859,FALSE,2574,715,Radiant
1f6ea548b03db550894b06f4a46e34c1,1180,TRUE,1301,121,
5fc7b44cb83166825d9c525c5e45e0de,870,TRUE,2919,2049,
f62b57b445510040d5c0c8cf2082d55c,1187,TRUE,1223,36,
62bdf217662174567d27e8d6c89dc7be,795,TRUE,1685,890,Radiant
96dd7dfa06736ead0c59bb2f9f5f3ebf,562,TRUE,1225,663,Radiant
543b9a44e8f6bdb30c3bf441ba74a09a,2543,FALSE,2994,451,
c0c87efd03c60a235b69e520f8298472,346,TRUE,2290,1944,Dire
b96df44da51ba479806f6989a73c4fef,660,TRUE,1144,484,
ebb9ca6ce94c3c45df4fa9c2965b1732,356,FALSE,1537,1181,Dire
a325f355304b2fc882e7be5220325b34,1264,FALSE,3044,1780,Dire
3d4b2bd982187b7b58dec475462b1935,218,TRUE,2081,1863,Radiant
35c8b19ab2fc677d83b18aa87dcd1afe,25,TRUE,1383,1358,
281977a7c895ad45e6a88a9e01214d9c,1425,TRUE,4117,2692,Radiant
b6be86b245945defb750e51444ac92be,2539,FALSE,5065,2526,Radiant
6633913650b421ece3463cce546aa2cd,1973,FALSE,2405,432,
33f849ea9c20c98454f55f382a09d63a,1271,TRUE,1725,454,
3020054a775d7870cc2106a33f8544cb,1799,FALSE,2719,920,
546083b9db7650809648b506f849154e,1830,FALSE,1945,115,
7bc4331672a5cfda22aa05934dc07b2b,734,TRUE,1707,973,
c4d1808eb4c9f2ee275d09a589c23fb5,795,TRUE,1398,603,Radiant
f6777516f4d974dc13f3d4d790a176bb,1565,TRUE,1614,49,
cc505b1861422bc46392524e74f569bd,683,FALSE,2415,1732,Dire
d1234ca7c8754826a11f61718e3f5f9e,1854,TRUE,2396,542,Radiant
55ca63358ad838fa2e33100b85f58355,338,FALSE,2325,1987,Radiant
16f201df268c2c9dfc481598d4266cca,574,TRUE,2395,1821,Radiant
fdca73d282bbfb825c6bc7f76ef14f31,81,TRUE,3280,3199,Radiant
76d33f494a0f52cd6a732a399d729a69,1968,TRUE,2607,639,Radiant
812ca22e8d30e387fdd370c45440b700,146,FALSE,1179,1033,Radiant
108b44c44fb66762f6542addc2a928f2,808,TRUE,950,142,
e06efda3b63515b4efbeb0de174aeb7d,879,FALSE,2934,2055,Radiant
efb38b3799416fd0b5c6ad29cdea0e05,1563,TRUE,3119,1556,Dire
a2ea945ac85ee79c078e75298c617d38,1221,TRUE,2087,866,Radiant
d13b9992056e8823b6b21003bfe970ee,873,FALSE,2262,1389,Dire
1163d7936a92bf77a48e7c7b547db8be,626,FALSE,3376,2750,Radiant
4af1234230093ead4e8bd542ae7f4a51,1413,TRUE,1448,35,
7d10f39cfc947e437ea5f2eab517143f,1438,TRUE,2490,1052,Radiant
61a0feac1d10a30c488e4955788f7eb3,2088,FALSE,2633,545,Dire
e7734bd310917bc3e04dd75139121842,3240,FALSE,4299,1059,Radiant
f07519dc79ae4622867616494eaf5f4b,1679,TRUE,2903,1224,Dire
c0ef05de52012290ca23c749ffbd9644,1101,FALSE,2525,1424,Dire
17b7aa71efd9ac9594110776667d3780,1077,TRUE,2184,1107,Radiant
e472bed937b90cd29e533563df0e7c54,1965,TRUE,3654,1689,Dire
dfe980daa55031148ba36bd6e90eeefa,1429,TRUE,1476,47,
ba8c22fc6d7a3d74b2b7c8bcb105a4f6,1026,FALSE,1644,618,
b390b201b938654cc3338b2f7b5bb079,179,FALSE,2734,2555,Dire
c044753f1df3a6a5f2ad8e8adad628d9,25,TRUE,2715,2690,Radiant
74f3224d824d41043b8b6dfca6160811,1640,TRUE,2343,703,
7a28ba32ea691eeeb6098e4ad509c95d,732,TRUE,3937,3205,Radiant
4f633371fd9c29d6806b456428ccd21f,1204,FALSE,2538,1334,Dire
29df9f21178055a9dfa5e3b377348eef,2044,FALSE,2078,34,
5c005e5f5e28efdde9cdf3b29fa51533,12,FALSE,2655,2643,Dire
19657f4f7e15cc260c7b2f41dca74bd1,398,TRUE,2766,2368,
cbdaebe0c2013b1d5d172b205045e022,301,FALSE,2873,2572,Dire
edb07fa22db61c707e8f224aa36d4f13,2125,FALSE,3401,1276,Dire
2aae889f1507c1fa2f3e8804c2633946,845,TRUE,1709,864,Radiant
2d9a3302fd8f1a448dca8fb750fdeec2,1034,FALSE,2341,1307,Dire
cef57cd3a6906083a7d5d2817f8fac0b,281,TRUE,2543,2262,Radiant
9570a8ccb89303e3b3905c2dbc0d6e20,793,FALSE,930,137,
fb9186cd42ebf6f56d57aef6509ca73a,1190,TRUE,1371,181,
c37ae4fa79c18bf44e49c3cfbedaa375,771,TRUE,1986,1215,Radiant
c85d3c5388eceb47c4a8aba334e4c320,1517,FALSE,3488,1971,Dire
cc174ce92b24338f7bc8eda64cdd5be1,2807,TRUE,2948,141,
f3853d387c2b6a1f6313b9e03d161b44,1762,FALSE,2376,614,
5d12f1cc1d30f2e36c51061925b67e4a,174,TRUE,1567,1393,
7bd3c002aa8cbc64e4d600686151e332,296,TRUE,2798,2502,Dire
47796a7ffc9ee12442fc4c0ea43d6b4d,1164,TRUE,1533,369,
ece17b1f19518979feb2c5b960e2923f,661,TRUE,2075,1414,Radiant
a399f991dca441473e8cb6a61744084b,1626,TRUE,2554,928,Radiant
f985f6858a4fb18fcbb0d8093d00e65b,202,FALSE,1981,1779,
73a88c3de6e18d3529963e02c52554e9,2323,TRUE,2986,663,Dire
5020dd5d6d17b984cdfc45a84ce2e4f2,791,FALSE,2650,1859,Dire
920676701f8a9105dc3cccd129cbf20b,1299,TRUE,1858,559,
87cc1112a82450a2799383ab05226c08,38,FALSE,1762,1724,Dire
22b77bb801e4fb39e6c850535ecd8afa,358,TRUE,1702,1344,
d04592ae43814cd2fd8ec1bcacb33e1c,1881,FALSE,2352,471,Dire
0b2b4d9f1b2b57d7419d57f98292083c,1090,TRUE,2585,1495,Radiant
4a85b2c79db128566650ef97d13df3a4,1571,FALSE,2155,584,Dire
891213861b98a370058a417a2d560d72,884,FALSE,1020,136,
be787b91d54932a0a5b0bb31408aff78,440,TRUE,2118,1678,Radiant
b386bdb1f57a40bece40e0916e8ca2bf,284,TRUE,1552,1268,Radiant
40617cea3383483ddcb791f11001f323,605,TRUE,2218,1613,
f6f11c9aaf32aeb2cb43981e6755d07f,742,TRUE,1580,838,Radiant
dafc5ec6f6e872cc000eed3a678e148c,664,TRUE,1762,1098,Radiant
e5c35d88a5b1fc2743bd0d0e697ad597,1376,TRUE,1767,391,Radiant
4f7af9bd8c0e00d945c8664aa161deca,1208,TRUE,2288,1080,Dire
e4674e8c499ba1950eae7f35a74cfe7f,1777,TRUE,2082,305,
0c58168c2db4bc65f75727ed1d28697e,800,TRUE,1900,1100,Radiant
e36e6e88947655320e17763ac674d6d1,2248,FALSE,2513,265,
9190ddfaf79a9cbbaf67eba19329f9e0,1191,TRUE,1388,197,
d05c9b0052ff36e38e851036d4b63e17,795,TRUE,1193,398,
3439fb37fd5b3bad7eda11612586f667,1275,TRUE,1601,326,Radiant
2ecceca6569628f9c8fbcd486c80556d,479,TRUE,2455,1976,Radiant
3c45ce65f790815e1f59f8a3dc12a28f,851,TRUE,1980,1129,Radiant
83b3e8db201ea704312da7168dca2317,2214,FALSE,2449,235,Dire
8494b8df48a18f0eed1ab00f86c7b2f2,1420,TRUE,2579,1159,Radiant
fd27e760c90a0ae8bd74e55436c11256,241,TRUE,2030,1789,
97469b0943a0fec878bef2c1b357deab,530,TRUE,2155,1625,Radiant
3b9a07f53bb344a60b9d1275fd7ba8d2,362,TRUE,2772,2410,Radiant
9a4141df289e24afb332bb87486659fb,1714,FALSE,3240,1526,Dire
0b6b46d66d1fcae81452f94c480e63be,1466,FALSE,1875,409,
9779fccb28ad45834251d07fdd37d611,740,FALSE,2757,2017,Dire
e62b25a66f38b850b46361510080cccd,405,FALSE,929,524,Dire
87824a48594c5a2113c1addaad2ee0dc,301,TRUE,2391,2090,Radiant
08335b5a1d3c4ac81bef6a2dbb7d6095,505,FALSE,924,419,
617baf20d2b620ddda3a8ec586c364d7,2178,TRUE,2382,204,
554dfffb617f082183053c46765e897b,1904,TRUE,2327,423,Radiant
18071ffbf918181b787e82fafa8495ab,1140,FALSE,2789,1649,Dire
2e2834d8a4c6b1bc97814b9cbd056c3f,803,TRUE,988,185,
0eee5ffeffbe50a4af4da1f8aaca662d,100,FALSE,2241,2141,Dire
245c16ec79e44bb0b7d0ea0be9d45f0f,176,FALSE,1283,1107,
fa24f47a1eb2c76c6cea756b6eee7122,1569,TRUE,3114,1545,
d79fff5de354d7e71f9abff597883a68,1522,FALSE,2632,1110,Dire
0bae55218adf7e5173b58b5160db892a,859,TRUE,3050,2191,Dire
f4e3fb2cf8174ab6e3c84c3fb3bf3932,1030,FALSE,2047,1017,Dire
c215102d6837c4f36077a60431cf840f,1742,FALSE,2417,675,Dire
1e1cc497b676b525190b976e92b03d21,931,TRUE,1029,98,
88dbd34928a75de55ba1f53cca1525ba,755,FALSE,2029,1274,Dire
3365ec913dc7144881b76f2a73d92536,2163,FALSE,2439,276,
616bb6a188e77169a93241b12cb5087e,2890,TRUE,3305,415,Radiant
37e42db707798c807cf5d37a89681477,2081,TRUE,3101,1020,Radiant
431951a10423010109fd88f8dc46bbce,1269,FALSE,1557,288,
3cd1b8d36870613ebefa09c09aae656d,2423,FALSE,2646,223,
dbc17678c2b31b70abf994895109d5e5,1033,FALSE,2237,1204,Dire
efcbf0820a87a0740689bb45ef3f748e,113,TRUE,2193,2080,Radiant
c2e5ba5879fe01cd8f86f1a783e6dcb4,1827,FALSE,2882,1055,Dire
828db4be9c66c07dc3dd330a668f3a67,325,TRUE,1430,1105,Radiant
0eea565011984863639d08f7742c5f65,673,TRUE,1553,880,
e1a2e6b19560c7d7815bd1161f9b107b,821,FALSE,2148,1327,
ee57172d283ae9092906dd5191af1cd8,154,FALSE,2870,2716,Dire
3715aea9c19de88b6204a266a8b9f6f6,2000,FALSE,2687,687,Radiant
991931e7aafa6f88a88e26ee8859574b,284,TRUE,1696,1412,Radiant
18fd550df6184ab76dfefae7f744a63e,2269,FALSE,2545,276,Dire
5e25103ad2dd910dc1167ba490e40cb8,671,FALSE,2491,1820,
50878e5e67357c67e669f600322354fa,324,TRUE,1248,924,Radiant
61b46ff750886417aa58780271dcbb0e,1924,TRUE,2321,397,Radiant
511b0de9f8007b780a0be1fb1467bba3,442,TRUE,2075,1633,
9d5371188e39b4e47944663fa296850a,87,FALSE,2726,2639,
f6e73af4e3cc84d294fab5d21871884c,345,TRUE,2274,1929,Dire
1d2992a8586d607fc6cc0ba71b9a91da,222,FALSE,1745,1523,
4f441af9b1525c04c95b0c95f965f706,699,FALSE,2422,1723,Dire
2f005b286b81fe61f94e597c57bdd31d,2184,TRUE,2513,329,
a66def3316746a8909af670674ef09dc,1674,TRUE,1725,51,
ddc2a0b6dee1aca196b3161671d051e6,316,FALSE,2607,2291,Dire
be16591003348ef77da5a123c0941cc8,195,TRUE,1954,1759,Radiant
033467b1aa769e892a51429f519e8ab8,724,TRUE,3716,2992,Radiant
f1fe362daed8625b4783e8f2992d71c6,1880,TRUE,1922,42,
2b5122a8249cfc526c3d8c551174a766,450,FALSE,2655,2205,Dire
886c74605f7e1e1a64985e38727de618,772,TRUE,2667,1895,Radiant
0f8deda02a10a50adff29ab361f152b3,1316,TRUE,1853,537,Radiant
c5dea64d3a633b0a8cf54b938aae5e9e,483,TRUE,3206,2723,Dire
2b186a6cd145e222f4005edcc9fde7cf,626,TRUE,3349,2723,Radiant
3bd958ce70010b40fd63677515214fad,384,TRUE,1164,780,Dire
beb690da0a3f03cf94dbb0a0b5f54381,560,TRUE,1111,551,Radiant
94c42639a3fa3c791c722746c0b4723b,21,TRUE,2042,2021,Radiant
6e82e4745b4cb6e4c2afcf8fd4a35bab,3261,TRUE,3390,129,
3e5c952347cb2f2dfbb088a2f8274ddb,981,TRUE,2522,1541,Radiant
f26344102537f23a4dada630e8423bc7,644,TRUE,3871,3227,Dire
edc8f023068498c69891c6fdc0b4c090,2230,TRUE,2437,207,Radiant
63b3a14ff092010d10ab05e55fff9aab,1187,FALSE,3200,2013,Dire
6e30dd2721627f949f37c62f9dcf11bb,161,TRUE,1932,1771,
06136c51aa8933731b5a7b42db8fd1ab,2086,TRUE,3195,1109,Dire
074843268f5e5a5556166a1f508e5dd2,1257,TRUE,2875,1618,Radiant
60264030081a2e42a68be911897511d9,1077,TRUE,2118,1041,
953355ec0456fe217d44741f3cac7902,2484,TRUE,3130,646,
502ed1b25683c02a12430ff7303cc0d5,1585,FALSE,1905,320,Dire
875b15b5f49f1a85307835c96346fa71,999,TRUE,2368,1369,Radiant
41da0f8e9274a7777aaa735632742a95,1611,FALSE,4045,2434,Dire
6508ee523a8cc2495d502482dc3308b9,1012,TRUE,2756,1744,Radiant
7234c86f63bacf7ff73692ff7d874f04,518,FALSE,2094,1576,Dire
5e1de18ec3769cef3b9e5d7a1d15b7ce,593,TRUE,1802,1209,Radiant
2cb7f02d9ee1ee2c05d75cf7ab0a5239,811,FALSE,3197,2386,Dire
121821126f91af079420e1137e006881,868,TRUE,1614,746,
eed2040aac63d45ece9a2c3aa6184b29,613,TRUE,1138,525,
c6d5a8e7b92d71ff77ef739b761ced99,1936,FALSE,2504,568,
1a30dabe05967690fb632a305d56d7ff,198,FALSE,1251,1053,
8f402f12a6813c3dfa6c4bda8415d5f9,906,TRUE,1881,975,
13f723c1ab3c55eaed6242ae5e571a4b,1521,TRUE,1837,316,
aec98eeaa3e81e027e50f0fbfb2cef41,1510,TRUE,1971,461,Radiant
53956a0f76d0a9380d3daaf08dbe59e5,900,FALSE,2103,1203,Dire
fa0c3d327af2ea86aa17e0710d7f2955,50,FALSE,2560,2510,Radiant
5a1607eab7d1e92a60d8314fd6501fe6,149,TRUE,1948,1799,
252a1f8ad8ebea770df9ef5388e7531d,1619,TRUE,2180,561,Radiant
c5ed554182eacdf8bd387922b1b956ff,921,FALSE,1274,353,
c4882e6064fbc6fda7f5109c7893c5d8,328,TRUE,1576,1248,
732b37803b646b5c5c74a87129b3e009,716,TRUE,1777,1061,Radiant
b3d34f059b62fd603406c7910f3f6187,710,FALSE,1749,1039,
100937ed2ccdb6929f987ddfea720d2c,1689,FALSE,1887,198,
29a4ba2d2026c83e300d0ce6b0bb47e7,333,FALSE,2141,1808,Dire
48eb89227ee480a17fa257f6ddf19a5f,1750,TRUE,2582,832,Radiant
7f34ce0ff63600c7d9faaacddfef4393,1430,TRUE,2557,1127,Radiant
eb36edc2a6d67850847aeaf034ef366d,2330,TRUE,2493,163,
a49fbe4080cacd98f86eaa9ae84017a5,1217,FALSE,1914,697,
69b5a9a885dad2ba9c5ff8a3cde600d1,1122,TRUE,1984,862,Radiant
119f393ec41f7313a8e4aee32b0a2510,924,TRUE,1316,392,
69d3d068c27efb27293f1e34ceaac217,343,TRUE,1939,1596,Radiant
cc0a979d12d986d00af3954cc11dde2e,1637,TRUE,2574,937,Dire
5401f5af5cb78a3f265c6f2f63d60eff,211,FALSE,1976,1765,
b9068a00e706bc75eb95be0c5f8d564e,1083,FALSE,1614,531,
9cc031fd80a6069ac70500c610d56d60,1238,FALSE,2891,1653,Radiant
1879465d3eee2086b5a6253691835638,2467,TRUE,2973,506,
9421673be4d527334062c27018015f46,1035,TRUE,1669,634,Radiant
d5980299620adbc678a2eff3d7377954,1717,FALSE,2687,970,Dire
0b2f005f47962f27b77d141f17b3ccd2,1355,TRUE,2365,1010,Radiant
af8e4e890b5c5cc17a8aed1b40c2b3d0,1390,FALSE,2315,925,Dire
04826587f247da241546922148e7e63e,699,FALSE,1937,1238,Dire
7e180f7accbb2b90aeb63a4a2604c791,2429,TRUE,2475,46,Radiant
28fa6715c62e07f33b5c27bcb11a45b4,1628,TRUE,2039,411,Radiant
8af45257b737c026fbb32eb80ce668ec,417,FALSE,2129,1712,Dire
64f32f71536b01d36aa638d25191e05b,912,FALSE,1853,941,Dire
2347e64ac109613856e7de88c3e29713,1129,FALSE,2139,1010,Radiant
3bb56412a2978d28035b0f83db2dd558,2040,TRUE,2772,732,Radiant
53f9d31cf3d6c625d3fec39443b6109f,1390,FALSE,2421,1031,Dire
8ff645ebe17e1ad23483180da523a745,1404,FALSE,1840,436,
e9a2ab7b3612c457fa3ffe30300b3d1e,1421,FALSE,3473,2052,Radiant
ab7bee07b4e8ae5da130fc78091c0f11,268,FALSE,1860,1592,Dire
b2c8c33199caead72cbf545ede2157d4,2517,FALSE,2791,274,
89cdb3d8841e31c5f56823ef29909cbe,1115,TRUE,1904,789,Dire
ea837ff7c767ba35835e731f665871b3,455,TRUE,1180,725,
41a3a907610dfda2364797fa1b5d914b,487,FALSE,2485,1998,Radiant
cb4e0433db7b379234b781ef7ca429f0,722,FALSE,1356,634,Dire
cd15f67e50362e1f54deb9982deef2e9,3303,TRUE,4429,1126,Dire
006f98750a054cb450f6a8a447f194b4,513,FALSE,1877,1364,Dire
5aa12b97f94370731daf9dd4de4946b3,1885,FALSE,3044,1159,Dire
7c2d3361c6f343ef0f92edc49a2df303,1136,FALSE,2088,952,
d2d889b619508bd8a75f7116f25e6eeb,1143,FALSE,1929,786,
10dd90f293fa515f31dd1fd73e72bb44,283,FALSE,933,650,
2cb321565663204804e9dd966693ee70,394,FALSE,1565,1171,
31f0173bc58a2a18c606846e981a29c4,1398,FALSE,2092,694,
c2a05acd77542bc59c43ebe50b71e5e0,314,FALSE,1909,1595,Dire
9ff348e43897a12f25997dff1c9048ae,1082,TRUE,1132,50,
30cc32f067fbc02a4cd1aaac4983f802,1671,FALSE,2943,1272,
224906b2a46ac3c3252cdeb76748a722,850,FALSE,1028,178,
19c6addb69a7670670ab97910fee258a,1798,FALSE,1889,91,
6b3de6731277bba4c4e5d828223057fc,1330,TRUE,1479,149,
a4fc515c178126f88c949382fdff4363,1210,TRUE,2360,1150,Radiant
1a40df8687f94d481efeac9db25f60c9,306,FALSE,2239,1933,Dire
b05d0f25987beb1b77674f21bc75457e,1787,FALSE,2160,373,
9f128ba557d7369cdc5476f98385ce17,201,FALSE,1993,1792,Dire
0c1521eae41a23b67d34eaef043f6b34,1551,TRUE,2389,838,Radiant
29dd38d784862ab41d6ecf52e5974357,1581,FALSE,2444,863,Radiant
a5af7876b7481d9826d207c92f65e61f,632,TRUE,1888,1256,Radiant
1646837041a1e6e2b6806e6e748cf0be,1087,FALSE,1856,769,Dire
a43bd3de386cd01d63764002228260c2,1471,TRUE,2018,547,
86822a84319b073a87739be6f817face,2,TRUE,2324,2322,
91f506d1a685fe36fe8949b3ea817ea4,1286,TRUE,1361,75,
2a5a92554effee3fceb46d1cd77e1622,1654,FALSE,2849,1195,Dire
495656dd1fc032fd37ea6cc8c2531f95,516,FALSE,2801,2285,Dire
f12bc1b9ebaaf3ac1bfea85f054cb490,1291,FALSE,2124,833,Radiant
062f64b8f27a4937d504be8b4f67030b,1562,FALSE,4293,2731,Dire
8b4cfa2eaecd18681db341e61b1674fb,2145,FALSE,2583,438,Dire
636ced5f5e50020a480d57d2553b23eb,1786,FALSE,1875,89,
ceeca58db90a455334d8fec2868fc605,657,TRUE,2377,1720,Dire
8ee0e73a44c8a197aa5983a03eff68ef,2271,FALSE,2716,445,Dire
52781a2b5b4efab10166703e2c272763,1457,TRUE,1664,207,
5f4e1bc908c08c1f533874948a12ec1b,1722,TRUE,3126,1404,Radiant
1f94019966a709940b65c8798f9e3c77,1227,FALSE,1465,238,
1b4a32c4a9c63be1a321715db8fa3051,108,TRUE,1789,1681,
9b0327f03f75c90286d6c6f16e02c2e3,1436,TRUE,1761,325,
db2855cc208926555704621a92ec9457,1425,TRUE,2663,1238,Radiant
6fb789d12d96a743be465228b3b32485,1830,TRUE,1937,107,
779439294d1df2fa99f7f6d251fcf151,446,FALSE,1598,1152,
6a78cb0fb7cd48f09be2f485c1f3fd95,407,FALSE,1898,1491,
fd2ac8abba49d86497ef5696f1bb727e,240,FALSE,1949,1709,
68203bd7bdf0f974c47aa1a5ca858c90,2542,TRUE,2676,134,Radiant
b98bdbf4cc3a6c74b37be154b4108eb9,1425,FALSE,2059,634,
3751319e77e70b213c52b15d29ecab1e,1969,TRUE,2324,355,
25e892fdcf7afc979ef3604557b4f796,1716,FALSE,1898,182,Dire
ce71374dc31f883316b1e77d45b696eb,1866,TRUE,2008,142,Radiant
5047ed1ae6742ee8c8afac900ae2c5ee,1596,TRUE,3313,1717,Dire
32bc09cc673dcf56d70e8836ad782758,420,FALSE,2269,1849,Dire
6f6b641a848cfe52269cd1b3f6c4fa4b,1506,TRUE,2528,1022,Dire
db009f5bfabdb34d634b24a67c25ef5a,37,FALSE,2274,2237,Dire
998dedb5c1c688a495d02823d7fe4e20,1460,TRUE,2810,1350,Radiant
ade638caa94ba6224f0dd46fd64ad6db,819,TRUE,2525,1706,Radiant
462c3245301bf0178ddbd7c7bb152314,1518,TRUE,2799,1281,Dire
b05c4513aa5bbdec46de8fed558195b8,487,TRUE,2834,2347,Radiant
19542cb082e8f461c83edbca45e2c43e,1611,FALSE,1737,126,
296ca2e380fa98231f1cc962c8d027bf,1180,TRUE,2208,1028,Radiant
c34e093503ff25eab612759f681d37a1,1503,TRUE,1895,392,Radiant
96f9adfb1ad65e147754fdbffa8105ed,701,TRUE,1451,750,
ab2309f4b4c7beb226b41f3f27348f4b,1466,TRUE,1926,460,Radiant
f8da05ce3132ba3f5a64587822ba4332,2067,FALSE,2149,82,
d6c8f4c6ab635da30c160d94fdac5b1a,1722,TRUE,2269,547,Dire
54ee17c0e65cf8b988df63aab6de0332,2109,FALSE,3506,1397,
c6bf4b300932ac5df16847743848af04,895,TRUE,2738,1843,Radiant
ac01799a94006164b421ed32cfbcf9ab,935,FALSE,3677,2742,Radiant
bfee3f7e57dafa60bb83611c13b79821,101,TRUE,2711,2610,Radiant
231b29ce86c7a549068ced0ec8138358,2055,FALSE,2227,172,
7e243564c9048c0702731932e251d1f5,127,TRUE,2192,2065,Radiant
50325bce0b27efcf7e720e0672d006ef,1508,TRUE,2788,1280,Radiant
88944b3e051a73df48d53236a5aa377e,2222,FALSE,2987,765,Dire
e67c85f84effad97487adba6d3b7a8cd,1968,FALSE,2293,325,
b99dcd2f716faf5e32ee66baae9485eb,71,TRUE,2548,2477,
395c2262031fd94fdcb0ac2640c761a7,1996,FALSE,2427,431,
9a68ba58d8512b2ae4407f569e400d17,2977,TRUE,3161,184,
460585b817808ef6745548568be4bf58,1103,TRUE,1993,890,Radiant
6f2bee0880b99330d0578d5398e81ee8,1469,TRUE,1677,208,
00a984f5e1c21e38cd81ca65fdde359e,681,TRUE,2250,1569,Radiant
d2a445f2053df416305a69e6c5e99bd6,165,TRUE,2289,2124,
8b0c130e9df636b9065d868444c892fd,22,TRUE,1619,1597,
17330d0b00bba4523d9e6cf9ece92d16,19,TRUE,2315,2296,Radiant
6ab2cf7d6069ea0f3e4bfd017da9f511,1295,FALSE,2103,808,
a8eac348b8faa0ec4840e247c6701af3,2095,FALSE,2176,81,
013303775d24c2855516936380764c5c,1596,FALSE,2555,959,
d80dcd60d54b6755ce033d125c411ff4,392,TRUE,2120,1728,Radiant
fb75a73b1b4825a701e46f98b01d8f04,2054,TRUE,2578,524,Radiant
c8f41054a3e241121033160551d02096,2989,TRUE,3502,513,
fae90322827d300c38db2027bed54b82,1254,FALSE,2837,1583,Dire
ebb903b3daa70096a8198fe28600bbf9,932,FALSE,2874,1942,Radiant
4d0880738893695e3cdc5ac6a8561ad4,1027,FALSE,2232,1205,Dire
d8e1d5ab436fa208f73aa44ea7ff926f,2051,FALSE,2369,318,Dire
b74fae5fc661aa6c3ef7a12a44aab6eb,858,FALSE,917,59,
dc639a147e0839cde02cffc393684f57,1349,TRUE,2814,1465,Radiant
a25bbcf53b1616524d4bab1932dbdae3,1200,TRUE,1705,505,
901111e496de65be1cd9694b6ecd42f6,2339,TRUE,2635,296,
78114c9a3efdb9d8b5a9e79c47a542b8,317,FALSE,1361,1044,
dab007a4aa28fd3495bcfe530a44b8a7,2881,FALSE,3229,348,Dire
95876fe86a71c8f600a130d565ef2a32,2478,TRUE,2527,49,
26647554d12661f15b8885f416976bf9,1573,FALSE,1815,242,
fb8a8c7188238a00e5db2e6aaa8baf08,871,TRUE,1372,501,Radiant
c94829872d0ea9bc40e316d6fc8788b9,452,TRUE,1730,1278,
fa675789485ead2b0e4c5fb1212ada98,662,FALSE,1708,1046,
397dc571529a4cc2ec59d30819a06382,1108,TRUE,1634,526,Radiant
89ebae16fd6b7a7af96b991df464f2a4,1586,TRUE,1937,351,
19d26913d660109b99c74f101c56eb25,571,FALSE,1833,1262,Dire
02a0ce07f39bb334af8171d7dd09c313,868,TRUE,2131,1263,Radiant
eff256eb08b5e3b8ec31fad3ce255f12,714,FALSE,1446,732,
888867ea003adf22c5732ee988ba5bc4,2023,TRUE,2211,188,
f4f08b9b4bffa8065ed05febdff6e1fe,1745,TRUE,2633,888,Radiant
39e1b25d13ca6a677e45cc424906b6f6,1814,FALSE,2547,733,Dire
5654fde1bf137ad7d5da53f63f2d4938,752,TRUE,2676,1924,Dire
a27b2282ad529d9cead2050386f0b3b0,1716,TRUE,2309,593,Radiant
1901a0bbe2f28d8f3c8bfe98ba780065,1156,TRUE,2039,883,Radiant
e6dfcfe5586a6fcc4812bea3c4d18c5a,2634,FALSE,3052,418,Dire
0e38ac2ab0ca40d10c2fe35bc4478d6a,2772,TRUE,2906,134,Radiant
c8e42b280682d126b3e3216a1acec573,1240,TRUE,3055,1815,Radiant
1e3536d11bf2a0c3df2585db5c30e070,665,TRUE,1598,933,Radiant
7ecc35b74af535169d1fb2fe5bf270b1,2234,FALSE,3930,1696,Dire
bd849833c48cc75f2e631f85622ee9d6,688,FALSE,2780,2092,Radiant
d103ecbb505f5f885ffe39f80e319996,377,TRUE,1722,1345,
142b1b6d2222ce71410091a7cd644b13,1168,TRUE,1710,542,Radiant
cbd33869f4fe5e730edde5cf59cd71b0,84,TRUE,1443,1359,Radiant
865ec9f1d0c631aa0228be4121881c7c,257,TRUE,1592,1335,Radiant
8d0d85ee6402df1ff7ec786b70125b8a,885,TRUE,1046,161,
0c9fea5d95415a8eaf46922cf9463848,925,TRUE,2782,1857,Radiant
f38bc6223e7d6d87f4825f18f6e2c973,940,FALSE,2182,1242,Dire
99c493b68df3c726df7254681ba4c1df,1482,TRUE,1651,169,
f6cd7fe2964e580995dbba195f1ff031,1464,TRUE,1993,529,Dire
c0a134151aad799bc20c67dbb7283ecb,202,TRUE,1705,1503,Radiant
5568b1f4ef4cc7b020403ffb8271cf88,1636,FALSE,2775,1139,Dire
63cd5b50002da0ac34bb2e8da2a00606,34,TRUE,1601,1567,Radiant
82e72d19eedc428e8bcbc05bdf30ad63,1529,TRUE,1944,415,
15f932173ef008088cf8162205682523,1371,FALSE,2041,670,
89633b2763d602f07399b95a241f1914,803,TRUE,1959,1156,
25588b5f14e1a78aa5e33fd37499cd21,1479,TRUE,1799,320,Radiant
b0af254b0192448d6fe5ee0b88dd12df,1522,TRUE,2159,637,Radiant
c9a7d0c9829d8ad457cb29e490c7be3b,795,TRUE,3178,2383,Radiant
1b8b5d314bbd3738f04508048ce14e62,1571,TRUE,2675,1104,Dire
510de40c8707e664c18c938bcc54b76a,2355,TRUE,2871,516,Radiant
32528d68d62178c150f307e264553206,893,TRUE,1879,986,Radiant
c0019805cd5ff592b6f94eddf41dea91,1048,TRUE,2191,1143,Radiant
a1d24ba4a7139fead363fd67c6cfb5cb,564,FALSE,1015,451,
519825d434bc45b9fb1c1d5b6b0828cb,1704,TRUE,2963,1259,Dire
413dfdd6e1b224113651365a41ed93de,276,TRUE,1115,839,
89f51612c7179a8ea7e9977147200f2f,1925,FALSE,2827,902,Dire
210dbcad5edfe568d7592d000d3e7c3c,1420,FALSE,2626,1206,Dire
f28705398a476be72b502886ebfb2ae6,1163,FALSE,1204,41,
ee3c416f4bf786501cc8f2b58c3bbc0d,1155,TRUE,1276,121,
74d3db4fb75f02026fb817a6d0929aba,45,TRUE,2464,2419,Radiant
48ebcc5c737ff075c1ded66d0c2c0c7b,683,TRUE,2808,2125,Radiant
b7680181223219e35454b54836e728d7,411,TRUE,2397,1986,
019132349aff563f316ddd8c72acce0a,1266,FALSE,3277,2011,Radiant
cfba16baa8979a4f80c7e1ee2ac75258,2274,TRUE,2587,313,
dc00f90a0df100747e7318c852858968,2031,FALSE,2679,648,Dire
c161322bb243272aa89126628e0aae8d,1659,FALSE,1981,322,
d9a801d2b4a393006633b2ada9266e96,84,FALSE,2389,2305,Dire
ea281fb77f82dc8a4e34a69ca56b5de4,293,TRUE,3553,3260,Dire
7e5deff5359252e153003cb1bccc3a11,351,TRUE,2060,1709,
0df2924cabf826fab3b01cc835401491,843,FALSE,2257,1414,Dire
499d546673b68b6a9ac44223701dac29,2238,FALSE,2887,649,Radiant
9a7af9890a4b1c4a48e4ae01006ba40b,3067,FALSE,3271,204,
bf1253a2cf93aa9c99ab6bcde807ecc1,1449,TRUE,3214,1765,Dire
89ad4abd16fce63aca3d0bd07ba0f3c7,667,FALSE,1917,1250,Dire
f10e0e3683a10ad44e05a25f110c4bae,2296,FALSE,2741,445,Dire
2043222299b70236c08f8a5034d7dacb,1571,TRUE,1927,356,Radiant
d8427a4b8210bcd16de69bf14ee81f5f,338,FALSE,1822,1484,Radiant
bb56844d5f8fa55ac2bb34b0ada4bf17,1262,FALSE,1366,104,
648f35863b1e7c173066ed4f111e5308,329,TRUE,2056,1727,Radiant
50a642e53c4854244c1b9c996140d338,1574,TRUE,1673,99,
c8288b1995b5753b7bae19beb4c01c36,655,TRUE,991,336,
1fa44b9eb4bc2469395ef703788977b1,2961,FALSE,3460,499,Dire
f9b4db6fdf16f6962f2c3c54d5bb8fe7,1843,TRUE,2574,731,Radiant
ee7b180070c4f41278251a05ecf5ec2f,901,TRUE,1629,728,
556d4c280a0b76c8700fb1a01c6bab11,827,FALSE,1099,272,
7472908b83b8fb7abcc33ff509d61096,226,TRUE,2675,2449,Dire
51499173d7a8ff6a2b694af8f84c9d0d,1083,TRUE,1184,101,Radiant
0293e5d9bab15eeb4b5bd524a4f9f352,2665,FALSE,3705,1040,Dire
f3aa513fcab1a7db8ec70ee8c234fb63,1583,FALSE,3566,1983,Dire
cf6909d50c8ceaa65e3eff27b9f7fbe5,627,FALSE,1482,855,
175988a101ec33668024f083eebdd869,2989,TRUE,3100,111,
1bd4e0387fd9484a1ce3f767b63afae2,1842,TRUE,2225,383,
2709c3d68d3072abe3dccd44b1bd7c0b,1375,FALSE,2045,670,Dire
83aa3b5bd22850797856b980c8770ad6,961,TRUE,1136,175,
2bb6bc4745ad0fa7bbb09b13af68b047,544,TRUE,1564,1020,Radiant
777c5286a1c01810b66a6e0152b84111,1764,FALSE,3007,1243,Dire
ad002f4f202af42a94fcf13c9f59e201,922,TRUE,1022,100,
d32145ebfcdc0ebc1d7dada4135f6424,345,TRUE,2472,2127,Radiant
3dd6fe2e3dc9711a5768eff76e115b81,1840,TRUE,2400,560,Radiant
f96dd7d25cab97aba655e355789f5d4f,951,TRUE,1257,306,Radiant
6416a0d23d9edd9720f0fd4884fcd5ba,972,FALSE,2502,1530,Radiant
9c49d6b8f04fcafb267d655221b17084,1578,FALSE,2772,1194,Dire
4e5f9e1fd4a1655aaa15d9201da4b4ba,2643,FALSE,2765,122,
ec361ddb2e3910cfbf06f72f7e53e34a,179,FALSE,1756,1577,Dire
887f9ff1a5aa5cb38fb4db8a10df6f17,116,TRUE,1171,1055,Radiant
ea949986a3617d04c30b2ca0ba3ccd60,880,FALSE,2515,1635,Radiant
13e8f95c300c84901a49222785c977ef,923,FALSE,2225,1302,Dire
0e2cf7a4687c3db478ec043e12955e2a,592,FALSE,1824,1232,Dire
b15e6b4676c14ee6b9821c5fba5191f7,1630,FALSE,2620,990,Dire
037d4b18c3e9a3b5179f5aea5b2934da,1021,TRUE,2912,1891,Dire
2ee218f07b45d137a6b12fdab7938704,438,FALSE,1617,1179,Dire
25b60e0ca446eefa359a10fb77749ab7,702,FALSE,1915,1213,
8a416b1124ca369f472bae572ef08766,486,FALSE,2559,2073,Radiant
209af9b702850ebe326f15f5f08dfd4b,696,FALSE,1942,1246,
c17c6436b1c916031adc7645506b7a36,343,FALSE,2230,1887,Dire
40b05f3342c2ff681c4b8ae9d4bb0aa4,1315,FALSE,1523,208,
bcd391e415d0fae4683fedfb9a701a33,2253,TRUE,2350,97,
91273c8ab13bfc83279c0fe492b12305,831,TRUE,2046,1215,Radiant
6f56c6f5d59191ee3d9103bfd3ca7ef3,1335,TRUE,3075,1740,Radiant
2fc580b273e8b3a08c6959f724bd2540,1229,TRUE,1755,526,
44efe2f9a478cd2580a663e1a521812d,3244,FALSE,4580,1336,Radiant
d81e0c06e16e3112f60ed191217ce65f,1230,FALSE,3497,2267,Radiant
5c5458e0b6fb6ddde8bd713a01ffe893,698,TRUE,2855,2157,Radiant
b5ee3cecbe9f6d475ea64b174da8f842,669,FALSE,3428,2759,Dire
108a41d660f13acf02c5f5c51dc16a19,1191,TRUE,2048,857,
27804c194e18b808762de48d9628412a,913,FALSE,2612,1699,Dire
cdd1bf0d73bd2506f2f3604d345b11fb,1902,TRUE,1944,42,
3d085dbb32fd63015a0aa3e88d355b28,1420,TRUE,1761,341,
344c1bf9c56922659d4eb04c8ffa47f8,2586,TRUE,2657,71,
3aab40da9fe1a2bfe6202628bc4fd7f6,2000,TRUE,2319,319,
cffde7400c9826d06dbcd29cc4224ece,1737,TRUE,3428,1691,Radiant
32156cf566b61987a0704e14f49c1bd0,671,TRUE,1180,509,
df21473a386ffefab990b1fdf4179ab7,1229,FALSE,1582,353,
8778ef8e88a20e80f2c2065b650fc642,770,FALSE,3690,2920,Radiant
8e377be613f6ccead7cac1b9ad239034,1676,TRUE,2613,937,Radiant
d12c8058194dd313caae1d0e1af37dbc,322,TRUE,2256,1934,Radiant
0401ddab36a45a7f698e05f091dadf30,2539,TRUE,2571,32,
5d66ad773e8a5d974de5bd0647452836,446,FALSE,1055,609,
c00590696bf925b5a28a1028529752b4,563,TRUE,1379,816,
93232094ab0b8d6b065bd4b9e5de0dab,871,TRUE,2306,1435,Radiant
898e605c9fe05e5aaca3120737a18701,536,TRUE,2059,1523,Radiant
9b31b70c17ad3722b1fdea8c0d872722,1949,FALSE,2667,718,Dire
9194c2e1ea71b304ed46dfa1e8283e4a,2460,TRUE,3421,961,Dire
ee12cfaa8d1cb391ec84e3656ea04925,1820,FALSE,1938,118,
d87e58dd49cb8dc372dc771e16280e57,1402,FALSE,2569,1167,Dire
614a78c549b86b8d4f6f9a1732719b6a,169,TRUE,2407,2238,
259bb0c07af0765c8b3a1e09cce9123d,2304,TRUE,2490,186,
eee834d5bc225cba3ea9ddbac747a352,627,FALSE,2315,1688,
633ef81ec5f7b5a4326dfd8a6eaa21f9,635,TRUE,2199,1564,Radiant
1ae1c0359ad0dfcdd9c8eaa4d6e1e484,640,TRUE,2687,2047,Dire
a88557b8a21410d23e4267045d4e3d70,1314,FALSE,1945,631,
03863d0b2c9312413db8ddce0d6cb479,1969,TRUE,2293,324,
c041ea194c32d177e1fba6ad2a517ae1,1062,TRUE,1933,871,Radiant
c8cc10d99976aa36a36ebdb0b86c49cb,303,FALSE,1632,1329,Dire
9f0d56efcd885706f4554116c2db53c3,1234,TRUE,2569,1335,Radiant
fac02004a55bb7a0753cb6a53a983f5a,1396,TRUE,2352,956,Radiant
9153076113a55701e42cc0bbab0ae6a2,1311,TRUE,3052,1741,Dire
02fb48dda461c05250dd2a5d27585526,403,FALSE,1341,938,
4882ee03c955c8ace206ff2692b3d2bf,392,FALSE,1802,1410,Dire
c52b63ee76aa2b088937860e31bbf4ed,1903,TRUE,2202,299,
c3ac0a8b0d2d0967425d8a245d953b73,221,TRUE,2456,2235,Dire
2841cda1d5e1f1651636880d1d7e25e2,1558,TRUE,2763,1205,Radiant
e86592c48b337594151537908e819cbf,274,TRUE,2237,1963,Radiant
58e1c42b7f855c07a59d36fff5e8b39b,285,FALSE,2863,2578,Radiant
e17584f331b8a82ac10979779d5a8836,1428,FALSE,1782,354,Dire
eb32812a7d01af034460d8234386bf9f,208,FALSE,2190,1982,Dire
1a78c253e1f52d6fb4b5730171dafdc5,1847,FALSE,1975,128,
8ebd3511a02a8a0189e50b891e9a8dde,458,TRUE,1399,941,
b6a4201eb591007e4cd279de2bdbef3d,1020,FALSE,1920,900,Dire
2899cb5231f8a2f57779d14f0c9a2b34,980,FALSE,2697,1717,Radiant
1d0aacf778131ae22605819af286d99a,188,TRUE,901,713,
81618d5ad8f6973a32674a1cddc1db62,1059,FALSE,2176,1117,
882d6dd16ed504c5c878a662bd19dbd8,2053,TRUE,2285,232,
97c993bbb6b8ef77b01219d778086438,2401,FALSE,2569,168,
6c3c1c849d1d9c3f4e5fad4fb77d26cc,586,TRUE,1621,1035,
6659d84f0ad5ab1421aabd9d16d193e2,645,TRUE,1911,1266,
dfcc9b02516d3eab58993ed4cda9b0fe,546,FALSE,1070,524,Dire
6a67b5d81ae7bcfba0ef9400543fbd63,1625,TRUE,2549,924,
58a433be8b303b335e45393b0f0022d2,1455,FALSE,3102,1647,Dire
132841e552aa41142577591a8fccedc0,636,TRUE,2409,1773,Dire
d9e5eb8aa0fca579c128e96522ef01e4,631,TRUE,2447,1816,Radiant
0fad15c715b1d679fb55eb6bf52db64d,2427,FALSE,2694,267,
093e7ee3cd9a0e4fd1c8ee755be9ebe7,661,TRUE,1562,901,
5d08494e50e12a796cc7e781567051f2,844,TRUE,1638,794,Dire
6db88546fa59f443502c39dfbcc0dbf6,1893,FALSE,3017,1124,
0c35cf9f60c916b045fa2d1587bccefb,1825,FALSE,3122,1297,Radiant
75537cad063d8fc4df2a82885dcfa678,354,FALSE,1469,1115,Dire
28e158cdeccda7883fff23699ebb2d12,2012,FALSE,2315,303,
d0f729c576bdb8530e223287dbcd083a,1106,TRUE,3817,2711,Radiant
11ea28d0d20819f31f44cb2979c7e0f6,1104,TRUE,2710,1606,Radiant
7bd8db81a8a7217e3f5fd3bedb9325e8,853,TRUE,1888,1035,
23f3c945f9f7d11404f86e32df030e93,1462,FALSE,2545,1083,
76c7e18f3f459d857940673333577ad5,192,FALSE,2466,2274,Radiant
4546a962113c31e2b2930fb8bab59793,533,FALSE,2280,1747,Dire
9c511f5ed0424ca103cce2922cd93ee6,1896,TRUE,2041,145,
96513e957cffc2bbffb6f8992a84f2c2,2109,TRUE,2311,202,
c9a883931420eae239042173b8dd7f87,1944,FALSE,2797,853,Dire
a29b6a7663fe8b4f2ceae19da32c798b,1983,FALSE,2661,678,Dire
931343eb5a48df7550562dff52b33149,940,TRUE,2679,1739,Radiant
592e6170f56d1c10c00643dbaf43381d,189,TRUE,2632,2443,Radiant
6a4e670e0d0e15fd25651123eb8eec0b,476,TRUE,2370,1894,
60023cd6b9234c64059854cc104d265f,1224,FALSE,1551,327,
299c4d3395db4b2d2f2c5dfafcc437e8,723,TRUE,993,270,
c26a64e2774032879fc2e97443a52601,397,TRUE,1770,1373,Radiant
adf7445f674a878c56578e05dec72e21,37,TRUE,1856,1819,
b88ee23d68163b493d6e6bbd24f5d010,2400,FALSE,2557,157,
2233b6462d9eb588eb2270b851a8bd5e,468,TRUE,1268,800,
80e016664509e4364d576a0b824faca0,1540,TRUE,3333,1793,Radiant
ba005f08d253cb97d77fbf7a4442f511,942,TRUE,2626,1684,Radiant
e74dc04fb16f4c94130c77bd9174a600,332,FALSE,2059,1727,Dire
dd665acf15eda5ff342dfeddf73246eb,970,TRUE,2501,1531,Radiant
ac87cc6e138a3f568c2be9ac39018311,897,TRUE,2492,1595,Radiant
ef962363a86fe2404e20a6136700f0a6,2147,FALSE,2789,642,Dire
da273a86dc68c7c359cc8243e7f813ec,1959,TRUE,2524,565,
e0e256fb52e278ee2729d8ac794748fa,993,FALSE,2294,1301,Dire
826e9f43ee2025f3f18c92520dfda9dc,1665,FALSE,2273,608,Dire
bcdfb78ecbf207de358a8d7ba57ccc7d,854,TRUE,1817,963,Radiant
7d82303973eaf50f43953933b2ae57d8,567,FALSE,2269,1702,
0b75272205c5948164816fe193d05a3d,1068,FALSE,2036,968,
542a56bbc67fe0527234931cc64df71b,1276,TRUE,1431,155,
82ec91de88230814c3339c0d2ff7c228,924,FALSE,2227,1303,Dire
39250b66a1780887e6f61279a9019d7c,2175,FALSE,3205,1030,Dire
41b72f91e469bb2247b478e8129f0160,129,TRUE,1330,1201,Radiant
ad2bc1be6167d38bc8eff38b86c143aa,283,FALSE,1353,1070,
f83f98ce5e4e7c6184dba68b81725748,931,TRUE,2288,1357,
1b6009c78aad2031d5b7e7724f61d8d1,465,FALSE,1714,1249,
ea75ec55ebb8c1a9e5cdf3ee0f3f000b,40,TRUE,2543,2503,Radiant
e112fd653c9efcafc4e3cedf04b96e85,1362,FALSE,1936,574,Dire
21fcbcf59468e6096b1e89b1adc7daf4,1012,FALSE,1319,307,
4051f0aa23df03d8c9130b0679d0d3ce,1037,FALSE,2601,1564,
cd6d2c4aaf2877635c20205de0b9d227,643,FALSE,1973,1330,Dire
3416303dca7d94e3cd13e930c2a6111b,848,TRUE,1491,643,Radiant
d55a008396f892119c507a88b4164418,129,FALSE,3388,3259,Radiant
e156d56aaf7dd26d3295698dd78e02d6,627,FALSE,915,288,
2f456ed617ddc69810b2ec4a562ec4e5,753,FALSE,2385,1632,Dire
02a0ec598196e740497c105459f6ff83,1706,TRUE,4207,2501,Radiant
cc86d44ebfe3225fddcbdd4a38356126,888,TRUE,3015,2127,Radiant
89cf8c52f86f7a7b71a4c0525bc3befb,1918,FALSE,2274,356,Radiant
b1550908c012f69123a958a2855efbc3,1549,TRUE,3223,1674,Radiant
15fef34a46cab0466b5ce8ac4302919d,126,TRUE,1498,1372,Radiant
5f0e57db09716b882a6e377f5f871b21,1168,TRUE,2645,1477,Radiant
a58ab35e00e3f6343d3e6eb0046ccb5e,393,TRUE,1708,1315,
d37c67b07b9cf218bddb48c976ed5f9f,53,FALSE,2202,2149,
ee3cf503c0a87f6e49bd8c6456e1948a,2665,FALSE,2996,331,
300d6e64ee067b0d825f0897619b3346,388,TRUE,2498,2110,Dire
9e151f8b4215163e4315a5159441a541,1986,TRUE,2061,75,
9acb516b10095922837d11dbb1a36386,1750,FALSE,2216,466,
61967d8519c50fcf71910a895eee0628,425,TRUE,2061,1636,
e0aece39bf32a9a3952b6be1d3d37918,1291,TRUE,2952,1661,Radiant
a17da69ed72f58f92dcf485ef418ccb0,465,TRUE,2686,2221,Radiant
0735363b2fc1d918f051ae2fb4d6f232,428,FALSE,2601,2173,
6e2e7b8b957b491ec76df2f4247d8f99,215,TRUE,2978,2763,Dire
2dbac17b8fc56f2d7fd79446559aec54,1922,TRUE,2642,720,Radiant
38dd1cba410ed03767af9e50195ce149,1147,FALSE,2027,880,Radiant
614f851ed9a39a96215575e9cc9e9915,1968,FALSE,2091,123,Dire
09868020576d2cd10cf9fa918f01c9c9,684,TRUE,1799,1115,Radiant
2f82c47d9dfd97b743269041b937bdb3,1416,TRUE,2193,777,
a13e1a1d7e3e5074fd017fd9e04406ff,2438,TRUE,2752,314,
fc014655c970346a43b0ff827329f3f7,2449,TRUE,3307,858,Radiant
9db4aaf797268d2267fec072ccbe8eb1,1437,FALSE,3279,1842,Radiant
84e2388b752c572c8ae473a3628aac79,166,TRUE,1476,1310,
45215b120b1195b01398ab1dbc3e550b,2180,TRUE,2549,369,
688b0c93daff09f4a1e6bd1d211acd62,1334,FALSE,1640,306,Dire
d23e93959f51ecdc3e5b1eeeacbfc515,1751,FALSE,3293,1542,Radiant
fcbf19cbe404646796da6d7147a96997,642,FALSE,2852,2210,Radiant
e171387799eab94dce85c82022e06ae3,2077,TRUE,3236,1159,Radiant
889a8f81182aa5aadf8487f57fa2de42,767,FALSE,2425,1658,Dire
7a053caee38c11252dc01d0f9bb8c971,1643,FALSE,1773,130,
5b58587aaa515031ae652a139a3c7de8,1444,TRUE,1945,501,Radiant
7507bae8e65b9e1eb416ac3bc93e73da,1837,TRUE,2190,353,
5c6da070030506cecf231593a0309921,1700,FALSE,2515,815,Dire
54c591647054360df1e18bc2e0d83562,2186,TRUE,2742,556,Radiant
4a2a559e1ef990011b3dceb298a138bc,926,TRUE,4929,4003,Radiant
97512dc47f1869e2a695455d32480cd2,1041,TRUE,1827,786,
f4888317c29accce358b32e53f46bf73,890,TRUE,2910,2020,Radiant
d8ed7ad38c6c452a712479b85e8ca546,1367,FALSE,2829,1462,Radiant
ab5d32d61060bb9c7515a19b93c32520,1004,TRUE,2129,1125,Radiant
9a0a786894ff4ca681b8118fc8e368e2,42,TRUE,1775,1733,
5895ad665ac2432dcaaf394c2c24a05c,816,TRUE,2094,1278,
8c9d8e2c53a85b8bb09ae33639519ef5,896,TRUE,1558,662,
523a85b950e9281e247a9473fe412fb2,577,TRUE,1785,1208,Radiant
5bbbebee7b0e62b5be3a3894b7c0fc2c,2708,TRUE,2937,229,Radiant
d1020f307aa4de59fa1ebbf490cc2773,4,TRUE,2382,2378,Radiant
bfee43411fee90490dc3842a0c09ecd7,1414,TRUE,2861,1447,Radiant
a236f8635f084e4db53b8b62ad620225,921,TRUE,1392,471,
ceea8489a9385044534c71b7c5b67280,592,FALSE,4648,4056,Radiant
45327d8b03f48b032a3c0286de0e9bf6,453,TRUE,1885,1432,Dire
7a724d4579aa53819c828cbf00e2636f,812,TRUE,2027,1215,
468fd4727630b32480e38a4c82fc43ed,590,TRUE,1019,429,
7083721e265e4deee50a1c5e75f8fc3a,3633,FALSE,3960,327,Dire
6d44d1000e5c19beea387de79c37ca28,457,TRUE,2036,1579,
8981f98e3c4971b6081be3ed2267dcc3,924,FALSE,2252,1328,Dire
e27df4c5ab40cc800db3fe8606ba5af3,772,TRUE,2077,1305,Radiant
0556e1c5391ee0cda8c8f7e7ef44d0f2,506,TRUE,2783,2277,Radiant
419a10f3ceaf112ecc56095be3a8921b,620,TRUE,3885,3265,Radiant
01002f01955d9066010f92d5dc8902a2,624,TRUE,2588,1964,Dire
fb1b37f7846adab1eaa23ac1864b842a,1213,TRUE,1671,458,
09833c651cfc1a5b064370f7cbcd9164,2002,FALSE,2424,422,
bba035916af7bdb980ea07d7ef827229,146,FALSE,2863,2717,Radiant
555e3a71fb2b8b378dd22b5bacb72d3b,834,TRUE,1681,847,Radiant
f006d57d1ea096ce8c89a3e213e9a2d3,847,FALSE,1272,425,
f74ee8af0ad7dacbe551a7b3be47bbd4,771,TRUE,1933,1162,
ea32121bb89ca9fab23ed45abf6c9780,2887,FALSE,3984,1097,Radiant
751a12df660c544b56a06642a567eeec,804,TRUE,1525,721,Radiant
94f3197044e3e32c593762122ae97b1e,73,TRUE,2633,2560,Radiant
9680fccb8187038e834fc567a8b5e57e,1871,TRUE,2500,629,Dire
a071ebf3eef1eb38bba2a53ac538afb4,1029,FALSE,2296,1267,Radiant
7ce8f895d55e0cdd6ecbbffdd27e2d4b,75,TRUE,2060,1985,Radiant
5e1216a35150d6792a02eb3388a1e3ae,536,FALSE,3086,2550,Dire
ea31a44279cdaf610b9f78728c75bc8e,1002,TRUE,1716,714,
a4c1fa00c16169c2186bbdf93200cb2b,1287,FALSE,2868,1581,Dire
637577de431d8a810c0d38c6acfe6409,345,FALSE,1643,1298,
2cdb98c1d152d0f469ea7fc16c36b790,1573,FALSE,1801,228,
ce2ac29269dd1d31b8fb455be833443a,1281,TRUE,1696,415,Radiant
9d9656b84cdfa9de1a5df365ba7aadc7,1656,FALSE,1699,43,
6468356749cc6317402325426d7772a6,462,TRUE,1527,1065,
298585cc3231ecd462b4e027769db827,1669,TRUE,2197,528,Radiant
26648aabc546c6ec1413a604010e61d8,297,FALSE,1149,852,
f92bac256ae3b26ab9eef7116343b434,1557,FALSE,2238,681,
99a1dfd50f7c543828b0604b2d0451f7,979,TRUE,2012,1033,Radiant
f5295a15de61b053408d559cb8ebcb6a,1033,FALSE,2553,1520,Radiant
f054ae0e700bf7b7d65c2789679445e3,328,TRUE,1570,1242,Radiant
b6c2f94cf884af66dd6112422f7dc2ec,912,TRUE,2996,2084,Dire
f3a888ace969a2a383215f70769718b4,1954,TRUE,2091,137,
0703c20b36a7fae8d353463a47aaf4f4,255,TRUE,4313,4058,Dire
c6cf398f731431e65db2d6c4c8b15bb1,2286,FALSE,3002,716,Dire
c836f3cf71079c1fd2f65c416101f6cc,124,TRUE,2396,2272,
8cf74ca7fc05185498d4d6623a43ad58,287,TRUE,1266,979,
f16d7a8c4d30af56d11534873b4fde07,2975,TRUE,3159,184,Radiant
9ddf112e3dee6b92633d2c49bd241055,1866,FALSE,2278,412,Dire
f42c904c8084137b654f83e2e43f2fc9,290,FALSE,1991,1701,Dire
5077ba49c76e5bce00c02550aaffe127,410,FALSE,1915,1505,Dire
bbbaf27a29da88ae7a00963d7870b250,109,TRUE,2801,2692,
053ba5a8ce0edf2f2f970a1274a1e872,1407,TRUE,2627,1220,Radiant
a85c4c2a13cc59f786b6aaf6ec3c4c63,1413,TRUE,2169,756,Radiant
8eb52bc89c42606b9eff81fd34a0580a,841,TRUE,2466,1625,Radiant
4a937fd20e2b147ad7532c0a9ce420a6,656,TRUE,903,247,
8a2399daffdc44ba178b2b8507c02713,1610,FALSE,2364,754,Radiant
bbd29033ffaafeba0c0a2685dc19c2f0,1786,TRUE,1913,127,
4b46a25a43c2ba0b845d40731cffd51d,363,TRUE,985,622,
ad3dfaa0b438f885966e586792e46677,1574,FALSE,1811,237,
67fe461efc16f7c45447b7504e46a601,677,FALSE,2814,2137,Dire
deb062aa812ed125384211d318d0f3b3,1476,FALSE,2642,1166,Dire
0933b0d1de6a4f5ff954dbdaf7554841,1134,TRUE,1562,428,Radiant
a55ce6ff16258ed61fabbb77133cdfbe,1475,FALSE,2215,740,Radiant
d53758769cfae14cacf13f0dc19f58f1,675,TRUE,1094,419,
1041dbd65404da56a9e2ad614d1ccb67,379,FALSE,1960,1581,Dire
8ad4d61375b4801f7dd528d724bc2f68,400,FALSE,4002,3602,Radiant
fe08a961cdfc03268598bbca4c29b981,647,TRUE,1870,1223,Radiant
9e1aa9bf32b2e185170e3ec5aaea7595,953,TRUE,1718,765,
c71329248c3c1bda79c185ab9041f526,2982,FALSE,3224,242,
b5e0fdeb7029e40d443a237bd3b4f28f,1441,FALSE,1644,203,
7d7d1da4c1b40c8f942a45bc0d211009,1170,TRUE,2275,1105,Radiant
f8515d95642d4be624de5404a4426ed0,598,TRUE,2374,1776,Radiant
e82a467856dd284b9323897a46fbaba2,412,FALSE,2805,2393,Dire
a7a5ab0f85e32b9d91492598e1e395a1,809,TRUE,1918,1109,Radiant
b3835ee71ec92d7d1a5510a070e70b74,2074,FALSE,2776,702,Dire
3ce1918ff81f9a388536239b03e1bae1,547,TRUE,1683,1136,Radiant
d566af81a1417ec3a739f39ccda068a3,2511,FALSE,2811,300,
7773bf0d6a729133b0dbd930ea8002c0,1232,FALSE,1643,411,
acc0d467ae97d3538fc32564b0a3f4ff,1188,TRUE,3827,2639,Radiant
bb81d8231c5dbcf2291597c50fed9dba,1915,FALSE,2814,899,Dire
187db5623cc9c657f477b244468546c5,537,FALSE,2176,1639,Dire
e0320a5494d1ba79dff23b0b1c503eb0,736,TRUE,1951,1215,
b04c240eb5e91c69630764bb4ca79770,66,TRUE,2941,2875,Radiant
8e973c5a13bd1388d1fac0d122693f1f,117,TRUE,2085,1968,Dire
e5d1616add8b86fcbfc1bdebe56b465d,2002,TRUE,2990,988,
b084aa415127b25a8b5f555abbd6e0e5,996,FALSE,1923,927,Dire
b65f934378dbd76c4b946ae69e8bdd62,1564,TRUE,1946,382,
239c7fdc39218d525839294a8fb3e92d,3169,FALSE,3688,519,Radiant
017bbc9c8e4673efbebdbe485e57ed8a,825,FALSE,1674,849,Dire
b6f6929edaf9497c440f401f538f13d2,1922,TRUE,2473,551,
6757c53de80bb22478b8a085d10ff62d,168,FALSE,1710,1542,
4f599df96c8664d57c79dbac2625e3b3,1003,FALSE,2697,1694,Dire
993005f645a4e26f68f73db24efa4047,20,TRUE,1443,1423,Radiant
e04f644bde60b91f5cfa5d5d38ffc087,1418,TRUE,2421,1003,
2fadfb33b973d55a395c25fd517230b9,797,TRUE,1651,854,Radiant
429ceee70d7bc7634b78dd5d5678f255,1192,TRUE,1491,299,
f23f096cd54986088472e79cc6d996b5,2075,FALSE,2493,418,Dire
85d0398e563f6671f1354e26494f386e,690,TRUE,2469,1779,Radiant
e63478b1a4f5c414578051116a7e1cb3,1842,FALSE,1983,141,
1ed4c8ba2a9aef210db78b8f73fe5b95,698,FALSE,1214,516,Dire
b28562bf4f6a2c7c6b92fb8736995ee5,1931,TRUE,2186,255,
5080fcfad782644dcde82a911f1e00f7,988,TRUE,2452,1464,Radiant
0437255662905e67511e2b806d6041f1,983,TRUE,2387,1404,
c33f0795310807f0e0c5b14ae5880f13,628,FALSE,914,286,
4cf7cd92ee03856b40e62f7769a061ef,2278,FALSE,3362,1084,Dire
8bc75cc40f41662a349155a4ffc83893,721,TRUE,2814,2093,Radiant
5b694598f5c9640ef0b3a713155da31c,890,TRUE,1940,1050,
c5b85e0d0b43e579837991bbcd88bb7c,990,FALSE,2066,1076,Radiant
e29ef76bc0b1a7f21f5721cdd8491140,1067,FALSE,2291,1224,
b6996d14303176bc55bfdb93b78538ca,1403,TRUE,1860,457,Radiant
e9fc198d1ae64d106c6c5eac5d55636f,180,TRUE,2112,1932,Radiant
a2665e70847f4d93e16cff24eb63d185,100,FALSE,1595,1495,
8e8b22ca413f2c067d9c2c3b2655c270,1208,FALSE,1907,699,Dire
84d3c57dec04e0b7ebb3c37552cc20c6,1422,TRUE,1605,183,
ccbe90fef206041288801a2bff9f72c4,2013,FALSE,3669,1656,Dire
d26b4b452d28e2ecc6ca9bd018aa7c28,843,TRUE,2050,1207,Radiant
2533e2e925b1ba2a144fc2395d25aaf3,538,TRUE,1858,1320,
ff018026688e22e66c185a17e54e1e2f,264,TRUE,1731,1467,Radiant
f713610567a94d9fd5e1b57edb103f85,211,TRUE,1730,1519,Radiant
35a70adfe3a7d9b5dde9022995bb7940,612,FALSE,2430,1818,
23a113cc2cb6de48edfd56cfde832525,185,TRUE,2076,1891,Radiant
e1f64fd3449b30fe3ddf44dfbfd99871,691,FALSE,2487,1796,Dire
9ef5e9cdf21fa275f69090a8fb92b739,1641,TRUE,2441,800,
04d8b324cb3fe9295d804b971c820365,508,FALSE,3122,2614,Radiant
48e0926cd417a8dc4ea940b4d15389ba,1006,TRUE,3254,2248,Radiant
3d6f1af88a2f54859c665fc9ef385222,292,TRUE,1589,1297,
1222674f0a698d95e91a8749db81170f,408,FALSE,1730,1322,
dd196523ca83807f60910b9ce2f2a8e8,412,TRUE,1743,1331,
0fccc97f00f5003d3f5e40cfe33340ae,1301,TRUE,2068,767,Radiant
d16259ec6c6fe7d8179bfdb6b957caec,1403,FALSE,2250,847,Dire
ffebc1108c603fa3386081a93ad92d16,300,FALSE,2066,1766,Dire
32e34b00bf10691ab2e519fbde81cb96,202,TRUE,1795,1593,Radiant
3b4910f335f2403e8840e2dbed0af8f3,404,FALSE,1724,1320,Dire
ae9295858c21ab544d42064de39dd626,389,TRUE,1331,942,Radiant
44eb4bf7588043e99857a5e6c8e3bd93,1971,TRUE,2143,172,
0181bc47ca20bb25ea64eaae9e30fbe6,465,FALSE,1516,1051,Dire
456ca82dc8c5fb1be1b049c3e0d635e8,715,TRUE,1285,570,Radiant
3130a247511010f0c29ee0eb72c91ada,231,FALSE,1222,991,Dire
13832251a0efa6cbc43f71c5c72e91eb,1962,FALSE,2401,439,Dire
c5bb10af896eb9f200fde86a58a755da,939,TRUE,2628,1689,Radiant
cc337fb853b32028a24046e609ba720b,1305,TRUE,3669,2364,Radiant
6f50ae9704deec21706ce99cc1a6c30b,1231,TRUE,1435,204,
dd7965627917ae9d9c9dd035b7997f9b,1730,TRUE,2175,445,
155c1bad652e9a11520a4f546f50414c,3299,TRUE,4423,1124,Dire
4e2f0ce28bc32132bb148555005ae347,1868,FALSE,2082,214,
002f8edcedcd4d7f37c794c60ef70d6a,1555,FALSE,2217,662,
03b62115113510a291c721652ad43ae2,2604,TRUE,2802,198,
8ee59a6775d007bfd358a22f7ffbcfc0,140,FALSE,1520,1380,
7141af1ed5b46dae6c5944e8c8845a8a,36,TRUE,944,908,
a95d1ed9235947ca4295084595473f2d,306,FALSE,3429,3123,Radiant
ff776c8f5bf32aa5da275b6664a723c0,1060,TRUE,2774,1714,Radiant
68608bc4dc65094241a5a00bc8546353,112,FALSE,1094,982,
5edeef97eb1ac63adafc23591984cacf,1154,TRUE,1422,268,
54070556696b30cc0d190f4cc1078168,1299,TRUE,2557,1258,Radiant
ca6571055f60cf4c344903baeb4fa352,578,TRUE,2787,2209,Radiant
a8a1e38994256330dfcadbbb01449c58,469,FALSE,2789,2320,Radiant
d890fc7f93769e82e58a3723de2572a2,49,TRUE,2562,2513,Radiant
7cd40476dc8d190eb00500cb25841369,546,TRUE,1878,1332,Radiant
20e7ed860644f766a0d7638dd3260bd9,687,TRUE,2559,1872,Dire
dfa184f13bcde58f0a05e2d2fc5f3796,1419,TRUE,2211,792,Radiant
4891a063a41edebc4cf4f1e4292618d8,252,FALSE,3464,3212,Radiant
1a25f6dbdf8a5463a87aee805561becd,1483,TRUE,2260,777,
596585ed6c4a50efb7217bcfa91a18f0,915,FALSE,1658,743,
838b7aa744b023ca1b8d4a8137545e65,2049,FALSE,2212,163,
5a8459dc6d11413be9d6a166b15f07a6,1869,FALSE,2275,406,Dire
619b797567a31c124d47b8956abecdca,1930,FALSE,2758,828,Radiant
6d855a2b719c289f81e1231b51a8ce6f,867,TRUE,3581,2714,Radiant
17e578bd68f8da6471121ca029dc7960,194,FALSE,3268,3074,Radiant
a825fd51b03a84e0810e26a72b055538,336,FALSE,2366,2030,Dire
9a14763b703e073094906bbe342fdf81,905,TRUE,2702,1797,Radiant
32c430d842d63da664c3958dfb111e82,4351,FALSE,4687,336,
39eea366d788d1a76ce1512b9af68a68,1054,FALSE,3713,2659,Dire
e8cb7b0656b2054ef610830d7144c150,1731,TRUE,1982,251,
a57d68103550c11fb68601a0b14bf38d,1561,TRUE,2542,981,Dire
cb202e8763798967ca8643787009c86e,2018,FALSE,2189,171,
7ed4f3ea74eb501b7b927bc63edd7b45,1600,TRUE,2291,691,Radiant
4b32ab8a11e40f5b174092cecf23853f,2760,FALSE,2909,149,
d61e641ee3957ec61dafb5f09846e357,486,FALSE,3460,2974,Radiant
415574817746a8576d002558cec848b1,988,TRUE,2457,1469,Radiant
73722ec54365c0a2cdb2fa88013da8c2,3374,TRUE,3425,51,
dd7e650ff7f9a24942d64cff02dbcb56,2039,TRUE,2870,831,Dire
9937fbaba7ca323bea299ba04ed5633a,1658,TRUE,2059,401,Radiant
4782c71b52669d822f3ec873872fd5c4,2671,TRUE,3818,1147,Radiant
ef0e4e96f2905895f33e943945fa9bd5,305,FALSE,2053,1748,Dire
f7d39e804ca93f2557d80384b0a6510f,1958,TRUE,3225,1267,Radiant
46153fcd724ab6f0a2058f394eed0d7c,1952,TRUE,2668,716,Dire
5de41da56e3dcfebed302b9529e53e12,183,FALSE,2378,2195,Dire
f491d00db759a101628b2bd0e20a5139,341,TRUE,1903,1562,Radiant
89a9f20ec1ccc4f5e5bd1be22331e795,984,TRUE,1717,733,
c917788d866ebc335b3fa40fb7c7d814,1019,FALSE,2802,1783,Radiant
163e47ec2180521e045aadb3cfa09262,1212,FALSE,1309,97,
c778e6c32416a801e16bdd4eec81721b,2064,FALSE,3835,1771,Dire
660361c48f07d51ce462d468ef03173f,905,TRUE,1936,1031,Radiant
ffe7c47d3debebe913411ff7e47a8197,1234,TRUE,1377,143,
fe1cd0b31cec2ea5a885bb3ae29447f8,658,FALSE,2905,2247,Dire
6ff3209c9b1881c42f416321a758dfe5,1456,FALSE,2328,872,Dire
84dd86cced2c9999c90035ab6ee78943,2923,FALSE,3004,81,
a8d27eb02eba1ee8ddd9114d0c6235bb,809,FALSE,2139,1330,Dire
e89cfbdd67cdb02e35a5c76f7342928e,910,FALSE,1741,831,
6186b7484e0dccc3cd525f71dbccc4fd,1472,FALSE,2495,1023,Dire
cf943c0ebe574010cf45698861ec59da,1633,TRUE,2494,861,Radiant
ca9f83d4e7cca2c4eae01008a1f1bfee,2096,TRUE,2645,549,
dffb7e8803cc3f833bb56ca9399878f8,1264,FALSE,2079,815,Dire
6563c04ef572c2e50993e778cb6501bd,706,FALSE,2510,1804,Dire
1b5e6f9087b08303a52e21eb0e274718,1296,FALSE,2545,1249,Dire
9624a6ff747f38b5bf5728f427fbd5d5,735,FALSE,2954,2219,Dire
c1d3bba9f0dcdd9c34a14693ffbf6c73,158,TRUE,1429,1271,Radiant
c8ee9e67d03d9dce975fc621ef33560c,1435,TRUE,1644,209,
92e5755b26acd46d570027ca3ebce65f,693,FALSE,2071,1378,Dire
61860294280225708538b07521848fcb,1076,TRUE,2993,1917,Dire
b2f699c959b795e370200d8f1684137f,2847,TRUE,3984,1137,Radiant
c1424fa3ff509239d1f20daba067a25f,1854,FALSE,3463,1609,Dire
310938390971487897cd6735afcc888d,2125,FALSE,3080,955,Dire
1195beafecb1bd74b3a24dcaff063b78,2214,TRUE,2355,141,
268311059c3978a07dd834df50f333a1,2343,TRUE,3054,711,Radiant
22e4c442daa91d70c462047be30175bc,1094,TRUE,1673,579,
b6c1a93abe01eaa2bcc1ca100e4712ca,2189,TRUE,2373,184,Radiant
59cc354b112922e726e3fe4cb0174908,797,TRUE,2032,1235,
b46ed831de54a591299460cb7fba92d9,1696,TRUE,1807,111,
01ffbd3b7f6e33ca232efe5459f02dfb,266,TRUE,1211,945,Radiant
cd5cb0cd8917989ab534e2003e0f3244,1309,TRUE,2859,1550,
aee068120df2155d2505da0eb8df530c,917,TRUE,2341,1424,Radiant
81f7ce9d61b7f838569b536fe6e1a5d1,1763,TRUE,2560,797,Radiant
86e5e33c93cb950e79739e8f843b138d,1804,FALSE,2363,559,Dire
2f22650a73691e2662d6ee6c7996628a,1506,TRUE,2822,1316,Dire
1b741dd9765b838a1173ab59ec5051d0,1651,FALSE,1914,263,Dire
a5746708e3763a68a4de6e73926ee7e0,129,TRUE,1980,1851,
665c4de253e5f575c835b952ca2aebeb,701,TRUE,3166,2465,
e2110e2a13f44a37252ade94582b0770,1605,TRUE,2856,1251,Dire
8f3a48a3c1834df8296ec371db9d5121,197,TRUE,1601,1404,
63df7d6899f03f778fc18ee37debf643,449,TRUE,2671,2222,
2ca736a354e5c6148609f0e7e2035305,2772,TRUE,3157,385,
0644c69b2e48f8586b9f2455e4edf3ea,2992,FALSE,3245,253,
532cbf415cdf4278c61fb961ea52f2bf,1370,FALSE,1595,225,
a66a5b76e375a6d3f340cab2257173af,3032,FALSE,4266,1234,Dire
4b6b734a21f0f503fb44dd5c787ed32a,1880,FALSE,3356,1476,Dire
516aa25bb03b2c18e9f66cac96854be9,910,TRUE,1357,447,Radiant
3d6b6912407a50c36ee9a7d44750ed8e,1172,FALSE,2212,1040,Dire
9cef47ed37cfc73f71b327deec41c508,639,FALSE,2469,1830,Radiant
0a146ef889edaaebad62bd5b6523ee70,4,TRUE,1278,1274,Radiant
1bb4dc282a00f5b58283cc048333e22c,3866,TRUE,4572,706,Radiant
bbc2c4e487bd4ce29f466888b95b8741,930,FALSE,2503,1573,Dire
9a60a24d74cc5315239e9866190e77fd,216,FALSE,1139,923,Dire
a9566a42e8670d96248fffa6376388b1,644,FALSE,3024,2380,Radiant
b6e2d02edcd6eca86b6ce0cddcf25947,86,FALSE,2580,2494,Dire
b483237ae0b3b7259b85ce1ba1739746,2086,TRUE,2248,162,
caac45ccf1c941bd5c657de996d8e5e6,435,TRUE,2164,1729,Radiant
7034bceb32ebc72e0d334a4160d25874,1703,TRUE,1789,86,
76ecc6892e9b3b761865c33b9bb1ac23,48,TRUE,1726,1678,
37abfb57695998c0b4155aea56b7c0db,859,FALSE,1588,729,
3eb2335250b24fa60187a1fe71dc9cc3,1288,TRUE,3421,2133,Radiant
9a81b743575e2d97a68497364b2b5c2f,2649,FALSE,2891,242,Dire
931d3445e8ea3efd159fad3d5dea9e19,750,FALSE,954,204,
35fb86d4e3cf05a6961cbe29485503ba,849,FALSE,1270,421,Dire
89abf46504dd8c2dbddc1b8ce2352c38,336,TRUE,2342,2006,Radiant
f15c632a12cf782b6bb9425ebf1f9696,287,TRUE,3102,2815,Radiant
08604071a7786581c623d0e5b6465c22,935,TRUE,3364,2429,Radiant
026817b1353de5cbb2f0e7aae0f6f14b,13,FALSE,2512,2499,Radiant
fcfc70788bcfe08c23f9c46a89ac43aa,1159,TRUE,1757,598,
62b426ce34a3fb77d100642731cbeb47,1466,TRUE,2790,1324,Dire
3fcae08622ad349cc35cb2f86c0f1084,543,FALSE,2350,1807,Dire
cc79eac2bf12fc9392ffe14daad3691e,488,TRUE,3323,2835,Radiant
c14d01dcba64d2d1a3cccb75f8c29afd,2422,FALSE,3628,1206,Radiant
08e5db4cac0f0f168797f5962b3c9739,2123,FALSE,2735,612,
6668e93c259c22280ba34af7d96c5c80,1451,FALSE,2250,799,Dire
2eb59243c57a71561fe4dfaca517134f,931,FALSE,2528,1597,Dire
80c9ca9dba53bf1075138d8588615cc9,1027,FALSE,3016,1989,Radiant
e0c9dc5b3337b9fcf79399ee86738807,1144,TRUE,1958,814,Radiant
0373f7db137004a862890b25b12d6a9b,1537,TRUE,2676,1139,Radiant
1ca526cd4d118997b686ed9ae40c9e24,2427,FALSE,2550,123,
7a3b57891fff1789b63ddcecf9ce8274,1567,FALSE,2547,980,Dire
5f72e1106be6808b60ae77fa4db40550,1575,TRUE,2535,960,Radiant
163b424e76f92ba751115a717cb422ba,2179,FALSE,2213,34,Dire
de0c9497547eab9705a62ba3c48ec234,665,TRUE,2917,2252,Radiant
a0ad7436b825529012fe0b9f57e96721,850,TRUE,1981,1131,Radiant
1801fa71983a9aff5a8f477983871541,0,TRUE,1635,1635,
8f6265c7f485c851adaf73bb77247275,2004,TRUE,2110,106,
a63a3fc9f3605ab998019f40d2f94fcf,1275,TRUE,2146,871,
95d356dbe6323451f116b6a34a9cc216,981,TRUE,1300,319,
bd07c27f5c93c985cdb19d03ad427aa8,1633,FALSE,2406,773,Radiant
9ca25a68b58b3e84c13bbdfb4c65bd9c,1873,TRUE,3181,1308,Dire
5cf72249c58c5b5f8e28cfe718e5e0a4,1352,TRUE,2684,1332,Radiant
39ae11ce8cfef6e2b88d994129f9a040,1716,FALSE,3341,1625,Dire
39c427d935c42488aea15ec738ecbcd8,1041,FALSE,1996,955,Dire
1b342ec77bdb25b113c8d6018b5cc7b4,528,TRUE,1420,892,Radiant
6777b4d22e60006ff292e430f5adbf55,1745,TRUE,2986,1241,Radiant
40a661c123db0507a61cf86376b83bfd,1614,TRUE,2124,510,Radiant
a4d5221b60692027d6e4eb707145b8c2,1057,TRUE,1693,636,Radiant
d33396ede065da926fb35f8d5884528d,2009,TRUE,2585,576,Radiant
35cbbfb608dd7319c785d6a47d79c8b1,1299,FALSE,1990,691,Dire
7d25a46729417cbac4243ddd54fb3ef5,145,FALSE,2371,2226,Dire
935798b1080b8375f81f94a134194679,889,TRUE,1575,686,
f36d0572d6a9449f7d0d68963fec2ad9,920,FALSE,3437,2517,
d6398657570b6fcfcf1111809c3b456f,1239,TRUE,1713,474,Radiant
3b05efad52c6016f443006007a817639,846,TRUE,1711,865,
c025dc796163fa62301d0d389801b321,1395,TRUE,2487,1092,Radiant
d5e4163a0fdfc26d221e4adedd748d9e,780,TRUE,2515,1735,Radiant
38d576c704f4fc32ca707ce612aa282c,2875,FALSE,3080,205,
5d8110fbaa5853553cee1110995c9196,893,TRUE,2834,1941,Dire
28e7d19577e96d4b2b81358258c33cad,1806,TRUE,3470,1664,Radiant
a8afda1b9a8af7e38fb086a7fbe9d2ab,430,FALSE,1675,1245,Dire
eba28971d4824521739c1cfc36d27407,3574,FALSE,4393,819,Radiant
e247dfdd3199a18342712f5c554d32dc,1467,FALSE,1696,229,
9757f848b7cb672646bd1d18bb34c4e3,216,TRUE,1438,1222,
3faa73302fffe29c0fe748bd417eb826,1633,FALSE,1930,297,Dire
252b51eeaa5f5e910244470990f921e1,934,TRUE,1557,623,
518fa4dc61fcf46e24e6908a2f65551c,3321,TRUE,4732,1411,Radiant
441e2f3a0aaa1be356ec2fdea6057151,987,TRUE,2687,1700,Radiant
13ca41d21aad5581275fea97df246623,1704,TRUE,1856,152,
943042bddc58eb067a6283be9f935482,1489,FALSE,3085,1596,Dire
17ef64e68db1e0a25a01fa28d95cb644,745,FALSE,2216,1471,Radiant
de682a884ace344672dc8663438f992c,440,TRUE,1976,1536,
d9bd5f7894979f7d58e2cd3dcff84127,593,FALSE,2002,1409,Dire
4fb2bd31f7351b66b0391ee5bbd71c72,785,TRUE,1471,686,Radiant
aae23aa9a5fe834e5e38ff5db7a233b1,2003,TRUE,2453,450,
861721a68b7a4fad98f6a86644c1e33f,1805,TRUE,1986,181,
ac62e06d8bc06e3022e4dc61162def2f,1958,FALSE,3035,1077,Dire
03970f67e4581347362120404ab462a4,711,FALSE,2999,2288,Radiant
515c1d98cc389f4a87455d88b7c836a6,921,FALSE,3174,2253,Dire
1c3672419e4e42713713065926c6b4a4,280,FALSE,3036,2756,Dire
0d40bb6d3b037afc0ebc3844457fbff1,615,FALSE,1853,1238,
5dab04a94ac90fafb6212a9c7b68ebbe,386,FALSE,1187,801,
2b0de7866b092efb90467b4521d61bf0,1733,FALSE,3354,1621,Dire
ac4479e53774429e7479653eb7c91970,143,TRUE,1682,1539,
90f196f2d28650b9138c70cad7cff303,246,FALSE,1413,1167,Radiant
b3692be3717f694ec5fae9f2bbca97ce,1036,TRUE,2456,1420,
f015230719bd7cbe7dbb35a6c38eb74a,1304,TRUE,1524,220,
8c0be5442c20b407e80637333970a58a,2130,TRUE,2484,354,Radiant
cbcd28bec26b3ee566268dc850b2e5a2,135,TRUE,2699,2564,Radiant
084c6283223301e68d4986e9440d3236,3154,FALSE,3222,68,
9060d4e38c6ef3c5104bde8f4861edd9,1386,FALSE,2467,1081,
6dbab5554bf1efbfcacc1a8d7c1ab018,1414,FALSE,2486,1072,Dire
4c1537786a081d13ab61eba943467905,1524,TRUE,1986,462,Dire
3414bcc24b25c5dd5c2637b46d072892,1106,FALSE,1465,359,
d43eaf2c8198a9a8e8b3b226c332a970,2251,TRUE,2466,215,
8af8d73557986adc9c7fffdc80d998f5,1046,FALSE,2314,1268,Dire
5053595e60e41c3bf8d6f6f5dca55385,1276,FALSE,1730,454,
dde1a511549afa40ec7be7913b9f1b35,281,TRUE,3185,2904,Radiant
176706c9280c645f0383b497d549fac2,166,FALSE,1879,1713,Dire
88a2d19aacbb1d610d887e55c4e05010,643,TRUE,1058,415,Radiant
0933f50ded1d679652aaf94a010fb413,903,FALSE,2407,1504,Dire
d797d2fc21672b2c3e98c67532e091e8,788,FALSE,3008,2220,Dire
e890f735a185373f2628dedb8b1a3f6b,191,FALSE,2547,2356,Radiant
823ae0ef8c277d0e33f07d2108f81800,427,TRUE,2298,1871,Radiant
12e1924d19cface255c86ef8b333ebaa,5,TRUE,1836,1831,
ed90770693843607dfb01013bd90e6a6,5,FALSE,1728,1723,
8120f97d41411851275e783214ee51ad,3220,TRUE,3751,531,Radiant
a7b024343458876356497403fcb57b26,473,FALSE,1262,789,
e13a80057f55560c35e52b9fc4c31fd9,511,TRUE,3183,2672,Dire
142c813ac1f338e127388d408f4fa0ae,2346,TRUE,2417,71,
7cfc67f0d5d06ef7de467d50ebc85f97,1754,FALSE,1875,121,
c3fb6735407931a915a5a22352b2be23,1772,FALSE,2138,366,Dire
2cfc71ce111b616dc37875c3dc5dd616,2539,TRUE,2592,53,
c5113df59ab6a0a1aa23cf7bf236a311,2052,TRUE,2797,745,Radiant
042da42db84c6b83b99396163886f1d9,1087,TRUE,2840,1753,Dire
68fdfaccef97f2230153f80a45e3567e,672,TRUE,2309,1637,Radiant
6289c0317a43880d23fade9994d932da,213,TRUE,1952,1739,Radiant
9307c6fee5596549155c1eddf85f47c3,621,TRUE,908,287,
ae5892d7f08236d60742a0e774354dca,211,TRUE,3126,2915,Radiant
38a77a9693a9286b5caabe9dac8a9e51,1430,TRUE,1882,452,
4ac2719a33e691267c5c24e4631b5447,183,TRUE,4092,3909,Dire
d2e13ee5235e7f6b8678a1d9342d1dd6,348,FALSE,2043,1695,Dire
6390b4df0ebbe36d08389da56be0e64b,984,FALSE,1344,360,
be8f5f25c780974db65d95fd4574d01f,895,FALSE,2670,1775,
c42ad345f9dcda0ff3a8bfd34e073f94,1424,FALSE,1909,485,
55041b5ca164fdd9c245e12130fedf51,165,FALSE,1314,1149,Dire
9c9b1e8a630e4089115734c4e2f9d215,455,FALSE,3299,2844,Dire
34d2dd515e9ba1d49defd2da03bc3a21,76,FALSE,2006,1930,Dire
cd7b790809b430dc32ceca2d49d8c594,2142,TRUE,2431,289,
33dc4c29e74af6d67c2955062e576dca,1198,TRUE,3293,2095,Radiant
5c326e889061a5756c6ddbe9bb3f5b7a,1486,FALSE,2593,1107,Dire
db8de2e3d13a0487f96105f127751e7a,2044,TRUE,3321,1277,Radiant
1fbbddeb3a25d923d5dfe175dc129299,467,TRUE,1427,960,Radiant
1737e2155b7318853c61bca647152c0f,50,TRUE,2340,2290,Radiant
24d4d236f330c37cb2008f778cc125ba,328,FALSE,2752,2424,Dire
df044292211f0d053caa06760275d766,710,FALSE,3081,2371,Dire
93f3a4f18311615584350a97fbf735fb,1355,TRUE,2530,1175,Radiant
c39a08ed4ecd92d9eaccf901d60a721f,2205,TRUE,2916,711,Dire
4235550746680d992821b4074c9fb4b1,880,FALSE,2221,1341,Dire
7fe500a9f8b3b6e564d0c465b4ed643a,1117,TRUE,2505,1388,Radiant
6d82c50a28ab7734a50f58453cd10618,680,FALSE,1262,582,
93ecac4c15a9529e272ba1ce1190859a,32,TRUE,2460,2428,Radiant
6c57048924b3adea0e2ea2fcb0e5a78b,2403,FALSE,3574,1171,Radiant
6a6d2cc0e96ef888fee5d2fe1efc4743,1528,TRUE,2432,904,Dire
ba7de4545a4bfabb86e4cff9f9e25eed,2999,FALSE,3257,258,Dire
f06aaf734577c3e1a2a5d63998919940,2667,TRUE,3227,560,
f46b4dd9cd2865db5d3c9bec1bd90a8f,1198,FALSE,1545,347,
20d6e8226fcc2821d3f47b981adf33a9,21,FALSE,1394,1373,
70d544c4e7a706187ee4e42e316cf1cb,358,FALSE,1814,1456,
b0bcbae97bd9e29b1ac5def57e7b27c6,1455,TRUE,1687,232,
880c31afdd33efda1b9316ac00eb0b5a,1200,TRUE,1520,320,
20dfd9b03192e57c29ea16710ef6e8f5,2072,TRUE,3025,953,Radiant
9b6332c65c2803b2d40c8636b0185a36,1355,FALSE,1639,284,
4f4b55a53200a4418ab155d51ff35b24,391,TRUE,2536,2145,Radiant
b28a0e94fd061c06e2e0a32a259d201a,79,TRUE,973,894,
15ad0efa1712eef41fa5aa48c8b8f866,1873,TRUE,1958,85,
bfb986485fbac818b28b1634bb5c079e,333,TRUE,2827,2494,Radiant
1ecc7a76df18fd55322aa112cd949631,334,TRUE,2807,2473,Radiant
e645ac23db2aa7db3dccc255c6407eba,255,TRUE,2398,2143,
12ec730b4f0b0929cf8cae3a3a5af4b1,769,TRUE,2501,1732,Radiant
26076d3f8531526c2ce82a41cc4c1ee9,480,FALSE,1746,1266,Dire
9009748dea419e198d43a94da851832b,2224,TRUE,2289,65,
d4f3aa1e4b19406c1e64bdeb758b58fa,813,FALSE,1797,984,
f33346467d5fcdeeab45bc12857e7df8,2881,TRUE,2994,113,
b1757eac8ec78a3e682cbcd543b3cdaf,384,FALSE,2274,1890,Dire
e4f48d0afaf25bf2f9e12257954ce7c2,1389,TRUE,2447,1058,Radiant
757581a93bc6e94b77ae99e0501c8d13,369,TRUE,1638,1269,
a743dbe8fb34da56362d85937969f046,712,FALSE,1942,1230,Dire
c5cc80fddedb4bd4a6216c70556e0110,42,TRUE,1036,994,
8ae49d26e55db7ed2aeae054dd6f3abe,1372,TRUE,1595,223,
6bc414eb2be207cad807362b20212cd2,1528,TRUE,2033,505,
841bf54eeff707d35164ec9d45be19b0,2872,FALSE,2916,44,
9876119b8e488737ae1f1464fcf3da32,693,TRUE,1852,1159,Radiant
03e98a356d9738f1a6cc23087a37397b,1717,FALSE,2782,1065,Dire
05b3cacfba5241ebe801ae4f293c40c6,1278,TRUE,3418,2140,Dire
8b260df8b160fa50ec63d3da49b8d3a4,1294,TRUE,2082,788,Radiant
699f68c35ed08882f5c8cec7dbcf4768,571,TRUE,2620,2049,Radiant
afdb846ce321feabefe37db32f9b49d3,1468,TRUE,2484,1016,Radiant
52d1911b43ed330a17b93637f1131615,748,TRUE,2502,1754,Dire
04ad6210480ecd1966be8fd5f6cf956f,543,FALSE,1894,1351,Dire
9c0ed3e12773a4fe1faad775cff4df90,631,FALSE,2148,1517,
d51d3d91b6b6b3c32b31a7be8e34c660,785,FALSE,2130,1345,Radiant
94c8d3b04f4be9ca5cd63dbead3126b2,1469,FALSE,3754,2285,Radiant
a130c3140c27f2bc2340c184e5e43e39,909,FALSE,1102,193,
8585132e76dfa62a53dfca52b9b92526,1040,TRUE,2070,1030,
10bf717883b68cdea06272f1728f3b38,886,FALSE,2775,1889,Dire
603be03a724d066fc359c9491bcc7284,149,FALSE,1343,1194,Dire
8b7deaedf4d6ede126fb3fe23e7a48ae,1311,FALSE,2044,733,Dire
db8e14b9a60f83de3f706f2e443e141a,1020,FALSE,2459,1439,Dire
3c5f1a4093a4a3c1cd0fd45bd505119c,1750,FALSE,1996,246,
63949f1a3e44974ebb0b9a297a124cd7,140,FALSE,2125,1985,Dire
d6bdc20d72bc16dbe1da3287ef185c52,869,FALSE,1937,1068,Radiant
8576f7e083dddf6a3ed5ac5d54b9db26,1058,FALSE,2458,1400,Dire
62d04d841b5c9f6da9987d7a9389fb94,2472,FALSE,2560,88,
39b5962276041baaca4f6657cf9c86e7,669,TRUE,2757,2088,Radiant
f1ac7b48ae5910911a420742081f69ca,1670,TRUE,3546,1876,Dire
4eb4476d9a0fa601a5183fc985d3183b,1666,FALSE,2891,1225,Dire
2c349a32adccf42bdcc9f539b1991db3,380,TRUE,2166,1786,Radiant
3a1d8b81ca2225d927786edf2be44dd6,1121,FALSE,1434,313,
c543f97e9c58693a13d6da025cfc027b,2340,FALSE,2869,529,Radiant
52344046345f62c38a60c065bd2c6706,2110,TRUE,2805,695,Dire
c161f9b5481c0f613b65187cd6ca2be8,956,FALSE,3192,2236,Dire
e4b9a270fe8b66f08daabe9d95faea70,1198,FALSE,4258,3060,Radiant
bf3f7011b02cf01b7439350ffc332e20,269,TRUE,1100,831,
fa3cc62122cca02910222566840dbb8d,392,FALSE,1927,1535,
2a0cfb65b84e67fbab245353b1c4654a,263,TRUE,2576,2313,Radiant
df4d84f2ea52e71bdf002a0de0c32cb9,1094,FALSE,2198,1104,
349a6cbcc2e192e79b14b51c8aded7ee,1184,FALSE,2535,1351,Radiant
2c062e9249b7890e0ed38c5fb5272bab,232,TRUE,2065,1833,
9e02e45870f0828aed501999aafd5cba,250,TRUE,1417,1167,Radiant
ae295b015346ff50988f546b132af049,1594,FALSE,2072,478,Dire
86409fdd53790e62635423f624d6145e,2389,FALSE,2479,90,
bf917bf829e3716386e6700196169b50,1163,TRUE,2286,1123,Radiant
7e2fe01e2ec74d6349a11450dbc23825,1081,TRUE,1637,556,Radiant
c2b680691fbb75198d47b455550da948,989,TRUE,2180,1191,
2e1d9d59d4d36bba77b7211fd3c587b1,847,FALSE,3071,2224,Dire
5d0ddd2913b5a206c139ce1e9d40b106,1559,TRUE,2529,970,
ad2fca2bfc669f3de033ec7e84d3d807,958,TRUE,1207,249,
98a69bef34066ed6660eeef79d7c5c36,554,TRUE,2082,1528,
1e5091b3c5bad5deb63e3b186204799b,278,FALSE,2056,1778,Dire
a8d6760c0f416a94a1ee8c5b56dc073d,1625,TRUE,2065,440,
7f640e8732d2bea64a419f47fcc02f67,326,TRUE,1897,1571,
cd40a213f5557264102b8614caf1bf15,1941,TRUE,2005,64,
b05a640e2249fba6c58f54d9ebc00129,1682,TRUE,1736,54,
e891bccb77e0b0fd4e0a3adc679bbefb,222,TRUE,2512,2290,Radiant
8c68f68b87e1293877df63d8b81937a1,1395,TRUE,3157,1762,Radiant
0a0a25d64518c5ff70c0552cfe307e8c,92,TRUE,2205,2113,
48bff34208751d80cb752e8d78972bfb,575,TRUE,2475,1900,Radiant
344e56aa03e1f0a0574bf34fbfe32073,254,TRUE,1473,1219,
662e41adcd23be81d4c875b84cb4cc4a,240,TRUE,1807,1567,Radiant
28c324c687237567906766794546dd82,532,FALSE,2745,2213,Dire
2fb8b55aa3167b232f7f182573fea66e,2578,TRUE,3303,725,Radiant
ddf90815e4718647ec01d704f8045eb5,608,TRUE,1478,870,
4f7baf50f2bb1d063e8cc2ae1db60224,450,FALSE,1584,1134,Dire
1b58ee85dce0bd5a5ef975164aab9c14,899,TRUE,2991,2092,Dire
0bd1ece202c279ee5b1cdb4b9e609bd7,574,TRUE,3481,2907,Radiant
61ae3b5299253ba0a7ab2e1ccbc836b0,346,TRUE,1453,1107,Radiant
cbdcf939b8dbc05d99c9074e9e0c1dc9,431,TRUE,2026,1595,
bb86ecf85294ad8de258611e474ccc6c,1936,FALSE,2428,492,
a774f20880bdd82b0e3f75a6e8784a9d,956,FALSE,1721,765,Dire
f2e8ba48f5e7a1751f593d97f09e5f0d,662,TRUE,2354,1692,
07719700c32dcfa3f1ecd760a6cc8013,486,TRUE,2064,1578,
f5f3196daf6cfe7decb8588417f17a7d,2005,TRUE,2544,539,Radiant
864f040713de0a1e462a9acfa50d7aee,2512,FALSE,2643,131,
8f7de871663916f664cd4e779d426a05,756,FALSE,1608,852,Dire
e0f37aea5541098f427a22689babb61b,1357,TRUE,2659,1302,Radiant
22a4f223372e08048cf29e461042172b,272,TRUE,1610,1338,Radiant
04fb4e6d290b0f387e45afd9a7467f36,1001,TRUE,1616,615,Dire
47422f4bfd8a7ab51a092fbbc50322a9,2028,TRUE,2260,232,Radiant
00fbcd5772ae2608cf09caf7e115b298,906,FALSE,2232,1326,Radiant
060e1069b86d6c6421b179af5d13c058,252,FALSE,3097,2845,Dire
23d9bdc5155c85cab3a84ad8f6c0ae9d,1771,FALSE,2155,384,Dire
90dc9c584d3d017f126ac64d888f4885,2288,TRUE,2638,350,
0179bfddce72134e931a05d23d6c8982,446,TRUE,1737,1291,
f2430468c081bd04366d2d5a78e934da,1123,FALSE,3026,1903,Radiant
564bd59e7d58d5a6368a7d62585a3c42,2113,FALSE,2321,208,
15ea2b615a099e62e9df531f40a571f9,783,TRUE,2490,1707,Radiant
9b8902807483aec259b43b05f66756f9,1452,TRUE,1551,99,
275f4bf74cfa58d056b8fc54a06afd86,2055,FALSE,2590,535,Dire
2e5b885753505733f218071a1bb62c6d,444,TRUE,1076,632,
18e562563efa4e1b737eb217e2d62b0d,377,FALSE,2674,2297,Radiant
69342c7ff590f97370b7eb6cb55081b3,1128,TRUE,2947,1819,Dire
3eee4400876cf0051dafac2d5f3b365e,347,FALSE,2228,1881,
b07825709d71c943b1570f996fb105e8,185,FALSE,2899,2714,Dire
c6706fc09b01c50bf59340d3ae13cbcb,2254,FALSE,3062,808,Dire
b93baeaf5f1bc5ce88ad239744ceeda0,773,TRUE,2542,1769,
8d9b1f0cf7fa881a81f0190de5fdd65e,1526,TRUE,2513,987,Radiant
3f3dd67ef9ed5a4887a6ea4b5daa280e,48,FALSE,3009,2961,Radiant
61e8b9674ae9d86c444ff30d8ab47fa2,563,FALSE,1882,1319,
177ae3948b39edded6696e3986d2cd34,236,TRUE,1895,1659,Radiant
d2950bb985732970c83d15cac56f5aed,543,FALSE,2289,1746,Radiant
a9475ee47c8a10d6cf37c1461814653e,2591,FALSE,3375,784,
7487913920146f7b3d4af7737a3b5efa,375,FALSE,3120,2745,Dire
ffe401e616468f17373ade34c1606c65,514,FALSE,1745,1231,
42967f08c01a1d37f33ed9be1b4c4b86,517,TRUE,1402,885,
34483a018904435474780ef5da822d9e,1081,FALSE,3021,1940,Dire
39e78d25b2e2dd45a79d779d52497828,56,TRUE,1325,1269,Radiant
328354a135976d9d41f59d7995e99bb1,3307,TRUE,3351,44,
8bc11d1d7fc01c7a697f40cefb63d213,2402,FALSE,2451,49,
024784633385b5a46ff423a02ae076c3,358,FALSE,3161,2803,Dire
8c6896605dacc9d75f50fdce1d5f618b,337,TRUE,1480,1143,Radiant
d3e97975590de1f21c72833934e0a2a6,680,TRUE,1620,940,
8df158858b999de6aa20d65b08dac6b8,146,FALSE,2114,1968,Dire
34826fb8432e4ae09c190b8797b4be88,2401,FALSE,2454,53,
cf2ace78414869ad08911b93f90e223b,3570,FALSE,3863,293,Dire
fbab1999edb5ed9e588644d9ecfe2ffe,2353,FALSE,2636,283,Dire
feca8b7a5ae8072ee5a08820023a2b7b,653,TRUE,2876,2223,Dire
f5d08b524cd9b91db16330e92f0f7b74,2254,FALSE,3672,1418,Dire
c550c8128b7c2c0ef40394b42291b857,182,TRUE,2342,2160,Radiant
0c0d1a8fe076202746eb9f02491baac4,1658,TRUE,2724,1066,Dire
29347f255f1e5ed835ee3e172ce0017c,688,TRUE,2202,1514,Radiant
ea4ad9958fb8d6864e0401ce04b9e4f3,1101,TRUE,2132,1031,
5fd8029724bc8dcdb5194088b390190f,1405,TRUE,2268,863,Radiant
cba0ec679d15ef842321370df94b65e4,2460,FALSE,3390,930,Dire
da5db302901dfad37006b6515f9bcaaa,983,TRUE,1922,939,Radiant
5ff1e27ffcc9facf01de874ded331f35,2283,FALSE,2701,418,Dire
b86454235c4b7bb9fc932b87cb6119fc,551,FALSE,2110,1559,
bc364eabc8efce20a95933b47f87878b,207,TRUE,2320,2113,Radiant
300a8342bba31040d15627357c2512d9,751,TRUE,2077,1326,
e0a8370cbd083a028b46c07b9a6c0700,627,TRUE,1354,727,
324218ad5dd6780d50adb187b11cff98,2927,FALSE,3542,615,
1d0aa1b33ac081ffdaefaca841add1ce,1874,TRUE,2028,154,
924412ff47c8147ad99d121e625f87a4,1700,FALSE,2002,302,Dire
0d132c1467d92029541c2a87a021fd07,635,TRUE,1940,1305,
baf837fee0dc8e716447b1c22ce4efb2,836,TRUE,1862,1026,Radiant
dc27d5296f63de906635cc9a329ab5b0,2099,FALSE,2702,603,Dire
f555ea4e75549ded7e860ed5e9377475,1699,FALSE,2105,406,
a2aff3b8d7eb98fe8ec857fdd64526bd,426,FALSE,1337,911,
3d1b2d7844dbcbf52246748c6cb626f5,495,FALSE,2321,1826,Radiant
b76aeaeb12de936c23caece66bc572b1,1264,TRUE,3032,1768,Radiant
1519d01eede95b72407a880605d42782,1155,FALSE,3100,1945,Radiant
5ee80a3778352128deda45ba835ef30e,977,FALSE,3800,2823,Radiant
0fbe64e539d3bcb5558c920463180e34,841,FALSE,1906,1065,
92277397875f07f0ccef07f636bc9328,396,TRUE,2050,1654,Radiant
0c90f58596750678a7b318044f50f687,1081,FALSE,2088,1007,
fea3794ba704009b7f25b89d88521185,1221,TRUE,3506,2285,Dire
018dfb63c736618f71eee410a328e02f,1263,TRUE,3800,2537,Radiant
88c152da211dadc873641350c87e26c1,310,FALSE,1310,1000,Dire
1642491040ac47e52957b4ea974ff539,523,TRUE,3712,3189,Dire
07ac71ccbe4f441d5ace8a59b53593a3,2450,FALSE,2803,353,
334eb104a67f1e2e307779ec1b48f770,3848,FALSE,4003,155,
4ef13037e349c8cfec7deef206c67764,1631,FALSE,2489,858,Radiant
5965a791543468135b11075a50e669d6,900,TRUE,2825,1925,Radiant
17ef2042caa6db522d74914f276cade9,1933,TRUE,2566,633,Radiant
73cca3f4b103c3fa7d4d807d68e43ebe,2301,FALSE,2745,444,Dire
076f3b85426914015ebbf36a8d857ab9,719,TRUE,2014,1295,Radiant
61fe55ee9b4f26b424a96df662f173df,359,TRUE,2208,1849,
ca9a378becdbb8e683a50e83a07ad8de,2585,FALSE,2774,189,
1105435ced9a696359e661f94851686d,887,TRUE,1840,953,
50d2fb7ad49e5501293483522f4fafea,707,TRUE,4228,3521,Radiant
82c7079011378936142700027c21f647,549,FALSE,2175,1626,Dire
dae29579950743ebace85890144e25aa,1195,TRUE,2638,1443,Radiant
40c3855d1b6908edd4503a524ec60b31,233,TRUE,3961,3728,Radiant
6b99e2e9fbf1d369c31e3fdcef53d4d2,2465,TRUE,2829,364,
c2422ae94493763a807385d73919fc5e,575,TRUE,2134,1559,Dire
23e0e22393d193005623dc1aedd2f239,1378,TRUE,2259,881,
e54dd1568e57cb42f3be4e9a2f824f8e,835,TRUE,1477,642,
297a060bcdce7c3b4ab188c61c76af5e,1840,TRUE,2637,797,
9cb1076576478c43818783aad508e071,2382,FALSE,3381,999,Radiant
4dd418dd4930820172fc956256f167d6,2261,TRUE,3158,897,Dire
b19aec9017cf0ad2a1c012c21fb86965,492,TRUE,1530,1038,Radiant
9a86799e27b48246e1a20bfc4441566e,335,TRUE,1653,1318,Radiant
e02f2be35134318bedf489f3c97d8ee8,738,TRUE,986,248,
39a7b1b1329b9b9597c7a33873e9e344,389,FALSE,1499,1110,Dire
aeb261f216d2018da81bd138c1836f33,856,FALSE,1415,559,
83f48648e4b68ac4345ad7a886fc1d13,1268,TRUE,2298,1030,Dire
d7f53fd1cf8d07a6ed2f53c8127e90f6,518,FALSE,2557,2039,Radiant
9718d1884148397a34f47de45d8c053a,1326,TRUE,2531,1205,Dire
39dcffa6a2afeb294d8c94d9795fa8d9,1126,FALSE,1740,614,
caecda1beb50145d958824326e3425a0,1719,FALSE,2787,1068,Dire
f2727a10cded06d5b7c4cd5f3ad56030,1026,TRUE,1936,910,Radiant
4fb6b4ecfc29ebdc6c5ed859c428c210,93,FALSE,3151,3058,Radiant
adc3a13bcccadad9959a598dbdb6b7ef,2171,TRUE,2574,403,Radiant
7148889526643bc718b0050e5827b1a6,2260,FALSE,2755,495,
b6dc455991c90819930954687a9a8911,1545,TRUE,1973,428,
bcd738f1164a74ec9b597feac7f121b2,388,TRUE,1824,1436,Radiant
3d770bd39324a47827afee6d3c87a300,1803,FALSE,2070,267,
048cc44d6c146ce3941d8093bbf18c1f,1649,TRUE,2339,690,Radiant
11504ee3d03831938157a2b5108b3dec,1905,FALSE,2296,391,Dire
59dc0a49a6e8c9d4476c72d14c46293a,205,TRUE,1157,952,Radiant
deb0eea5c79b547e83dd78a52741a0ac,1452,TRUE,2208,756,Radiant
6fc548e5ceb9d5508e869b8da3f5b11c,818,TRUE,2117,1299,Radiant
85c4ece3ef5d853c5b6fe8695431bf28,1985,FALSE,2280,295,
014407fa4ab382b0a6ea672ca5e6f812,1675,TRUE,2490,815,Radiant
341c7cb87a9f11be4da6b5bcfe9e25c3,539,TRUE,1470,931,Radiant
28aadd77a2ce6f53e13709c34e79f770,488,TRUE,2499,2011,Radiant
47544e6d391a8b2bf0f0de04630a8742,302,TRUE,1347,1045,
c102cf0b22533a0a801fd3889c08c90d,558,FALSE,1301,743,
f62a50b535bcf2b36f8d886d33574130,400,TRUE,2332,1932,
c7ab166ef84ab13a15b58673a8b5affa,1227,FALSE,2743,1516,
61fb616317ca304f89fb652acd12e310,409,TRUE,2408,1999,Dire
6129887f132dbea8936fc5fa0106d8a1,2478,FALSE,3007,529,Radiant
ae20f7e6cde259ba4894767ea3f4675a,499,TRUE,2496,1997,Radiant
6ee0199d4b79bbe33b547b484d5be2be,1478,FALSE,2300,822,
781a4ab580f9a6f4da23ad8d44e7d759,458,FALSE,2845,2387,
81c257973070b7d283bfcfc3c7e5933a,606,TRUE,1569,963,
80c5bc01ec2fdb82d3eb621ab966659b,2483,TRUE,3077,594,Radiant
8be6ecfac9acba2d64b9d24845426d13,125,TRUE,1927,1802,Radiant
094ca161c5653fecd8776a782439e17c,1461,TRUE,2461,1000,Radiant
68a67e2e868c9c4436f0fb6602ca4e06,1061,TRUE,3769,2708,Radiant
b9994fa696810dab26ea6dcd42ef8de2,676,FALSE,1100,424,
167a4b42786710efd0840be32b70d8a2,879,TRUE,1963,1084,
09371173a624d137c634786fb2824d59,1117,FALSE,2868,1751,Radiant
6e7d0b8c2c4d4f5d4d8b673285bcdff4,822,TRUE,1078,256,
e2e2460bb8aa4d1bfa80f8981196c0e1,1631,TRUE,2413,782,
3da106b70a104fc815cd5123527c1fcf,1103,TRUE,1868,765,
578f9e9b6ef0d932a5765cc6ffa11742,854,FALSE,2121,1267,
a683d52c174cbcff7ec8f33e6968c124,458,FALSE,1959,1501,Dire
4434ed760f7680154ede2845c461ebc0,1077,FALSE,2571,1494,
a2d4ebaee88de3f9cead1363fc069614,285,FALSE,2616,2331,
c6366c5a8fd5cb6aabd9f765fd601dee,423,FALSE,1454,1031,
34b15ea7e39bd7e3d94d8a903a184191,481,FALSE,1334,853,
9ad61a24efaa00a93340353884941c18,558,TRUE,1738,1180,
74892147dc731ca3ebc5e291623bd21e,929,TRUE,2138,1209,Radiant
2307432e99973fc56369dbcb5c4e8c4f,1743,TRUE,1919,176,
3bd2ddf0c2d64d9d764ca3be4011a4ea,273,TRUE,2628,2355,Radiant
38ff5c3395a18a5c0aceab5952e786ac,2028,TRUE,2266,238,
3214709325c2559e9a02b2d75a4ed7b6,1739,TRUE,2023,284,Radiant
be03faf3ba7446cf66e8ffc16ba5d303,1763,FALSE,1937,174,
34d3d182954eafcde6d918c37d3719f8,2185,TRUE,2473,288,Radiant
be99a1a12fa7f430c6404782a178d069,2543,TRUE,2746,203,
f66d9295fcc1989742c05eec4e712472,1182,TRUE,3390,2208,Dire
f43d8c13ab8f70948eccb655d3e3527b,1731,FALSE,2449,718,Dire
aaa9b41408ba1f42c14ed06f67cca081,1086,FALSE,1167,81,
f6527ff28a2130f4e270156c92c76908,311,FALSE,3708,3397,Radiant
956f0a7e95315fc841e228551045611a,704,TRUE,1140,436,
c5eeadcb65e66e300e0994620a9ac63d,1413,FALSE,1706,293,
c7e3fe4499b05c51dd8d8a2f40cf7045,808,TRUE,1018,210,
15e95ae95d29e3f42f58deb7de7d7f78,834,FALSE,1273,439,Dire
d0d6386cd9af94cfcea549a71bf2cfd6,1213,TRUE,1521,308,Radiant
270002ccb7d060c9d6790fb5c1bb79e9,1165,TRUE,1871,706,Radiant
96b6be83213494dfd3f5d9f47e9180bd,2411,TRUE,3102,691,
283548bbcdc344769f7d13d5ea5aa2e0,2835,FALSE,3403,568,
ab12e1fcc698a7b42fa273ba4705f198,707,FALSE,2185,1478,Dire
7e8dc4a5790bac48cf1ae296bd1776c6,884,TRUE,2394,1510,Radiant
42a7de396238d8f37fc54fbf082aa32a,1444,FALSE,2507,1063,Radiant
a391024023fbd2fd6a2af435acd6371d,2070,TRUE,2808,738,Radiant
0186f319fcc13fcde58dcd20e5084d66,2519,TRUE,2964,445,
a186d8df1412776c6a9d86d918580191,735,TRUE,2577,1842,
0517dfbf4cd8a0c51b6592daa7c2ed8d,1602,TRUE,3351,1749,Dire
a738fe8d647ad4dcb1090dfa9e8f3ac4,568,FALSE,2662,2094,Dire
2578beb8a0a3eed47455a5ce4e6c2ee1,1124,TRUE,2183,1059,
d8e4a575768b3d877f2160edfab566e4,1301,TRUE,1594,293,Dire
4f67d8a4674dd02135a04c50f5a1055b,712,TRUE,1906,1194,
a71708e1d456cffbf3808d25558afce1,1793,FALSE,2143,350,
a19d92f0c93665468d9790a8196042ab,57,FALSE,1537,1480,Dire
6ece6516372cc54e2167feee48aae282,327,TRUE,1223,896,
8c2a521ccfe377542fe390092abf6ec6,2378,FALSE,2519,141,
cac0a324b605f528deaf34c5447ad02d,195,FALSE,1862,1667,
72da1b8e660e555956fcb2a20187b76c,2394,TRUE,2581,187,
d9b9c25a582faf6789a8f9f49c5ceec7,492,TRUE,2207,1715,
b451fe1738e52927021f5f974adba6f9,257,TRUE,1991,1734,Radiant
b258e08c489eff3de9fb59a76d8981be,820,FALSE,2829,2009,Radiant
73cd66b83f00d16741c8963cf24a8a1f,2068,TRUE,2170,102,
b984f81724eb22f4c3f69f080df25d47,519,TRUE,1593,1074,Radiant
7e1898f918266edff56519887812ae04,890,FALSE,2008,1118,
aa6ce3291e22d46872e14cd9a1abcca2,764,FALSE,2944,2180,Radiant
5a2f07b0c45dca4c7913adc16f1a6326,650,TRUE,963,313,
6e9feb4e086cd99f69d5daeb269193dc,1181,TRUE,2052,871,Radiant
f7a3a62e2adbf4313456ef811c24c7c3,658,FALSE,1868,1210,Dire
09bdc81a568fda5b6ebfaa3b93e2d4d4,1335,TRUE,2446,1111,Radiant
ee2ccba12b821c23ad88e483a93a7d2d,11,TRUE,1615,1604,
5ba589778c4634b01ed26b3ffc71ee2a,2294,FALSE,3163,869,
5b18e87af8c3d28f71422bcd59edbacd,1937,TRUE,4054,2117,Radiant
19f61724e89cfc82927f60cfcbe36f1c,1764,FALSE,2441,677,Dire
94c589f1123e39b2cf77d5391cab2c08,1534,FALSE,2174,640,
2a9f364a73cf317afec7b99f6236af9c,926,FALSE,3391,2465,Dire
dc2c36b5b0c0c42b07a942adcefb2ca8,72,TRUE,1179,1107,
6cbbf4ff1678e451da862de12263795d,630,TRUE,1164,534,Radiant
15169b374c02676b62fdef2a5e728bf8,143,FALSE,2487,2344,Dire
591b8609683e573ee4132678c9cd68a3,2801,FALSE,2916,115,
f03fab677b637dfb62b94a956c74fc7b,207,TRUE,2240,2033,Radiant
ca6d226f2a62af300a894f510ba0e681,3449,FALSE,4086,637,
ed85e2d4c60851b6476ca0f27eb68b3b,418,FALSE,1913,1495,Radiant
9cc4991a4551c8b53d2e7d127429f10f,1504,TRUE,1699,195,
51ffafc28f22c377d99c43c7b3ab2f08,342,TRUE,1817,1475,Radiant
7a3765df425df4241a0b6f6447cd8268,3298,TRUE,3733,435,Radiant
bd7643219d2e945ad055e551e23d2abe,785,FALSE,2492,1707,Dire
7d22feeeb01fcb46d531eada5be9f5e1,835,TRUE,2368,1533,Radiant
c9aa3d4e634a0592f744566696915e1b,2411,FALSE,2632,221,
be277bbb224147fd25a4527f4ed401a0,357,FALSE,1968,1611,Dire
c4baf024b7433a9eaa46f024f41ec799,657,TRUE,1659,1002,
088be056aba1d47404b9fca992771393,958,FALSE,2323,1365,Dire
92733b11d4060e272da896242a521e3b,216,TRUE,1915,1699,Radiant
cb424fd12f87a252636d854cd563160b,1908,FALSE,2136,228,Dire
824aa9110b569d461ce1abe75f087464,1346,FALSE,1925,579,
0b24eb3def5cea7c43b13cbb665f5f7a,287,FALSE,991,704,Radiant
d324e78743acd2d2fdee38846ea718c8,1737,TRUE,2392,655,Radiant
cb2c7a5f03715557e2ad228e1ac49da9,1450,FALSE,2044,594,Dire
d8ec0f834cfdc2a6094d4b7f7fdaf11b,1938,TRUE,3402,1464,Radiant
b3e1fae3b2c45bc95b41215e6321c66f,1542,TRUE,2113,571,Radiant
26daeee6f7af55de358e022f01814b8a,1588,TRUE,1681,93,
dfca9d0e952d3bec04c85801bda2b3e2,492,TRUE,2085,1593,Dire
b69b650aa0f2c69c39ab367a0eecf6a6,477,FALSE,2661,2184,Radiant
6c475bab49c68913a13cdaff3bbe9a17,2615,FALSE,2742,127,
907829f48122f9a335ae7ad904d4786e,403,TRUE,3110,2707,Radiant
1e9395d45427c21df481c34c595c37cc,401,TRUE,2070,1669,Radiant
c1d98ab1947cf250d337096bb9e57735,843,TRUE,1015,172,
ccff70a4bb12bc5390bf5af60cdac64f,3239,FALSE,3323,84,
0e7f9a6b94dc54215ecf313bb27081ee,1411,FALSE,1613,202,Dire
627a90c0690d82dde8609515f67f175a,590,FALSE,1921,1331,
d23897685e83fc68ce4435204c404358,299,FALSE,2507,2208,Dire
03a06a5255186f17b133825e4ed84e22,1808,FALSE,1967,159,
ee26085977864c544b563a012b12c947,242,TRUE,2022,1780,Radiant
a6f39d5368f9f90ca1d402de7da14fa8,1297,TRUE,2125,828,Radiant
db7184e2e2629b0b4707acb1e60083bd,1223,TRUE,2281,1058,Radiant
338b444da9b89cd1f88171c3fd47cd98,3439,FALSE,4009,570,Dire
8c744a3adc39342a64998541f6640e44,253,TRUE,1911,1658,Radiant
72da3ab197c057c7636049d93b0a2de5,311,FALSE,1751,1440,Dire
dcc6665110524cfad23cee1026785830,503,TRUE,2232,1729,Radiant
ec260da5813a52a5e7be5019d048ed2e,629,FALSE,2574,1945,Dire
c8ba1493f19f9c178e8da13780a0355c,1983,TRUE,2659,676,Radiant
c3a98c49f49e5263b62e956f39edd4eb,722,FALSE,2098,1376,Dire
fdd1a8fdbf67ba6d143461c140b6b811,818,FALSE,2629,1811,Dire
9581b335a411d4eb2274d3ff02a1cdf2,1092,TRUE,2331,1239,Radiant
ce17def6c28b487f4988c5b008f0c1bb,675,FALSE,2708,2033,Dire
d493569796aa4cb352f6a3d25f9d2877,544,FALSE,3663,3119,Dire
de7d639e607874cea59b2d389b4f3e91,511,FALSE,2596,2085,Dire
c8e2d05cfc69adb9c7026d4fbd56ca7e,1268,FALSE,2087,819,Dire
5a0825648823e8d4d6ae651bf2f2f811,977,FALSE,2485,1508,
ce5040689436efc738b1e84884391ad4,1178,TRUE,2206,1028,Radiant
f7f7e00bb1e672a33cae7ac611ca2cfa,1488,TRUE,2765,1277,Dire
5bbe008c1d13e8062a45b3757145b7f1,996,TRUE,2908,1912,Radiant
fab01f81e7f7cb3498db13e5d8989732,425,FALSE,1606,1181,
6760a0c9960cf1a4949aea2b7f11f487,1257,TRUE,1987,730,Radiant
a2a4a5e580eb7ed9e3f58f116df6991c,487,TRUE,1714,1227,
ef2986439de279c498588dab21d70945,2032,FALSE,2824,792,Radiant
ed327b1a5f3e67745865936c93ae7351,565,TRUE,2511,1946,Radiant
2577000c8b66055d164f598b2a814411,618,TRUE,2220,1602,Radiant
d6f288065b0f71453c67e88a868fa483,838,FALSE,1259,421,Dire
2483ce808a3815cc5eceb14562d55811,1922,FALSE,2063,141,
1f03fc0a7d951f41f1b3f7dff4d1b2e8,1548,TRUE,1716,168,Radiant
9c2dbbb2cdfd460994cba278e117d248,224,FALSE,2537,2313,
c8ab46141507d068ccd2fc0e2194a74c,2047,TRUE,3077,1030,Dire
415d39b21adbb17e48226776c3c72e81,1303,TRUE,3127,1824,Radiant
d76f05ff6a8b7a9ce287c2fd611b6c14,1716,FALSE,2038,322,Dire
8e9b87f4c6ccf3e83e644184edecd55e,179,TRUE,1431,1252,
72d9be478b0889bc10187993341e780c,57,FALSE,1617,1560,Dire
f740acedd19ef4ba49fe615273c09d91,776,TRUE,1100,324,Radiant
57da712620e858a4ec35f6a48ec4b9d1,1065,TRUE,1953,888,Radiant
167809ff8585ebaec93a0a20efac1a06,392,FALSE,2155,1763,Radiant
d6516b362a4577938a7522944bc3d4d5,1184,FALSE,2535,1351,Dire
3f5d71d5b721db3ea5d50b388c2876cc,1374,FALSE,2193,819,Radiant
b91ad5a04ae872cbb01374ddf84e5828,1661,FALSE,2517,856,Dire
40fe55895b43c3b2da0aef856178f1f1,1631,TRUE,1951,320,
4d96747cccf4cd3f186f4a63ceeaebbc,962,FALSE,2313,1351,Radiant
5676cb187a6b22baf2c854ec8e334e70,1473,TRUE,1878,405,
5894e0893a8bd1683249df08e8a154e5,390,FALSE,1676,1286,
36126946accf5b27c1f1f11296968030,2748,TRUE,2780,32,
31e71232551234fad28fba6e6098a560,854,TRUE,3069,2215,Radiant
dcef6c6e56e2915ae30f8c4963005877,1942,FALSE,2603,661,
7da13c66f8718e798933cf8b783f0184,1318,TRUE,1924,606,Radiant
427c2abe8575a067498ca4d4fca0ccd6,2120,FALSE,2925,805,Dire
0572138ab4a21e53239d46805d36a78c,1228,FALSE,2235,1007,
426e3342a9254a0b050882f8c114a866,1466,TRUE,2776,1310,Radiant
ff82e7df04197769e6e121889c5d24fe,648,TRUE,1834,1186,Radiant
9b5c6ae4d9b4412199ee89f08d60f8e0,1407,FALSE,2206,799,
e845d6ce27b85f22fcfdf15df152d829,3088,TRUE,3142,54,
22b666513fdff9ae147c4807f04ad37e,150,FALSE,926,776,
d9b4cdfd7b1584e70e00158f2c75ae3b,195,TRUE,1874,1679,Dire
12e79f6188c0f4c5f239c72870e243a6,531,FALSE,1575,1044,Dire
88fee78fdd44f5c08b789afdc974377f,969,TRUE,2422,1453,
b848e4efc17c35f53839e450cfe37d67,945,TRUE,1311,366,Radiant
58e109f855b124eef1356e2d6aa022ad,886,TRUE,2312,1426,Radiant
1e5d05ddb01906d4b203328825d7947d,1896,TRUE,3062,1166,Radiant
7e532f3ff3fced42f53fe625c803fab5,1014,TRUE,1830,816,
94812d22018d726850fb726247ede247,427,FALSE,1811,1384,Radiant
29e855dc3ad2950b09c55a0ade243eeb,1771,FALSE,2539,768,Dire
6dfde7a46c62f8b7d698de2ab6ad9afc,218,TRUE,1623,1405,Radiant
f570ab878de534d1a000a6ce67692554,920,TRUE,2389,1469,Radiant
46ec266091d6b1cdebfbd8cf2f3dc263,1924,TRUE,3633,1709,Radiant
30b0eb5228126493a910c52e00528b9d,1439,FALSE,2593,1154,Radiant
87944f08fb972f89a69a7b0f9a3e8485,1325,TRUE,1495,170,
a6e4d7c4e88aafc10c228f09f06375b8,1419,TRUE,2827,1408,Radiant
8819ac4be87ca05e66374542a0c8a551,886,TRUE,3518,2632,Radiant
ce14984fdd60cf2213c612f28958c784,1252,TRUE,2047,795,Radiant
c72142441d061f214f30557282fb4250,1284,FALSE,2627,1343,Dire
5fc8b6016de8a7f8b6aa9b06c4bbeb49,2267,TRUE,2507,240,
f1ad6c4debc315132a22800d5929a23e,910,FALSE,2331,1421,Dire
2da63f42ae9de15b252657b47b0d7d0e,1127,TRUE,1643,516,
4ba0d23a6f7319ade036411381314980,1612,TRUE,2435,823,
9050b9583f750ed9d184e98d49660903,416,TRUE,1239,823,
91953404da87610e5d3fe30dee54f73f,496,TRUE,2678,2182,Dire
d9d7c7a4ae963f3333d421b444562644,2354,TRUE,2868,514,Radiant
36b2e08045d45b1c26e42eb604e784ea,2664,TRUE,3644,980,Dire
3eff0271432c6c0da9befea54e93f5af,637,TRUE,2349,1712,Radiant
5be8056c64ea838d507b72814fe3478e,1670,FALSE,2486,816,Dire
4d3aea1d5cea721df9f8611e18e4af2d,614,FALSE,2856,2242,Dire
7303dc3988b183b99804df6803376678,2618,FALSE,2723,105,
b8948ac384a556789958103c2a3e7d33,1292,FALSE,2360,1068,Radiant
9c05fc3f1e0de66c1dbc934103790382,993,TRUE,1865,872,Radiant
c14a8eb169bff20a697af0601b7091b0,754,FALSE,2623,1869,Radiant
cd41c70c26c9f37b87a4088c726a6f82,996,TRUE,2462,1466,Radiant
b08050f58ae7725599fa8cb69908451e,1307,TRUE,2436,1129,Radiant
593ef4c9037ada1918f3f8b573794946,14,TRUE,1628,1614,
978d8bcfaa3b93865b83a70ebe1a7f41,94,FALSE,1702,1608,
d7042c147e9204cffbd69fe4438038c1,227,FALSE,3068,2841,Radiant
1fc3121c6e1f86caeb65fb58b48f1b02,1173,FALSE,1464,291,Dire
8027ba9eb467d3a86d9b7e1cb9de871b,1155,FALSE,1192,37,
5da52371a547641f8aa369c856a756cc,1365,FALSE,2511,1146,Radiant
7be8c35d5a44e05d99d2049e972b8e0b,635,TRUE,1701,1066,
e7c88d36932a490de2a1f358cd0fb7b3,1812,TRUE,2185,373,Radiant
9a542af768082b1adf921ae8bff76a2c,129,TRUE,1402,1273,
35950b0916bcb7e9d2e69a7eb9dc5b4e,1702,TRUE,2089,387,
3ba493eb9ed23431d68c1aa36004cb9e,2108,FALSE,2510,402,
fe6bfbd71eb6b72a28c098d6f0463c9e,1541,FALSE,2270,729,Radiant
d245861997ed8380c8c2fa34253f9319,1,FALSE,2958,2957,Radiant
c07b4e4b3a0a29472b6b841776381df5,1082,TRUE,3914,2832,Radiant
a931dc8a913a7aa432323569f63eec1d,353,TRUE,2647,2294,Radiant
c7697bbd5bc97303dea65008e9c7cb9d,1926,FALSE,2015,89,
2d0dd857d4b4f58e003965bbcf339829,2752,FALSE,3076,324,
b57a6d120aba35edcf56dc38089ee8c8,2777,FALSE,3133,356,
32ae457bc3aef9df31670a3613cb4dd6,2247,TRUE,3416,1169,Dire
1e6bbad67551d8e130455ad580c1c70f,434,TRUE,1760,1326,Radiant
d29a4c59396f893acff81e03d3f48f76,1681,TRUE,2650,969,Radiant
5452e6875c889ec3b8fd81c3a1b08900,18,TRUE,2900,2882,Dire
dcef4a488f6b217501224a56eeaea937,2424,TRUE,2598,174,
b9b0b65f490d76640c791355633dadae,821,TRUE,940,119,
ac573902212de04454866551a037d801,4335,FALSE,4718,383,Dire
857ab180a4b3536487062fd8d70d50d7,1749,FALSE,3217,1468,Dire
e99b000766ec8f9523d13d6a875fc6d1,1952,TRUE,2309,357,Radiant
03aeff7035317e8ee7cd1ce702d3965c,2457,TRUE,2687,230,
fe2eaff52db45a3f1cd411a7e0e9bbb7,49,FALSE,1947,1898,Dire
7fb41d7e68c4db72f5675fa7fb6f9842,103,FALSE,1538,1435,
57277a9ce5aae4ae2a6d3857f43d8656,3505,FALSE,3821,316,
d4c944021dca7ab991377fbdd0ab90a1,2062,FALSE,2947,885,Radiant
2b8ab638f3c1ee4f7a37da5aefefad62,1970,TRUE,2196,226,Dire
6d8a3b3a5efc235051153da6e7a3c559,113,TRUE,2401,2288,Dire
eced829ce3b5739e0614c36c750974a3,1161,FALSE,1724,563,
9d81152a95b363ee84a15cf74e14b330,915,FALSE,1707,792,Dire
5e43987d252b9cebac2926c6da5081d1,519,FALSE,971,452,
9a0c76ab24405fd5c1c7741b0857a6ff,1097,TRUE,3504,2407,Dire
df8d651a277f3987277cff02166fad09,1024,FALSE,2275,1251,Radiant
ddefb00cc912015bafec5b85309af626,1132,TRUE,1423,291,
fa6056c2413c79ef68a568f746a2b601,2325,TRUE,2497,172,
9c5c45c5f884c8edb0353419cb0f3d8a,472,TRUE,1400,928,
f181c911de9036b676c2ef4270bffa1b,927,TRUE,1746,819,
b3de5e6a17f17289cc906e36588578e3,972,TRUE,2635,1663,Radiant
83563127a400df70c7c73c783f4799cd,482,TRUE,1050,568,
7374d27aa89f98e110644467c19170ef,1164,TRUE,3170,2006,Radiant
01bc606b982544f59ecf14a6d30f36c0,762,FALSE,1910,1148,
83a2fb952efe00cc2dcb76b673882410,1073,FALSE,2535,1462,Radiant
b196c5040486a733003c04afbb89c48b,2051,FALSE,2828,777,Dire
cd5c58daa076cac896f8bc6b3fab47d3,956,TRUE,2375,1419,
317650c454508da6df533a491a1383af,2482,FALSE,2967,485,
ab58e348c50473f98e5b0ddd1f030d14,1253,TRUE,2189,936,Radiant
eb210b01ea46c1927051e9e700e8353c,1393,FALSE,3416,2023,Radiant
70a1d78bbab0f7adf10e1995d2d89fc3,286,TRUE,1754,1468,Radiant
aaeaf8570c4a3b5191be717bf36f7fcf,1100,FALSE,2186,1086,Dire
1b1c50679c683939a547277a3f14b081,1288,FALSE,2973,1685,Radiant
2f33480099df3df1e48b2f5eb9fef9dd,2699,TRUE,3311,612,Dire
c7da8a7d9c0c30b3cb06d869a8f2099a,1955,TRUE,2410,455,Radiant
367a8efaa07a0a386776687589fc0617,728,TRUE,2941,2213,Dire
7e70b28d26dce7d1bc174d807ba68f3b,318,TRUE,2628,2310,Dire
8528efc5e9dc8292a5b5b012fda60f92,2367,TRUE,2501,134,
e74aaf78427c9834c0711e6e419c781c,317,TRUE,2240,1923,Dire
f6af3981b00e2b6ba97c8ab46cc0a440,1850,TRUE,3564,1714,Dire
9d8a10e70da942d6a824dc63f629b98a,469,FALSE,2815,2346,Dire
176842f998333c173b6ae13fb849c2a3,1335,FALSE,1926,591,
22d8d50f12ccc86690b19a817fec98b9,1487,FALSE,2775,1288,Dire
c3af3b7f9b65499365deff07a1dc02ca,2093,FALSE,2228,135,
c905f00e94f2f6f3e002d1724cd3a6e9,2302,TRUE,2662,360,
26e88bf318dd9d8ca03747ff750e8356,1463,FALSE,2044,581,
121aecc6318c84906a130cbd2f5a9587,1984,FALSE,3003,1019,Dire
6ec5036db3eaf746b35ced2fbc82e01e,189,FALSE,1714,1525,
9b4aae5af8c106faa1960b1a465c734a,35,TRUE,2725,2690,Dire
d095974f5780d9bf7c102ee5dce39b5a,387,FALSE,1790,1403,
a082eee5187132811ad2fd52f67d35bc,1871,TRUE,2133,262,
04af5331b5911a1a81ff949036c719b6,141,FALSE,2514,2373,Radiant
eb3484cc38615619399c74b46795a36a,1632,TRUE,1861,229,
84f910b059c9cefd5fdddc9d34a07684,157,TRUE,3548,3391,Radiant
009075a41349a5fcbc2f887d9ab6d989,404,TRUE,1785,1381,
e07afc3270a87e674af9125facf9a275,2893,TRUE,3286,393,Dire
7cd1a016b848c765979b031beea01cef,928,TRUE,2838,1910,Radiant
31286f53d7d6561cb038a0f704d697c2,2136,TRUE,2211,75,
9c522e98e58fdeab6d75c3261a68b59e,297,FALSE,2166,1869,Dire
d1998dc56fc70c47ae432c6e254fa431,590,TRUE,2375,1785,Radiant
6d997cc81e6df2aaf4d17382e5b5fdf3,435,FALSE,1493,1058,Dire
83e5b68b716e96f78595aeeaac95dd37,1167,TRUE,1918,751,
5b822ff68b14c42ab6096aff2f769bb5,899,TRUE,1906,1007,
330404f5d00e185b7f6cb7f23061a580,205,FALSE,1700,1495,Dire
8a488178e01ac8d078f306397e0cf3fa,467,TRUE,1479,1012,
8e0d2f9be67f9f63c75a911872a42f44,264,TRUE,2586,2322,Radiant
2bae8b6129139636a66338b3ae7ee2d8,2189,FALSE,2833,644,Dire
fda4d2cc15f87f8620d07c67cee1868a,492,TRUE,2143,1651,
fc1d6b90c14d865d52dc45d3f3b0a148,1429,TRUE,1737,308,
8eec36dbd529657f0c0192f1a56b28ab,1121,FALSE,1982,861,Dire
f604fa831104865318c2e10db9c8cd07,1779,TRUE,2194,415,
aa9505311811f57222f07cf014be534c,706,TRUE,2544,1838,Radiant
3e3cf8a627147b8317241b50e40101fa,710,TRUE,1445,735,Radiant
d3a2afe0d8895af906627e6a09c4f700,59,FALSE,1274,1215,
63e3edd0cf050ea83e1539c8f8157b42,1651,FALSE,2065,414,
c5a9cf7edd40b3233d0ed647206b647c,818,FALSE,2633,1815,Dire
c1d9e7f0596940be6b64fc53094e597b,150,TRUE,1789,1639,Dire
2ffce6ba880cfa8c016e52601672f15a,1301,TRUE,3455,2154,Radiant
f05c53d7c3e0fcd20d79ce2d3077a5a2,1519,FALSE,2336,817,
812b1872717c75efc4335b4b827105f5,115,TRUE,1883,1768,Radiant
c61211902a1a7205c0d852d6972a8250,84,TRUE,1960,1876,
4f13a5ae0bc546a55637b95af35ff268,542,FALSE,1801,1259,
1a405dbac936aeff405ab983a03dd827,1732,TRUE,2660,928,Radiant
6b05b039d8174fa23178462b8359fe4b,1053,TRUE,2113,1060,
256e0bdf80d63ef5ef9d7a0bb49f3ef5,287,TRUE,2168,1881,Radiant
a963f257b7e40748ee2a0b8282753bd7,2490,FALSE,2893,403,
49ffc5a7f8832a7a188e527096bf824f,1559,FALSE,2452,893,Dire
30f9f745111ea6bc397fbf7b81a9b136,1583,FALSE,4268,2685,Dire
295fd67e56d3b2e12cbef3359ba43ffa,1276,TRUE,2397,1121,
99d60dfd33732d1cc2f535061d003e86,730,TRUE,2591,1861,Radiant
e597f98d985db1296858a89e8c981e61,1060,TRUE,1477,417,Radiant
f787810a48b23dcc0518a6b1cc6e773d,17,TRUE,1757,1740,
61192b1933eea2d45e566981d347a78c,1462,FALSE,2047,585,
20eda47faccd589e93ed561ad03e1393,533,TRUE,2096,1563,
20ece6e2c277f0134de067695d5124a0,2806,TRUE,3187,381,Radiant
e50de7c54cafc74ab65ed043ca8b8faf,177,TRUE,2665,2488,Dire
6610043ebb69835723d7659f0455a4c6,1287,TRUE,1684,397,
9ec7d98e29eb9541e2561dfb56d24933,2604,TRUE,3371,767,Radiant
5a6bd6802d7e8da06a876ee6bfc81731,854,TRUE,1487,633,
dff0f795d92241fc9a81fde611ec8b22,151,FALSE,2124,1973,
5e33ab6bb3b0cef7c7e41f480ae99262,1485,TRUE,2616,1131,Radiant
d8967014ec21317974825bdaa72b9621,2214,TRUE,2474,260,
14d44b897e18263230807cedba47492a,478,FALSE,2412,1934,Radiant
963378f15c8945f1535fdd5b2b36112b,802,TRUE,1419,617,
f488c8edcd509aaf82ae9e8727b65798,370,FALSE,2576,2206,
63f72f7874165612a9e170c9346d05cc,421,FALSE,2894,2473,Dire
7a33b5d27127cffbc8ebd194490360f3,751,FALSE,2239,1488,Dire
340ec87b12197f8110705d41c6ff8bd2,1498,TRUE,2089,591,
6968efbc5cc16d94fd7d1bc70f170684,1350,FALSE,2194,844,Dire
880e214c19cae0ecef8d16187cec6835,2264,FALSE,3665,1401,Dire
01956496186841d13200bedf1a9aa83f,540,TRUE,1863,1323,
666853bff533d8239a32cd1a5736de33,938,FALSE,1877,939,Dire
511df680cf89d928f3f6812cfeddcb7a,2315,FALSE,2782,467,
2f5d5067676c409eb530f5d3e90373de,1222,FALSE,2146,924,
5288395335204caf926c0ea6a1f6b01b,337,FALSE,3305,2968,Dire
0848ee58e672e2c6fb3290d61164817b,1421,FALSE,1506,85,
898da759b1c6606d9eb62e5aded15486,731,FALSE,2827,2096,Radiant
62f891cf87d9310b5c24b7c1a982c768,706,TRUE,2736,2030,
3f6aed98cadd9a1fec0e8ee1e454a347,431,FALSE,2692,2261,Dire
66d16bcce4592d70a987e38cc4365abd,1224,TRUE,1336,112,
99666eeed58317a1e4cc62ac812c983d,44,TRUE,1334,1290,Dire
bcf3c42932ba186002629a7114cd5197,29,FALSE,1275,1246,
0e2867811aabc65219018ba4ffc9b760,108,FALSE,1568,1460,Dire
062d3389f5db47b04527b05fabcdbd95,2270,FALSE,2791,521,
8b814f10551cd2ab26f91d932056edc1,2138,TRUE,3043,905,Radiant
120dfc1721e54b51b7e686ba06563464,1667,FALSE,2801,1134,
64696baa5b618a280420879126029a07,1329,TRUE,3050,1721,Radiant
9872028541573a93c21b1c4ed38b63ea,3269,TRUE,3491,222,Radiant
c4f665ee469aa4ff2ba41cdf3e030b7f,1174,TRUE,3228,2054,Dire
6b4cd690a311627eaa5aae4edea9951f,1186,TRUE,1590,404,
0c15634adcc1956b0333a45d01d8bf52,600,FALSE,1809,1209,Dire
7049dcdd9502f313234dcff3eed4ae55,1146,TRUE,2609,1463,
f17173fcf04bed01cfd758b1785517ad,2441,FALSE,2487,46,
23e52e3d4f28dbaa7b5feff7fdc53ed2,623,TRUE,1955,1332,Radiant
ebecf166c9d7012a02bf2d13b573de3b,1004,FALSE,2493,1489,Radiant
7306442f4c88d315a915ce3a76f29c1f,659,FALSE,2508,1849,Dire
51f9e9ef9b663fab82bb7e3e90e88f43,1555,FALSE,2607,1052,
7df5e0d8c4c0b554f9e79cf9372542fa,693,FALSE,3178,2485,Dire
72dbf3bd2f7390d2d506ea720c4c43c4,1832,TRUE,2655,823,Dire
8bf3f6f4f3839ea531c6c4bf5b1cb25c,792,TRUE,1640,848,
0c4974df4b479237a5add9f94cd1b29d,2571,TRUE,3613,1042,Radiant
34bb1413514e727dca569325f76b8063,1490,TRUE,2793,1303,
ac23db66fbb59400ef16aef75b086346,1635,FALSE,2031,396,Dire
01b98f346c4aadafa460dcb962c03b68,1620,TRUE,3134,1514,Radiant
fa496b1d05c4ce269827b2d7b3ed97c2,233,FALSE,2273,2040,
b8ab239e44ccc723f6ef8ab68a746786,10,FALSE,1460,1450,
c97ce1989016e03fef4177e188992b99,1529,TRUE,2655,1126,Radiant
dbfecbec0ae855d30b0048fa6b04bb1a,2079,TRUE,2511,432,Radiant
67f7bacae0de869739b3b51b9e2e0135,1425,TRUE,2272,847,Radiant
13124d35df97cbca9d0924b41105c20d,532,TRUE,1882,1350,
c8f0174d99248f13d045deb89a09ff31,192,TRUE,2547,2355,Radiant
25e8b0b2fd60a3c2e6fae72ee76dcf62,1650,TRUE,2786,1136,Radiant
1d645a6f3fa1971ca0ce01636d7fa3fa,861,FALSE,2097,1236,Radiant
fc99366924bbd250d05a6c34cad13bfa,3151,FALSE,3226,75,
eaf53198a521e1b5052047aa571ed9a7,795,TRUE,2163,1368,Dire
84885fe39c306fb94470f42e88eb63da,815,FALSE,1917,1102,Dire
f14b263abadc753051e8910abc52183d,1638,FALSE,2840,1202,Radiant
a2fca0da92ced27700e489a335660f27,695,FALSE,3612,2917,Radiant
48a0d652f16ec9c79be72504bd87f2be,1238,TRUE,1911,673,
3a9915114af60f8a3191ab46d0db6726,1292,FALSE,2064,772,Dire
5b0c2c7e18afb5abbbe5164161218a4d,2216,TRUE,2374,158,
5f7e552cf5c8e61f15451f09680d0daf,1404,FALSE,3852,2448,Dire
f872ad5a4c8c3097dbf91fdd51ce4b20,1906,TRUE,2169,263,
5c66c450dcabcc7b4dbc51f4bbb7f3e0,912,TRUE,1900,988,
c7ea3782596ff8ad2e1c67fab331658e,517,TRUE,976,459,
8f5575c0a2dd9f6469ce6e3da58e0455,1069,FALSE,1410,341,
2a22b728e297ad65dcbe6af82fbb6001,3549,FALSE,3729,180,
86e7744a3a6184c2f02f8fd017add422,437,FALSE,1515,1078,Dire
4fcf23bd63883c43ead34a8a83d4c385,28,TRUE,2628,2600,Radiant
47bd880d59fae4c680ecc61c45a01324,909,TRUE,2110,1201,
e316ce085d7e3ccd3f831c02fb1388fb,923,FALSE,2619,1696,Dire
6f7910f73a4f47427033a25fcd39037c,2067,FALSE,2609,542,Dire
51e2fb1d129f97d53aa8d7a1730b9685,2234,FALSE,3071,837,Radiant
ee591fa49c9fa8b36e4de5c37bc67499,1258,FALSE,1596,338,
c7b8c4d5f0b81fd133c7deb2279f6ea5,2189,TRUE,2415,226,
8cf22fa863397d94759dcbdd5186b8a3,1426,TRUE,2319,893,Radiant
3b1c88263a37d16eadd4fd4365f9b68c,2886,TRUE,3132,246,
c5976ddf90f44e8757d42048326de6d7,389,TRUE,2185,1796,Radiant
03e8e0cd1828dd7607240f6edc90eeea,961,TRUE,2352,1391,Radiant
614f3dd987365bea63803c73afdd566b,1160,TRUE,1727,567,
df661473df9a8d1ebafb08442866aa15,1042,TRUE,1365,323,
864dd4cfe89da45398d5249c15b5b59c,1655,TRUE,3374,1719,Radiant
10f24e4d8420e7498e1711e90e446cc6,87,FALSE,1792,1705,Dire
e23db155dbc1f96987b964b3146cff3e,1079,FALSE,1938,859,Dire
e198b1379e2d140c04edc219ab953567,1316,FALSE,1545,229,
a04c7a973bf536ab4445b31b9b59d90e,447,TRUE,1567,1120,Radiant
3024799c4ef52fa64e7af1cc271a9c45,2251,FALSE,2418,167,Dire
bf3a399288765947371a20afee602c0a,535,TRUE,2133,1598,
43e9d1fcbf539a3c9cad23065bed7297,629,FALSE,1253,624,
b8c83881f18025e13fe46ec598002748,2053,TRUE,2253,200,
dc18e0b98bbd4b70a5b4d5a22620f414,804,FALSE,2191,1387,
ec54e53ceb8780d00ee03a8ffe0dad39,975,TRUE,2173,1198,
91407fed31d8e77a69a73e64c87cd938,3313,TRUE,3386,73,
3cebd506bac6c100c2966211e6ac6350,1199,TRUE,3549,2350,Radiant
9e91d3bf21b6dfb033962b3496e25509,3447,FALSE,4546,1099,Dire
cec3a8d40a5b81cafa0edf76e5dffd43,316,FALSE,1740,1424,
a46714fab0deaa7ec67d8fd518590ab5,480,FALSE,2727,2247,Dire
241b592a779650f42f6cdfba0466ad7e,1570,TRUE,2964,1394,Dire
6613cbd62e6d6031b59f2ff7e851baec,497,TRUE,1479,982,
c4ec09e8bf7abf5429697dbbeabd9a26,412,FALSE,1334,922,
ce93d21f722bb6414769698915728fa5,751,FALSE,1435,684,
09d0b2d2f0dd94c87aaffca19ac963c3,1024,TRUE,2747,1723,Radiant
ad7a78bcbb1cacf65079f6430099885e,1921,FALSE,2277,356,Dire
f9e3c70a2b7695beda3564672e31cb65,2347,TRUE,2484,137,
fc1a465e689f16629cc0dd6ec448884a,1520,FALSE,2478,958,
f6b57acf08ebd92eac177662dedbc225,1545,FALSE,2423,878,Dire
b08bb44e8f5c65b83190a75f0ae3fa45,771,FALSE,2731,1960,Dire
eb024dca322badf9194a769133bfe446,365,TRUE,2089,1724,Radiant
46bde440891e4b48752cc62e947aaf6c,1179,FALSE,2787,1608,Radiant
89943a6a3e31f42195749365a9d17161,1277,TRUE,2600,1323,Radiant
08513a947eaa80ace29adcfdb38f2186,2055,TRUE,2773,718,Radiant
b960307d95e3525e18a7cb29f48c8aa6,1794,TRUE,2186,392,Radiant
d88c94180bd45485f400500f58f8a772,82,FALSE,2011,1929,Dire
c3b4e20f4e1cc9795e989794ee96372a,607,TRUE,1290,683,Radiant
a96c483471cbac9ce9200ff3ce208547,992,FALSE,1402,410,
1d6555cb973afb3f9a3774a4a4786611,908,TRUE,2441,1533,Radiant
0862840a7dbfd98c86c3a09fa5679bf5,1269,FALSE,2846,1577,
ec0549f06b8b3d4dc2f458feee551e11,2059,FALSE,3376,1317,Radiant
fb6a377f6c6c0a97fd16fc12446d5379,168,FALSE,1637,1469,Dire
ef2102c12b9ae79ffc5223e29283eebd,510,FALSE,986,476,
014329c0e212ec75dda0f67b70147a61,656,TRUE,1767,1111,Radiant
122d0b2e495191f3b9483d36cb228580,1550,FALSE,2562,1012,Dire
1409b1fd7b8302466242a3c2ec60f226,1071,TRUE,2008,937,Radiant
2a977a66ae9ec6de35c8f0b195af3e8b,93,TRUE,1286,1193,
d74c7f2a2cf6c3cd34024aff2383f163,794,TRUE,2689,1895,Dire
3dd1b69907bcd9884734fa272fa9a243,1688,FALSE,2481,793,Dire
f0eeecf7619247c303ead4ff2ec87d3c,1657,TRUE,2807,1150,Radiant
c2ac75186025eb76b2859875693859ee,1382,FALSE,2080,698,Dire
286e51863299db7b5bdc636ca0fe79bc,1891,TRUE,2183,292,
4c5444ec41e2d574f2c1f67dea346daa,895,TRUE,3722,2827,Radiant
f8aa23b92d58a8b3d182c87ccdce40f4,1016,TRUE,3135,2119,Dire
d506f1841565720d212e4ce371962645,58,FALSE,3079,3021,Dire
f36900235ffa822ae0653ffca4de2b57,3026,FALSE,3255,229,
27b40541adcf8bc731c5554e3f71b77c,2158,TRUE,2497,339,
9aa0ba34db9c666900310160625ff6f0,365,TRUE,2229,1864,Radiant
980c329bb85b0a6ca553c88341b9f9ac,1249,TRUE,2526,1277,Dire
a4e0133665f15118b2496a9b7db58ddd,1944,TRUE,2341,397,
f4d6d228b80760239cc2fcff196f34bd,602,TRUE,2658,2056,Dire
e0e8cad699b4e635365b4937ddffcbe8,426,FALSE,965,539,
6a83bf4ecdbdb7af6a0fed9d2144e587,833,TRUE,2533,1700,
566b38517d58306683ebfce55124b90f,1120,TRUE,1343,223,Radiant
c1e697e9f15747df917481d6f5ac1692,586,TRUE,3297,2711,Radiant
4a4825ae36d386230bbc37f8aa1858ff,1046,TRUE,3068,2022,Radiant
6b04117f1b03d16355a70bb6498fbe93,1610,FALSE,2803,1193,Radiant
82836b4a12679df562031a233f245e42,1633,FALSE,3020,1387,Radiant
ccc1396f047c891d4625d3ab0540a83e,798,FALSE,1964,1166,
edca56b46226d84f396f6180dddab806,1905,TRUE,2168,263,
a4deded8a32af74ba2740516f5c1b143,2426,FALSE,2739,313,
496ef74df4f7ecb713c3c647823fb390,115,TRUE,2559,2444,Radiant
88300608f817a7f01de1b6710f124979,2531,TRUE,3003,472,Radiant
ee45d6965ef3a6505788ff865cb25b6c,74,TRUE,1495,1421,Radiant
b3fba06cb0cf1c7ca1d62bda3cae7e46,1504,TRUE,1681,177,
de24bf13e36a3992bb3ce7350382f8a2,20,TRUE,2234,2214,
b7b3d1e3842f4856ff281d417ee75c64,1098,FALSE,1280,182,
bb509d3c42eeea0e959e0352b008f6b9,101,TRUE,2673,2572,
81151a2d2e397ca06633863a45ff4d74,289,TRUE,3102,2813,Radiant
2a53ba588e45b039c5bf66bf195ea98a,433,TRUE,2468,2035,Dire
6b1c435bfc3fa5e360d971e06f3ef759,636,TRUE,1708,1072,
c7b8ea4e27052a456777e8b0a5aed286,1098,TRUE,2104,1006,Radiant
ced96649bd126c67e0f97d9efa697954,903,TRUE,2391,1488,Radiant
c93d35c7f3bbec87195d6e9464c87892,1542,FALSE,2869,1327,Radiant
ac7d6e709ec3d05d6fafc48a9610d8e9,1663,TRUE,1895,232,
2b30f76eb59635cae37b798f7b99076a,1227,TRUE,2765,1538,Radiant
2e89b0983cc45ee92b1f120d30608fc9,1454,FALSE,2792,1338,Dire
73edde2b676829630c234605f8c1f841,578,TRUE,1149,571,
cecbc3fb3b46e0a192aa6f18046bbd66,742,TRUE,3465,2723,Radiant
3bfa09ed48124e23423346156f003f50,1606,FALSE,1912,306,
0ca0db65d4a2a10650d0f34ee2150555,2538,FALSE,3017,479,Dire
454a1c24d04c6beffdb2a65317313a0f,2488,FALSE,2956,468,
7f4a1e9a01cc93a4607abe1063f7b7eb,951,TRUE,2236,1285,Dire
a905072af9a52fcd983c59916cbd66dc,1469,TRUE,1937,468,
e47c03791c25971d9ff4b2aee680def8,1683,FALSE,3076,1393,Dire
aeef02d7e847afb528cb0d27057a62a1,1138,FALSE,1417,279,
c5826c56fd0e300ebb51c227388b6dfb,695,TRUE,2009,1314,
a73adaeda455de0e9309dcbb6fa99c9e,1592,FALSE,2249,657,Dire
e376ba17a0fde057f56159e6426b811f,1573,FALSE,1673,100,
22cb88ebcfecb0cd289cf80247eff89f,1774,FALSE,2120,346,
38409f3ba92a2732e5180df4378cdf8e,828,TRUE,2312,1484,Radiant
3cfb8fe4b7ab3cc75a99ce40c5063c03,778,TRUE,1643,865,
1fb9a8dcf3d2a8ecc0a6390e974d44e7,1793,TRUE,1933,140,Radiant
5fda3f155c5a64d4518e70d32b69c7f6,1962,FALSE,3238,1276,Radiant
ec69188ff2922627617b54632df2eefa,2517,TRUE,3525,1008,Dire
16b0259645f5d3a16541ccaf85c4c8dd,792,TRUE,1990,1198,
f38543b9a232a9d85e693b5338517530,1429,FALSE,2605,1176,Radiant
e8516ac0b1169b81f19ce6cb56d57fc1,2446,TRUE,2717,271,
ef98e616a6f8bfcc4383d254332475c4,2485,FALSE,2732,247,Dire
6c7b46fb59eda719bc5343740e53242b,1595,FALSE,2113,518,Radiant
9b80d6c9a98828e87b0e7b884201d549,507,FALSE,2960,2453,Dire
4139726048392d342375fc6de48022e9,1081,FALSE,1746,665,
ed390acd38520f7bbab3adbdd8d6ddd8,1395,TRUE,2075,680,Dire
3f7abfd1603dfd79482fe911836f13d7,457,TRUE,2618,2161,Radiant
5207796e9143284aa0ad1a14ede6bcc5,513,TRUE,2081,1568,Radiant
ffbf7b4868b167914dd4894a1071167c,274,TRUE,1317,1043,
f5a70f1b1aa5b6cfd0838a4248c8b2f7,1639,FALSE,1759,120,
215aacd97648ac50b15742cd5ad4c8e3,1579,FALSE,2417,838,
4f36a04e34e3213078ba66adcc816e39,53,FALSE,1879,1826,Radiant
ab47a72a00b83c4b259a2028c22fba05,1413,FALSE,2504,1091,Dire
35f625cf4e53af3246af1c0dd252f803,1023,TRUE,1684,661,
57671ada1c5d883b5bc84eaeedbf7bd4,1287,TRUE,2635,1348,
4d934b2eaa6923054518aa826f74c5c1,775,FALSE,1497,722,
9b1a07bc3aaa03ca824cdb313986ac72,1443,TRUE,1569,126,
938db9b007c54106f8e2f20a26df2631,1339,FALSE,1926,587,Dire
6acc9bbc5680c2ca728577648e059cff,243,FALSE,1400,1157,
f9f5d88ed7bac4d04fd118075ac87be4,163,TRUE,1989,1826,
13bc1e50d9bc5648c5e14feff20bdcb0,3048,FALSE,3490,442,Dire
6494fa4d028b8a2b670ee2e4c4edc85a,424,TRUE,1408,984,Radiant
fa97eb677d13385f684f25a9828d9955,1665,FALSE,3450,1785,Radiant
c03c8133c3b7f5d3a545b822599fc058,3182,TRUE,3551,369,Radiant
679d7710b913362f27078e242c301faa,873,TRUE,1817,944,
deab5c7f48b9483379fd907adb172882,126,FALSE,2011,1885,
6b618dac7db5db34c70759acfb612d63,629,FALSE,2000,1371,
1dab58da8c68c7b336a06b3ce418fb38,3181,FALSE,4484,1303,Radiant
8baa0389232a7ea7efd73bede276cbd2,504,TRUE,2029,1525,
d75baa5925d734c76e05f9be36b99f15,360,FALSE,1807,1447,
a48e920cc2c3f28969d9ba76c5331c0c,1994,TRUE,2909,915,Dire
ffbead019e5af8a89a828fa753dadd9b,1646,TRUE,1917,271,
1f9906bca0c0e6d176b2695d38e250e5,433,FALSE,3324,2891,Dire
8402ceb32714820309c3d58602e93200,617,FALSE,3418,2801,Radiant
20ef23a095a51ded8cd8d803cb54b3c5,1489,TRUE,2375,886,Radiant
bcc8b54da369cfc3bca29f04d8872632,354,FALSE,1978,1624,Dire
f700507ac8790af8c78a987565920431,203,FALSE,1842,1639,
e1587103a99b8e106e59206415f4192c,936,FALSE,2244,1308,Dire
fc02529e5c17a35b431106684eec8423,1028,TRUE,2187,1159,
e8162cf116b8b39cde06a7b7ab7f4608,2140,TRUE,2775,635,Radiant
659d3ee0591121aaf77d85ed00dae116,779,TRUE,952,173,Radiant
d36da2bb8e9afba34b755e285bd743b9,957,FALSE,2036,1079,
ab5065d47677c479cf4450669e0a58ba,3460,TRUE,4325,865,Radiant
07c76acb3e9aeaefd6cacb9b9774a622,743,FALSE,2490,1747,
308759fbdda793b65e6b04a7fb26889b,411,FALSE,3051,2640,Radiant
2ba5a2c46372092006f0edc622715ffb,1703,TRUE,2656,953,Dire
85cdab170f4da27e83d6dadf944af72e,1111,TRUE,1444,333,
b3c8a4bfb658d2404d859ad2cbb10193,2132,FALSE,2218,86,Dire
4a8dd172ed7041638e2397b24eaae3a2,1555,FALSE,2026,471,
1c1e90dd7628b5ab0cf212037c76aa3c,1145,TRUE,2744,1599,Radiant
9076a47846e93ca75f760d6356312654,1878,TRUE,2600,722,Radiant
345cc2b66bcf5ecf98442bbff92e3bcd,873,FALSE,2324,1451,Dire
79bff601f43c399cebb7f04bff561728,94,TRUE,3031,2937,Dire
48ec3ba305bf2304fcfcfbd3a85f6252,1457,FALSE,1815,358,
39182de68dda84a289b1fb0be15a76d2,196,FALSE,2113,1917,Dire
4571b67f0b89f73ac4a48e8900860e54,1414,FALSE,2085,671,
8efb1dd5447893bf4fd438c65f0b354e,864,TRUE,1417,553,
a7aec4bbeed2a4fd313407d1e7b7518b,815,TRUE,1687,872,Radiant
de450e262816a6221a566ec14ecc47f4,1121,FALSE,2775,1654,Dire
cf24a2af2adc987f491dc1ba21e38e51,37,TRUE,1987,1950,Radiant
a344c15739ef477670127f546f9fc64c,2601,FALSE,2952,351,Dire
81180f7da07d57ac499b953862792203,1905,FALSE,2206,301,
49c98800294ae6d89b1a0819c9ca1b1a,1135,TRUE,1267,132,
ee86c0b8eb9226cd7f0182f5167bba66,347,TRUE,1510,1163,
694b999bf378bd564c43ed5303296588,53,FALSE,2190,2137,
c65ac57e959ca8051a1ddf9a924277ee,803,TRUE,2366,1563,Radiant
b2be66541bbeac1019fe1bc18c5502b7,2057,FALSE,2463,406,
299bc65cc04064d7d897a998489cfd27,1339,TRUE,1426,87,
1ec4e1ffe707bcd63ecccce4f2432b31,1012,FALSE,2667,1655,Dire
8cd08eeae44ba6bf804c9bfff333b4ba,817,FALSE,3475,2658,Radiant
2bc579c82dfd9870cc798e5114ef51cf,252,TRUE,1804,1552,Dire
cf6061d6a39b374ef6c0c40e14b87a54,577,FALSE,1729,1152,
da7e8412b595c52bd5b943ac5024323f,74,TRUE,2426,2352,Radiant
390ab23f8eee222f2a64bb51439f6814,1955,FALSE,2039,84,
54fe933dae1e6de257523ac4a4917e85,621,TRUE,2404,1783,Dire
f4ce8a5c2ecceaf88f3b1a4fc8afeb8f,911,TRUE,2181,1270,
e9858217ac4aacdb96273f8ddecbc1c6,643,FALSE,3571,2928,Dire
f3fadddb27018af3a2a6fac0869ca023,611,FALSE,2211,1600,Dire
2e70b42efd139647b53215031ef35771,2334,TRUE,2513,179,Radiant
5fee4f68d05d9fe09af3a7cc92b2a84d,938,FALSE,2156,1218,Dire
6fccd1359fa5be7c2d70fa298a65181e,445,FALSE,1247,802,
9c1cf24cc94a9d2f44fd26ae0eb11424,245,TRUE,2095,1850,Radiant
693640868a9497591e99e33efd024332,157,TRUE,2416,2259,Radiant
a45a31745ceab62b53b10eaf4278cd2b,924,TRUE,1911,987,Radiant
01da522a79360ee0fcb76f619e6630b5,2242,TRUE,2425,183,Radiant
671033f1e6a61bb4f7a28c47fdf19d41,1787,FALSE,3463,1676,Dire
c2912a6e0f852923d1f8135f1dd2b376,1299,FALSE,1368,69,
46abf7af274745f99154076a2c7623a0,989,TRUE,1482,493,Radiant
5d4d6e8fab7f9ed34de50448ea568a19,89,TRUE,2560,2471,Dire
13d00735cf262a7f10ab9ae859c367c9,830,TRUE,2295,1465,Radiant
62166e862b2b2e199b3358fc2f15a4f1,1035,FALSE,2144,1109,Dire
e69d33c24416ac39e67c8d209b6d54e7,727,TRUE,2554,1827,
6a9112ef32b813ee999dc24fee23206e,278,TRUE,4173,3895,Dire
c82bd56f228fbfeb34c4233bfdbf494b,2262,FALSE,2789,527,Radiant
11db2d85f16b7e7a18753dc238d4a38c,12,FALSE,2625,2613,
5e566273d6707ed50dc4a69f1fe143aa,616,FALSE,1111,495,
c1c86b521a7aa77696896c9f576c7695,2208,TRUE,3581,1373,Radiant
6164e685ed98e59a156a54f36c77947a,782,TRUE,2506,1724,Dire
4dc0feaaac9d8941f791194fcb71c736,2618,FALSE,2846,228,Dire
8461dad0df3afa867079dd68e9c4c173,1117,FALSE,3776,2659,Dire
967b475512f14fbcf573a671b9a213fb,496,FALSE,1846,1350,
3e14ed2673efe453088805532573ec87,613,TRUE,1428,815,
e771aad9be7336e3a72dd17a7ee8f964,851,TRUE,1022,171,
b2a0475033058275aad389c1a9fe9908,1131,TRUE,2838,1707,Dire
74a3146381fa19b9e605070c7a2cd7bc,1841,FALSE,3234,1393,Radiant
3a2a5c17201e344a2484945203533402,1590,TRUE,4693,3103,Radiant
25b7cd2c3882ffdca5cbab54a5705d42,1420,TRUE,1998,578,
8e6fcefb14c2d65c98d4b356851479dd,1101,FALSE,1719,618,Dire
3cb1075828d826f1fbce9243100329d6,885,TRUE,950,65,
2a2be2a4cdc34a5d3f3c1ab6855a324d,1385,FALSE,1712,327,
d707913ca35853a103b76483a0eed0bd,186,TRUE,1308,1122,Radiant
1fb85b3aea3da560115a02b86b44582a,291,TRUE,2645,2354,Radiant
0c4f243ed97959c672d9fc476231039f,806,FALSE,1647,841,
3f9acde225ad030f9d1b23636e8038e4,899,FALSE,2286,1387,Radiant
4143c6ffa383d28f869931c12cd522a7,1714,TRUE,2057,343,
4d86d336bad681b8b0faa6333a2d2585,2501,FALSE,3325,824,Dire
a6c34723e023be1365271629a05dab1f,1076,FALSE,1553,477,
22ed242085b4963e1ee7341bf56b57d1,35,TRUE,2843,2808,Radiant
8d006a556f95ad0391db017cdf789eb1,371,TRUE,2242,1871,Radiant
0e7dfa05fcb63d7a8ff7b716ac6c600e,1001,TRUE,2977,1976,Dire
1902f83ed2ba9902f530aa32953abbd6,846,TRUE,1749,903,Radiant
a2467a30b0fc1601164fa8f565fa9d89,429,FALSE,1777,1348,Dire
7f49113e418d9da5ebb559040c3c9efe,450,FALSE,3116,2666,Dire
9de7300ac079e215c9374f8501172da0,668,TRUE,2642,1974,Radiant
77afc3bc55fd3c8840983a80b565951a,1301,TRUE,2489,1188,Radiant
3eaaf6c28b9e70e04849edca6f562e4c,1844,TRUE,2644,800,Radiant
139014cd64197e348634ccc0679ead60,949,FALSE,1636,687,
638d8b1ffc841af6a91d171dbefbd225,1323,TRUE,2732,1409,Radiant
001b0dcf31ce1acf5c9cbb613167d53f,1343,TRUE,2044,701,Radiant
72c6dd2723ffe3eb3a56765e23cc4533,1245,FALSE,1330,85,
bf39354f673a5781ca79703397a9432d,277,TRUE,1212,935,
fc8839e692ef604ab4bbe9dbb25bc7ec,1552,FALSE,2087,535,Dire
40560518283261c5add1f0f2bd29e74c,763,TRUE,2986,2223,Dire
0762d0c5bd32ff9093b37eb8e765400f,36,FALSE,1343,1307,Dire
4993eae71c3129617f0f081052bba41d,967,FALSE,2039,1072,
9b715fe8e617163b691b9282ae475658,771,TRUE,1924,1153,Radiant
eca211262a3b492fcf22b7c4e3d3e423,334,TRUE,2063,1729,Dire
d5f84ea4e361113ccbfb7a7a906158d7,2017,FALSE,2357,340,
a1fe95e07f321118ed04e9a8a7d588b6,856,TRUE,2562,1706,Radiant
2f9e7e8aae586e46ad7063569fcd6fb9,117,FALSE,1863,1746,Dire
88e5508b4e5b1b418cf0237abf03c1ac,1767,FALSE,2380,613,Radiant
84c8eb06cb89cd6be137ee155b4e3f1d,2504,TRUE,2813,309,Dire
2650057c7054c66fee66ee11eed8c28c,1523,TRUE,2100,577,
415339930ead63a847a4e88122c5bc8d,562,TRUE,2124,1562,Radiant
da36f1794f502049b1be53910b8f20ea,1762,TRUE,2310,548,Radiant
0944870e78d294bfa120212eee5112f7,1967,TRUE,2205,238,
f8f7633bd25ecfb17d3b036d75ff8f90,2759,FALSE,2984,225,Dire
9b4322122e7cf5dc2f17b4e837ae94ea,1698,FALSE,1730,32,
6fda2ecccd594a6896e785b805ec12d2,1567,FALSE,1934,367,
38e8738200fc8cedb5c2af13bcd16a2a,2064,TRUE,2506,442,Radiant
ba39b651014cc325f2167071cdbfe1f7,214,FALSE,1622,1408,Dire
7b60e02834cba22a90b39cc0d60f161e,685,FALSE,1202,517,Dire
c64a98f7cdb013e257077e9fb226f2e9,932,TRUE,1381,449,
4c30f04332fadeee68a85719dbc68956,93,FALSE,2469,2376,Radiant
db73f539154d35cddc59df501c1a3464,175,TRUE,1458,1283,
2c295db41ca52d1c43c771af3127fb9d,664,FALSE,1862,1198,Dire
137f41dc22734dd63c9c673a27bf4f6a,602,FALSE,2401,1799,Dire
e7df00e9009b6dda71732161b74f544b,1207,FALSE,2191,984,Dire
318f2ff2f2132cf6b90c7ecae3039382,1068,FALSE,3095,2027,Dire
7ef715643663637d47ccf171d4eb4e7e,671,FALSE,2794,2123,Dire
72c08e83f3aa4096d30141cc12714b2f,251,FALSE,1814,1563,Dire
4aae38c6ebf99e5bc2ea3a789e0d1456,1405,TRUE,2827,1422,Dire
3216eadffa42c5fafd8ee149b4472d56,1910,TRUE,2437,527,Radiant
1e9754947a1146f6cd31d4122581eb19,1967,TRUE,2011,44,
3a0981caf97b811c32fa1604492b6a85,2009,TRUE,2213,204,
b326996a2da4200deeb47489e0bd31e5,1031,TRUE,1654,623,Radiant
4352dec4721b6070f00721b78849761c,1607,FALSE,1966,359,
c40668768f8857fdf05f1d750b579018,1714,TRUE,2933,1219,Dire
1134c6e55de78b128ee956eaf61a32bf,143,TRUE,1972,1829,Radiant
1f53e93754e1a87c4c5ea659bfcbce2a,106,FALSE,1379,1273,
4c5c614efeeb252778c4f653ce73a26e,2068,FALSE,2264,196,
b5054b9d708043b34c331bebd3fdd3f0,1631,TRUE,1809,178,
714beb3225826bc110d9b047bfbfe202,93,TRUE,3769,3676,Radiant
a27efd5a1bfb2ab38afc067f2292aa70,2367,TRUE,2478,111,
5739bbe96a99651b98d27fd5c53b647a,1991,TRUE,2780,789,Radiant
1a39a502d2990368b8a231ef35a58834,872,TRUE,1905,1033,Radiant
9b5306103954470d7e8a24c90a42ad3b,1058,FALSE,2311,1253,Dire
eb76184e2f332e446c29567e4006e1c3,836,FALSE,1969,1133,Dire
dd9cef6784fcb08f0ff4517a6d880e22,981,TRUE,1086,105,
d5d377edc24b234bbddb84ad9644e9ef,1766,TRUE,2471,705,
38f7000969b238f0b0fe06d30f0b602e,1712,FALSE,2053,341,
d9aca3a8c8f09a86e688b946d8d5e8a2,1019,TRUE,2143,1124,Radiant
f708edc4c8fd8da78603b8349da91588,1463,TRUE,1728,265,
133ac87c64729091cce22ced1805e1e7,1455,TRUE,2320,865,Radiant
9652fce0cd388930838a16682e35c1d0,1954,TRUE,3830,1876,Dire
34aa709da83e4837e170fa3382bb6cc6,238,FALSE,2046,1808,Dire
3ee55b28ccb63af3d408500a380654b5,1947,TRUE,2068,121,
0cc717f3a9dd1918043256990a0aa122,360,TRUE,1759,1399,Dire
1f88c0cbd72e4dab6d2874d7b48d7475,1581,FALSE,2349,768,Radiant
47d777e5a161a65d2951085a398b2caa,425,TRUE,1723,1298,Radiant
09a71345fd88ec32846ed7d1b327aaa8,1463,FALSE,2778,1315,Dire
5c969103a76c207349fde9a366b28f9f,239,FALSE,2097,1858,Dire
513c505b4f25c1fd6ea7894259535623,582,TRUE,2269,1687,Radiant
6088eb65d166d5f3a1a612dab83b1bb5,1434,TRUE,1872,438,
4abb9aa438514506034bdd70727599e5,1527,TRUE,2279,752,
1afcd1e365296c737404e74c14030aa8,2261,FALSE,3072,811,Dire
b5cd66a39031bb128ce5f7c16d21e9a6,984,FALSE,2529,1545,Dire
c34768f187e67fb4abe3a3eb135ba519,739,TRUE,2918,2179,Dire
2eeea25fbd156c902d469536b54a460b,400,FALSE,1189,789,
1d24126351929d916ec72299a6098c33,373,FALSE,1314,941,
021fcd24862645098b4ad0a61c36be6a,1457,FALSE,2894,1437,Dire
5f866ff06ab2460ceb5c337c70dcc472,2925,FALSE,3115,190,Dire
e94c9ea660fd3cdf5561b7156a74a69d,229,TRUE,3071,2842,Radiant
c1b8e7a26e0a44ad983c8266a63963c3,916,FALSE,3746,2830,Radiant
1800ecd6d538fd9e811ed08de8040111,445,TRUE,1164,719,
99d330306cc5ac98c4155897c9743403,215,TRUE,3331,3116,Dire
43f09fb98bdd3af7ee367fbc2b4bf061,467,TRUE,2258,1791,Radiant
1f726b994f8472c5279c84fd7d008135,1789,FALSE,2793,1004,Dire
f0e4f48e4dc05a3398a1a84efea4520e,956,FALSE,2160,1204,
7b806ddf6d6d616c10ae2089ffb8b5be,887,TRUE,2719,1832,Radiant
80c881e43bd394621fc926de0d3b2a07,1283,TRUE,1870,587,Radiant
8d7b2bb975e52f0fc0c3c33db2e32995,1466,FALSE,2062,596,Radiant
901a680c30b34d2daa14e1fb513079c9,1029,TRUE,1509,480,
a4f649e58945aca295cc6d52e3046f63,738,TRUE,2222,1484,Dire
360f03ab02f44c4e9e9038fac1092a49,760,TRUE,976,216,Radiant
b72e2ec76e3b1055159cc35d195a1622,873,TRUE,2569,1696,Dire
6a6fcae7d297b62d466eb18b2c83439c,1317,FALSE,2879,1562,Dire
d165aaeb9ae033f8709c0cdb54287ae2,298,TRUE,1155,857,
76595b0a3eb5e5bc82339a8c5b7bfdef,2165,TRUE,2627,462,
31eb15d83483284f706f518436e12d9c,226,TRUE,2133,1907,
8f0c40015036111ebbbbf967261f7293,535,TRUE,1676,1141,
35ac2dcbe86b8b30e25ba2421f0b10f8,265,FALSE,3389,3124,Dire
8b5f1d13a1443cfeaefa19992595e0e7,2847,TRUE,3297,450,Radiant
83991aca163dda5c5079fbcee98231fc,1523,TRUE,2252,729,Radiant
4e074a2599f92ce7f2f13cd44dc83784,2044,TRUE,2450,406,Dire
cdde2f4931187673c18dabfe6233baab,2450,TRUE,2517,67,
ba70b673e605b96d1854fbab5f86f9ac,608,TRUE,1520,912,Radiant
c5fd37823ead32714b8239863b7b4abe,2134,TRUE,2191,57,
616764991b560a7c41c0822a0972cb32,1348,TRUE,2852,1504,Radiant
ae208ad62d1c81201f6e6c93bd31a495,132,FALSE,1870,1738,Dire
f93f3f56b04107139a71a29a7283243c,1837,TRUE,3083,1246,Dire
3105381fdeeb1bd09883616fd3987519,416,FALSE,2058,1642,Dire
3a2f9398fb24fdcb9d3711173a3776c5,1077,TRUE,2476,1399,Radiant
7c6ab07a77d8fda8d552b34d6fcfc61a,1203,FALSE,2424,1221,Dire
f877c089f8186eace3111b50a9aaf212,728,TRUE,1209,481,
ccfc30f5c715ed62491ecc499a34a30a,1109,FALSE,3080,1971,Radiant
9d13503b199b8c4bdb5ab32b886dffa6,529,TRUE,1769,1240,Dire
b21caba12599dda41c57f75e6308c97c,1080,FALSE,2406,1326,Dire
f0bbc939a71c5c22cacb4cda176f66ca,41,FALSE,2244,2203,
a5006890562e2b6e4bbed034ae42d4f2,3033,TRUE,3118,85,
46e92602694ab318057aef67e28ba234,1007,TRUE,1759,752,
f55c5607afa5b96eff93e6d1fc0c877f,494,FALSE,2222,1728,Radiant
bc4ef5bb6934bacb87abf9b8ab591d54,1200,TRUE,2432,1232,Radiant
c9b2227d905bebcbd206744e9565ade4,1318,TRUE,2042,724,Dire
4ff847fd77a826e8761f7da96a113966,1192,TRUE,1866,674,
0c0eca2a50c0c421d893e77c4bc8adb4,920,FALSE,1588,668,
95f9a9422819ac7b3756aa45c7bf1849,280,FALSE,2197,1917,Dire
062264786ea34fa730a5bc489cef7892,870,FALSE,1025,155,
7f465aaa8858924209926cd27a741918,1514,TRUE,3064,1550,Dire
92872682a66aab1fbddb591a605305bf,1046,TRUE,2357,1311,Dire
1ee5630e472d79a45bc1ab8d559a36f7,119,TRUE,3682,3563,Dire
901cd41573a8a9121dfab034e6723781,1799,TRUE,2649,850,Dire
37a782ae3bfce7d2c75b141ae1d70331,722,TRUE,3016,2294,Dire
9d8e73ca7f1341967f7cd576b03d5fe2,1318,FALSE,2039,721,Dire
e2987f2a8b695a38c2bd9e1d90be5317,1525,FALSE,2099,574,Dire
f48c85954ed6f82c154aa6fff025aba9,796,FALSE,1596,800,Dire
cc4239afebb2b173b02f603a8a867ac5,580,TRUE,2580,2000,
9c78a88b8462954be9c031f65377b217,1771,FALSE,1882,111,
e47d1ad4d0693ef1b3a6a09f27b96f1d,1590,TRUE,2734,1144,Radiant
f7a84501b5c4399938d884424443bbf7,1065,FALSE,1107,42,
2ad542185387199ac8d865d7708c1b16,2634,TRUE,2800,166,
2227ddb5db0c4eb72dfa94461eba5c93,1609,TRUE,2560,951,Radiant
57755330a74ba4c3497ebc961f6b5845,1429,TRUE,1622,193,
51b3e922252980bbda88a85ffe4cd36e,260,TRUE,1623,1363,
603b1c8ba7c94c0df4bfe3631ecd388a,2101,TRUE,3026,925,Radiant
b1de192bebf8782274aa9c9c5a0e348c,1119,FALSE,1598,479,Dire
628acbbe807dbd61b6935e56a26dc23f,282,TRUE,2530,2248,Radiant
47aae34dbf96a937105b054d3f54c607,206,FALSE,2249,2043,Dire
07e1b8276b256282426986da48ffbca1,1373,FALSE,2396,1023,Dire
9a9cd8be544bc5fa3c24d813b7b4b42e,953,TRUE,3478,2525,Dire
f753ddc10b25a115373f1b8c07220ddc,1106,TRUE,2947,1841,Radiant
3befbbc7cce2a53bbe18516522ab4675,1615,TRUE,1800,185,
86f40281e8b61b080cdd8e385931e5a0,0,FALSE,2041,2041,Dire
d767f8f0368cf617bea4776c8ab35d2e,2156,FALSE,2776,620,Dire
0bdd3e1aa3202607c8f29f705a7f292e,2664,FALSE,3058,394,
afb6b9ae95d45aae1949041b52ce1a5f,676,TRUE,2142,1466,Radiant
760c2dfe0c28bfd669e3e6c0196d1cc0,84,FALSE,1318,1234,
307761b658900f1f19ca091dd0f7e3f4,10,TRUE,1067,1057,Radiant
eb2940f978e1d44f89cc0bc7e72501ff,2022,TRUE,2056,34,
b894a750d13b842dd9fac9bcf57f9cea,1103,TRUE,2874,1771,Radiant
0792b285fcfc328530374dd1352b1225,112,TRUE,1474,1362,Radiant
498318e0cc385281334c1f654503ed80,2222,FALSE,2702,480,Dire
a292f2d2e5b77130d8ebf43f9139574c,1101,FALSE,2002,901,Dire
f34a97d4e7b0442d97259ebf81488c86,940,FALSE,1891,951,
9473690655c208e7c2b4bd9e80f9d510,1016,FALSE,2297,1281,Dire
9d0f04f57c9e55e53edb39e454afee69,1529,TRUE,1739,210,
7ef43dd40e781a4a62f7140335d99a07,934,TRUE,2533,1599,Radiant
cf1a3e72528c9a8e7b0c060640a9ed4a,1937,TRUE,2321,384,
e8561ef96b6bbec9c93dcc956daea5a5,1888,TRUE,2707,819,Radiant
43f33c6e89914609a7145a926ea21d5e,2292,TRUE,3337,1045,
6ba9401265c0f5659f503d8080d6eb95,73,TRUE,1438,1365,Radiant
d186e49167b78cd7e9ba2d3143d7a851,1489,FALSE,1924,435,
b5b45a001514fa40396ad18fe787a713,378,FALSE,1702,1324,Dire
08dd682702d012983a6afff548285692,1906,TRUE,2192,286,
1ee4d65c8c833c9d5c5203cf7f9f97c8,1400,TRUE,1851,451,
c12be070b980b0592cc982b24c04a0f9,1500,FALSE,2176,676,Dire
389b172748d9d1c91e306a44d0434e81,747,FALSE,1973,1226,Dire
e0b5da74b8a7ca8bc884988fbfd9b014,567,TRUE,1263,696,Radiant
af853c62249f499f4c89d8cce09efee3,324,FALSE,2185,1861,
b5a106fcd7a6ce4f256a2488a50e28a2,98,TRUE,2956,2858,Dire
faa545196a6cc7217d8937b7ffe081e0,1325,TRUE,2485,1160,Radiant
2a7ee0712ad7a1118daf6ff50609c987,393,TRUE,1405,1012,Radiant
1093a55e75e1f0b78f494d53174d6b05,700,TRUE,3021,2321,Radiant
8246e33ae7ba5377d8f996686a91bece,2741,FALSE,2811,70,
a2d34838545caaedf114893e15bf11b8,1829,FALSE,2216,387,Dire
f083160b6cb74b4db24913b2ede407d3,258,FALSE,2298,2040,Dire
cc757acc3d8de05164d1d60ddabc7122,1523,FALSE,2413,890,Dire
fc47ea8f65937168552d84ee4f328569,20,FALSE,2146,2126,
a12b40d284d07fd77cea31bc05e422ce,565,FALSE,2697,2132,Radiant
13e3cca1eecd1741ba1a0d234eef72f4,1391,TRUE,2177,786,Radiant
66bdbace63427c2e4fca4d698393e84e,1145,TRUE,2130,985,Radiant
5e13f18a7041c4af0ca33c2f798bd94e,1506,FALSE,2114,608,Radiant
0bfb9f598bfd0c07b5d453e72e484aca,939,TRUE,2891,1952,Radiant
9a9d75320ebd65bedef1dd5883f51989,828,TRUE,2307,1479,
0a0342079e52ddf51ad853d5589d3c32,849,FALSE,3546,2697,Dire
5113d46ad86e0bd7de850eb7d954721f,588,TRUE,2472,1884,Radiant
a6145b051f0da17a022e870b61ae830a,109,TRUE,2109,2000,Radiant
60615a41fe7945b216c8c2161e30a893,1321,FALSE,2806,1485,Dire
ad8d62eb5c59423a3bed914bbe42e2be,9,TRUE,1666,1657,Radiant
5a4c19b2cccccf7cc47c99b675a66503,285,TRUE,3979,3694,Dire
3a4e846cd405dc801c5c469160a06341,886,FALSE,1761,875,
253d35afbc3702220126b62cce3e0f07,1624,TRUE,2282,658,Radiant
cd634c3a86f05b4cf7fa3a7c797f7e27,945,FALSE,2396,1451,Dire
8df87a15c9fab6eb500991f505615152,2235,FALSE,2301,66,
29ab1d85160d2226c8af4c4796f107ee,1683,FALSE,2186,503,
8bf84b1cda6f22cfe96fb93ae5b3b329,2276,FALSE,3666,1390,Radiant
3aeb5c586bcb2faad6454761a2d561bc,1427,TRUE,2628,1201,Radiant
011ef086f3a36494fa0e726724e59b13,1681,FALSE,1921,240,
91b261579bca0aa9ff30dfdfd39950cd,1055,FALSE,1303,248,
5d8d253e568a29bdd69d456daf934562,774,TRUE,2184,1410,Radiant
4c2a167c1499198401d51c65c07c3209,1201,TRUE,2197,996,Radiant
6c8c0f6a99322bb55d89179ef6f3be7a,788,FALSE,2995,2207,Dire
12c93c24ce7d6dfd6b670ec4c4df5ee7,24,FALSE,1934,1910,Radiant
df861dc80982fba2438d54c4991831cb,356,TRUE,1628,1272,Radiant
ca9a96df590e93a923de24eeb1624904,595,TRUE,1560,965,Radiant
d403a4219907d7ca8fade8371e294160,2086,TRUE,2300,214,
006fd6428c5b6c6466bf5610e23d50c3,131,TRUE,1948,1817,Radiant
4172d41eee0564170fcc9350192722bc,1462,FALSE,1563,101,
d09bc238d4f0127c6a4751ad64846c97,1261,FALSE,2449,1188,Radiant
4d6845455b34afcd3aa6c0c38cb76669,1255,FALSE,2238,983,Dire
e1fa1e072ba9f9da2f04b378ea9436fe,731,FALSE,1612,881,
4f9dccfc2fe5d8171e31b126ad9ebb25,1630,TRUE,2371,741,Radiant
0ca2c7cea9daaa2093bd27ace46e8edf,551,TRUE,2172,1621,Radiant
1b07524616c74f627653dbfbc0f87d8e,926,TRUE,1970,1044,Dire
35cb060c0cdc0cf1f5eb4a966267a513,647,TRUE,1566,919,
8383ed63b3f8bdd1f890631e2aa13e63,1531,TRUE,2001,470,Radiant
ed3360bdb62c4176df857334efb0142f,919,FALSE,3256,2337,Dire
83db1bb4c5563a94f13e7039505b846c,958,FALSE,2397,1439,Dire
5a4f047d0820897b2b55b0fff0783d4b,129,TRUE,3878,3749,Radiant
dc4c9f2dd18534680301e78fe34dbfa3,22,FALSE,2245,2223,Dire
d92ff67d9b83773cb3958ace105bcc74,1792,TRUE,3090,1298,Radiant
b89649c530f8ad6b4bfe590baf8eaf8a,2792,TRUE,3648,856,Radiant
3c41a498235726f150daac900f1b4eb8,873,TRUE,2027,1154,Radiant
a5f445c861f4bed586eacf161c2a9d27,2368,FALSE,3622,1254,Dire
e3104976dc5972488f9b450637c85182,2481,FALSE,3531,1050,Dire
3c572f92386ba0dcddc2aad64442de45,1013,FALSE,1918,905,Dire
9bc89a636423f37a8dcec03f9a97684f,2371,TRUE,3218,847,Radiant
9fe3e97d89a6faad666e69dde1bd7111,1255,TRUE,2166,911,Radiant
97213e841c7c435d2e4634479fd54e20,464,TRUE,1843,1379,Dire
3d16d69f18f872c7d15a6a75fff6e2b9,2295,FALSE,2686,391,
17dd34d3878917d8e93b3173e99c9aa7,1785,TRUE,2485,700,Radiant
614ca7f2648abe3b5bd917db234e6495,1533,TRUE,2417,884,Radiant
6292d3b167290467f2da345251ab46ba,323,FALSE,2630,2307,Dire
bc3ac20dd299a6f77b82fa6a1350219b,858,TRUE,2081,1223,Radiant
87d24f89e35a26cf94d28b97143568db,1487,FALSE,3077,1590,Dire
5b785b967261d5f2c1763bf0f942f5c2,2090,FALSE,2506,416,Dire
c19398908d647cb1d6ccec0d48c0afe8,2187,TRUE,3407,1220,Radiant
ff9c61f1763b211cf023d034e0adfff8,1819,TRUE,2446,627,
7de6b840f209fa484e4d6f8f3a5ae958,1601,FALSE,2448,847,Dire
7afd9d90eb098c0f1728063361d4b91a,1858,TRUE,1894,36,
5206d4ccd3fdb999a1c83f4d2d2766cb,439,TRUE,993,554,
416aad4eee24e2c2c5ec136a9a6207d6,2532,FALSE,2885,353,
48875c0b1d80b8937af113db56551fdc,1958,FALSE,2041,83,
372673cb7638256f4afe3378fd547dd2,2183,TRUE,2221,38,
90bec907ed4a12c2ff6fa5970ae4a7a7,879,FALSE,2940,2061,Dire
f4ec2d145d68943af5a52c6637cd082a,814,FALSE,2131,1317,
6ed57f88147b236a036c4d0acbc0d58a,405,TRUE,1697,1292,
f1e6e8354106a5f3bf0845732a002c4f,1981,TRUE,2182,201,
4d13baf33f77bf6cb67da8b600ad5d8e,1062,TRUE,2070,1008,
a9e678cc50bac70dae43e8dfa52078ba,693,TRUE,3117,2424,Dire
9eb7338651c59389a602e8a4d6fbea85,1267,FALSE,2525,1258,Radiant
5c4eb44fdfcecd24f79f74648945bdd0,2114,FALSE,3455,1341,Radiant
ffd9b10ddcdcedc184488d3210473091,1407,FALSE,2320,913,Dire
0634fcf20d663cc200692ee34904f4f3,2178,FALSE,4227,2049,Radiant
abea6101db19d8230793f99d027cca99,1413,TRUE,2327,914,Radiant
2c4acf826fa83376793172410ebf41b8,194,TRUE,1867,1673,
75a122d6a026bc84f9eb426c62b68688,4012,TRUE,4054,42,
b078ea98a9d2d0c02a7e4a5d8f80e333,1204,FALSE,2493,1289,Radiant
59c47605e8dad7d5f7f434227ec5cb68,1272,TRUE,3037,1765,Radiant
c8b71adb971d49643815bed8e7180fe5,2147,TRUE,2401,254,
0f5edcbe1c2102369ed530d994ac0579,537,TRUE,1908,1371,
5ff24e5f95a49b696a3cc9f85ce12d7d,906,TRUE,1836,930,
00e170dbfd83bb5187db27ac2e88db3a,719,TRUE,1810,1091,
fe6cc35e8dbd8070db65ff59c22f8200,1356,FALSE,2350,994,Dire
752de191a8b320a130fd6aa49b23c33d,58,TRUE,2635,2577,
02a998239e62edfa149a47ef44fda5ae,2051,FALSE,3492,1441,Radiant
56cdadbbc4676ff677ce7e69e19c6edc,723,TRUE,2318,1595,Dire
638a5f0ef678e599578547b50168ee9f,496,TRUE,1577,1081,
5ee154c973ca659229597cbe1038c3d4,213,FALSE,2524,2311,Radiant
35381d3d2d3cd96b75ba372973f3c45a,675,TRUE,2678,2003,Radiant
bf210d7ea0e4a8fd41e6a5cf2fb28f55,1404,FALSE,2589,1185,Dire
5dd26800af978f24e55d6b075bbf9739,644,FALSE,2190,1546,Dire
8353ad6543ffe8c8eb3116cc69a67fa5,115,TRUE,1258,1143,
df7cd9b3015e0194f4b2633d501b69d8,252,FALSE,2217,1965,Radiant
fee3ca2e3927b3f6faca7af093a3b8ba,550,FALSE,1296,746,
63f73daa6f90801198a1de0e9e4d6f78,577,TRUE,1406,829,Radiant
cf99ce66f9113296b93956c6a95bfd21,1045,TRUE,1442,397,
3c40d6973a90fe6521d1e7880b612242,539,FALSE,2022,1483,
a227f5a9c16b223819084946efd8d633,1386,TRUE,1540,154,
9277a5d8d1fd420396650e5ba6e4acb7,816,FALSE,1517,701,Radiant
3e3389aa698a721a4598e899c2c9750d,535,TRUE,1394,859,Radiant
9637a923a6bfa493bc97107e1aaf4d12,2208,FALSE,2857,649,Dire
dcc56bee8bc8bcd25b8b9a7ef54b50b6,779,TRUE,1536,757,
f08b2c12204eb71af472d0fcdf7c6846,880,FALSE,1607,727,Dire
2e087a3eebca6932ade7eed0ce42837e,1173,FALSE,2391,1218,Dire
e7c0c4d2102443df57ea7a595b6ffaff,1758,TRUE,2450,692,
dbcfd92e750600611363e8d57ac37c2b,2261,TRUE,2304,43,
9284e13c9dbab7cc93819f2978017b0f,73,TRUE,3130,3057,Radiant
4d64f8eb564ddeb5fce3378c544d6a8d,44,FALSE,1571,1527,Dire
fcfbd736362b2c6d83b4323fe88563e9,52,TRUE,2079,2027,Radiant
8d435af412785e3d49318221c83246fd,388,TRUE,2603,2215,Radiant
fa5058ed3e58a5438c23112b6ab8e1a2,1839,TRUE,2789,950,Radiant
ec4596cd9c9f51bb6052a88118c6a289,585,TRUE,1814,1229,Radiant
b344253f2329e07aba834be9fa0dc39a,1242,FALSE,1793,551,
1130e383502c8a9db63eacd09be3c13b,1611,TRUE,2394,783,Radiant
4701dddd8a381c7c04683d5ecbcad6a8,957,FALSE,1725,768,Radiant
b2575f42927887ce1a594d44e994cbcf,770,TRUE,1558,788,
827a6a3794f28fc2330c65aabb9a0ac2,1003,TRUE,1692,689,
ce62b779a7d2b14b4fc9eaba50d5cd1b,1635,TRUE,2516,881,Radiant
cfe5327de59b65ed3172fc4a0e222e36,1772,TRUE,2539,767,
bbb53e0c1768daf36f02da838d1ba909,1816,TRUE,3072,1256,Dire
badceab8d95eabb775ce6195e74ba1ee,1160,TRUE,2146,986,
b2c104bff8ef9afa7d1704a36c5f53b6,1174,TRUE,1805,631,
4d2623964e1556f9340afa8388a5e727,364,TRUE,1397,1033,Radiant
2caec8cc627d894eedb5ab01f253b648,2438,TRUE,2546,108,
8da798aa0c321a42dd57b41900f87e29,64,TRUE,1940,1876,Radiant
36feec4548aed39440da71cc6848bdb2,3899,FALSE,4067,168,
2c9b8663dec9f821c4573fa537db4c3b,381,FALSE,2005,1624,Radiant
b2263f8c08676e6daea697c2ebbca525,1221,FALSE,2339,1118,Radiant
f88159dd6925a7115b5db257cf67db15,1731,FALSE,3579,1848,Dire
2cdb6916569c0235e6319ccf2906fd5c,441,TRUE,2154,1713,Radiant
0e033c525798191e0b550fe0a93727f9,733,FALSE,2290,1557,Dire
e30f286a10584bc6873e6dfcbfdb41ec,1158,TRUE,2443,1285,Radiant
fed62fafd34e868b3b23b78e4bc4fe5c,1477,FALSE,1952,475,
8a0a2bff2cf8e52935b50c40918cce3b,485,TRUE,1734,1249,
3b490a93dfad2ba14868859a8476bc55,821,FALSE,3409,2588,Radiant
0000c270e25494c03d5c81036463fc45,1304,TRUE,1893,589,
78da1224b692d93748f1aab7c3506bc6,1786,TRUE,3394,1608,Radiant
b89585dcb838c13f8876045d4823f337,180,FALSE,1236,1056,
94420bcf05e29e307be5a04a80de2c69,191,TRUE,1653,1462,Radiant
adde6d291c1b1db7a6d3b8844b14ee06,1191,FALSE,2015,824,Dire
97fa6388ac19dbed5bb6c1a8253896d3,1477,FALSE,2460,983,Dire
a9bbb2454b489e730855ef3a6abd9b79,1365,TRUE,2256,891,
0229e36d56e086717eb7dcea587e889c,1637,FALSE,1735,98,
05965609c1f42830471c518d78c3286f,1506,FALSE,2761,1255,Dire
1a45ed7f8faecb41c8907da5252a60e4,1514,TRUE,2260,746,Radiant
ac4eef73ce4f91489b7c4e3eaa6fee92,1621,TRUE,2284,663,Dire
7a51b7ab784861a279a65136d47974c8,1426,TRUE,2202,776,Radiant
c03d5c72cd94abc7fd8950d409269931,681,TRUE,2358,1677,Radiant
df768880150caf0cb3e937c233169c6e,244,FALSE,2189,1945,Dire
5bb1cbc26efbaf6532019ce1b32ab3e9,1028,TRUE,4219,3191,Dire
8999947335c790284ff681434d23e383,1909,FALSE,2150,241,Dire
ba02e6b87b96b34af14883ce8c307f7c,1349,FALSE,2446,1097,Dire
06b7f29c763615e8fbd32ab5c65c69c1,781,FALSE,2213,1432,
9017b618d8b32706d6b560febe927410,665,FALSE,2226,1561,
fdce4eb302cbca17a10bccb0b98ae546,1406,FALSE,2048,642,Dire
19d58134f40a50b943e33bba04ee5bd5,1624,FALSE,2568,944,Radiant
410353e08ad0243f3fbf423d075f5906,2735,FALSE,2784,49,
ed8e31bea263e09dc27970dad82a38b4,1190,FALSE,3152,1962,Dire
c6efaa9634f35c5e568758ed60a3d5ea,1495,TRUE,2904,1409,Dire
7b619a8daf0ec49cd8ffaa6cdada2a22,1624,FALSE,2018,394,
c6797bf36c3c66d092029e44d35e2477,235,FALSE,2596,2361,Radiant
a4f2f43b26d6c7c04800151da4dbb38d,546,FALSE,3319,2773,Dire
ff72c97d5922adf94f08a6888ec11f4f,398,TRUE,2458,2060,Radiant
b09143d49ebe64c3375ff972f3d58874,1119,FALSE,2214,1095,Dire
4dc12c859207f72f36e003b7fcd3711b,2105,FALSE,2210,105,
c6f648596bb2d8d7006d57d2914f026e,1078,TRUE,1630,552,
2c104c05151749b136675d914e795aac,1,TRUE,1445,1444,Radiant
f9de2e7de315be11ac24a56cf1ef9433,1493,FALSE,2175,682,
15781bfb437d4e4e74063ba4fbe87b9f,1915,TRUE,2610,695,Radiant
7645364b0d4f55fdb7c09b089b7385a7,1452,FALSE,1883,431,
bcca9469770375df6c3ed5101e9bbeb1,1657,FALSE,3069,1412,Radiant
9923ff574c22d2a47e5ea378a19df5a9,1399,TRUE,2137,738,Radiant
4430fb9e4f21acfb3252dbdf3df7e640,436,TRUE,2725,2289,Radiant
8e43c2fec371590c68eb0e96e510bba8,178,TRUE,1988,1810,Radiant
9de4b1525cbe28457df5317513e71bf8,2172,TRUE,2279,107,
e3c5939a60da77185525b39284337e11,960,FALSE,3413,2453,Dire
81ffbbc686dca799a5a1e05e190cf55f,315,FALSE,1302,987,Dire
9e31c8ba6454ed0d848261e8c9527703,858,TRUE,1600,742,
7301d861ec9186f559dcf348585c6205,374,TRUE,3398,3024,Radiant
4700d6bb41fc91f3400a68d48bfdc3d1,1111,TRUE,2573,1462,Radiant
b36d82e7200ace7b02db2e42c202d983,1486,FALSE,2784,1298,Dire
9ed10327b6ee3f7aa0f8d3ea5de6da02,2664,FALSE,2751,87,
17dea801c074e80026cde63caa41c2d1,602,TRUE,1144,542,
f89d859292873b8263847e1e7cb20d94,172,TRUE,2458,2286,Radiant
04fa8d5ad9301d1154c8abf48e42e3e0,22,FALSE,2885,2863,Dire
906fed864a75eea475c12adbbfa3d386,1183,FALSE,1980,797,
28ee837932f76232a4b0a83a40dc241e,2418,TRUE,2832,414,
f9c159f8dcc5621769f47e6edc9db5b9,0,TRUE,1982,1982,Radiant
edc288b768c0319d98c4b67c3834947f,1408,TRUE,2532,1124,Radiant
e28246e50b988bad9c2ab8a87fd444c4,449,TRUE,1686,1237,Radiant
1bd0cfea6e35e1fa23f8164ef5063563,79,TRUE,1906,1827,Dire
9d581eae7652a31b8ac98dff0d32a173,649,TRUE,1923,1274,Dire
f42ec090589c8d9ca2c844387005d3fd,895,FALSE,1846,951,Dire
3bcb8fc53ce64defc0c7eb7f4a2c35d8,1298,FALSE,2426,1128,Radiant
dec87a7daf0f7b4cfb1ab1bc48c6b6cf,1046,FALSE,1731,685,Dire
7309698dd8e0eeb025df147910a1f2ff,3162,FALSE,3439,277,
0ac9d87fcfee8ab97d32a0e30a7a3254,334,FALSE,1970,1636,
e088e4f457cad94442d8897b5540267a,2206,TRUE,2330,124,
41d31818e0e42cd5b12762253fba3650,2806,TRUE,3070,264,
d71820ddfbd3c916bb2d7777ab820ca5,809,TRUE,1214,405,Radiant
ea1b5ee25dbb382a9da85da16025a949,1527,TRUE,1637,110,
94449ae56aa6c0e1cfcb98448f3dd06a,963,TRUE,1425,462,Radiant
27560d4eea2773370adfeef781b227cb,3235,TRUE,5325,2090,Dire
e853a0110eac54dcefc185ed82a307ba,333,TRUE,1692,1359,Radiant
6aba04ee5bfb578788799f3b01c41da2,1299,FALSE,1975,676,Dire
51a481605950bfe2b94d34d3953cdb53,32,TRUE,1278,1246,
e51f5edf369d06ee8018a643980796d5,657,TRUE,2527,1870,Dire
0238dfbe67334936866a3191e82689d0,2398,FALSE,2453,55,
361573dfb553fb8e31231f304cca9d60,138,FALSE,1655,1517,
345e679b843327491662429ff7784285,1406,TRUE,2196,790,
d5fe06f94cfa4cc5f82cd61ec32d27c1,929,FALSE,1971,1042,Dire
0dd99d7810d9f25fc67ff3e3501e980d,1038,TRUE,3240,2202,Dire
b45e4a7989aba2d29120c9e1894ae573,1379,FALSE,2006,627,Dire
ede1bd16110a429aa70420620873b8eb,1861,FALSE,2267,406,Radiant
b846aa51e832bd147b4a21fe07bb90a3,72,TRUE,2636,2564,Radiant
78ea33d7bccc10df33cb828c3e60a320,699,TRUE,3335,2636,Radiant
904f0ac4fc8642eb074f2a01bbb427cf,1572,FALSE,3020,1448,Radiant
76c8b72d7fdf5588f6959f191edd9eab,198,FALSE,2035,1837,Dire
6531c8d7ac05cd7413402889e265e0a8,862,FALSE,1109,247,
0483ffd2889454dd5a35d98b678e59ce,840,FALSE,1602,762,Dire
30316e93471f2d12bafbc990d4944365,2965,TRUE,3442,477,Radiant
16bc78f99958044cfb0ecbbeb276c82c,930,TRUE,1080,150,Radiant
155b7e11a669b906f7a05fa3ada87c69,776,TRUE,2780,2004,Radiant
6e9e6a0d95f323cd7f83b4b75fe9cb3d,389,FALSE,1511,1122,
e4cb81a24ee272ee0110b64ca0bc1ea3,1671,TRUE,1768,97,
416727531d4a07936103aa7521291776,1049,FALSE,1695,646,
84527d778e1961776f01ac90d138f0b9,1131,FALSE,2279,1148,
d29bc47119ba66ee5c23bc32227e967c,1777,FALSE,2391,614,Dire
91f07966c7ca043dab81ba4992be25e9,266,TRUE,2681,2415,Dire
31048a82afa7cfdd23323ec95def0368,1345,FALSE,2065,720,Dire
fd926c3c6596358b17593684fdf9ebde,1815,FALSE,2060,245,
ebca13398ad8c42c472a78b6bdf30f88,1301,TRUE,1850,549,Radiant
a235f461da4209aae50c733e5f7b4c28,1037,TRUE,3178,2141,Radiant
c685ac0617883a4813b41d1b14683540,965,TRUE,2419,1454,Radiant
de23b9c66eb1959ff416974838d2af4e,1969,FALSE,2603,634,Dire
6e47cd60e4be90727b96e5980a274afe,2002,FALSE,2204,202,
fe2d9b7306f84de95dca0b6183b0005d,1471,FALSE,2791,1320,Radiant
b8f7b3f6d2527d751851a96aaea34478,563,TRUE,3168,2605,Dire
48e335965982a019e50dbe42dd2be05d,1189,FALSE,1771,582,Dire
7fb527b9f907352cc17eea776b8a22dc,3598,FALSE,3845,247,
ee7d40a0e4493bc76ce989bec434795d,577,TRUE,2380,1803,
87ede6c27ee7fc35eb6fa6b4cf76f1f3,664,FALSE,3352,2688,Dire
d67adab231991edcb95c2b737b41acb3,2020,FALSE,2258,238,
fe5a44edd02fab5a8352dd8e2750cff9,129,TRUE,3587,3458,Radiant
f351fc23213cfe372a933b8d15efcf62,546,FALSE,1710,1164,
dc61d8edd5352534079f31cc60e4050e,360,FALSE,4304,3944,Radiant
c8091983c5cdea0f20a0cfa45a7ca0ca,883,FALSE,1095,212,
2a90dec4d288940349eb7fb8bd55e57e,2526,TRUE,4442,1916,Radiant
100501e64c8e74cb31ca2d1388464b69,1664,TRUE,1973,309,
6ffa51398ea0f240d7c89c3ea9970aff,2570,FALSE,3183,613,Dire
038846c0a5cb704fee5fc6b584ccb6f2,2508,TRUE,4674,2166,Radiant
be5311f74acbe5d4c31f383cd0a3d1e0,529,TRUE,2012,1483,
62c7d314de00da945defb8f6a0501241,209,FALSE,2306,2097,Radiant
0c1bbda39f5c1079c2f075b6ab909cee,867,TRUE,2047,1180,Radiant
2407799a8c9d6a59d9b125db1772ca7c,944,TRUE,2576,1632,Dire
a175875291c57e79c727aa4c4ac19481,561,TRUE,2659,2098,Dire
0c511d630181ffbe10f5290ce294f9b3,1041,TRUE,1725,684,Radiant
c02e4cd0b6edeb147e477e19d33551db,1919,TRUE,2804,885,Radiant
19c6d390877dfc4c346e54f56452a56c,1098,TRUE,1392,294,
0b835c7a216c282175da754e426a1efd,778,TRUE,1187,409,
5e5cd6ed62c24c422705a03f4b63db6d,707,TRUE,2781,2074,
d304be4d94d81bcf6a8c809a41463dec,1220,FALSE,1513,293,
0f24c981b70aa68d606a46481564fee2,36,FALSE,2446,2410,
0c5362e309869b74cfe1634bd003cbfe,475,TRUE,1751,1276,Dire
68bba1df6758033dc18db37536d5751e,2497,TRUE,3334,837,Dire
8366847ab6365bc2390f6838b3250759,759,FALSE,2004,1245,Dire
c0d921727f1fd5e990690a1091a9d8f8,498,TRUE,2606,2108,Radiant
c583e025c70ea23ceb10b4791e1d32a3,1508,TRUE,1542,34,
b62dac152b2475e1aac52fd943c6c6a3,1533,FALSE,2693,1160,
83a5d82e7e7d859b22032036eedb5fe0,1161,FALSE,2634,1473,Dire
5eb974d7a43ef10fe43d41a35456f2d9,1533,FALSE,3039,1506,Dire
b6478e5cb72eb185eec0e4fa3da119df,2004,FALSE,2093,89,
9a52aa76dbbd2f607f1dfa64d45d0693,220,TRUE,2020,1800,
b4bf8949d027802b0888665627ae5913,988,TRUE,1982,994,Radiant
857362a60c8a59a0476489ee0a01824d,881,TRUE,2273,1392,Radiant
7c8473c0b83142296aa0551b49249434,540,TRUE,2004,1464,
cba1c2bad824d901603bd069d4232250,774,TRUE,1351,577,
71b6737649a18015e9867b782682858b,694,TRUE,1605,911,
b302312f83cdc291e8f13dd38902069e,1292,TRUE,2589,1297,Radiant
b12be5213079d462a7da157cdf4195dd,501,FALSE,2987,2486,Dire
746ba741c22dd2b9ad618169aa3e9e39,842,TRUE,1786,944,Radiant
8e1e3043a10f2e5c48f0975323135e0f,2599,TRUE,2722,123,
51d29359093a435319272f2a24c8ec44,154,TRUE,2048,1894,
31fec905f15796e9f00522c89fc9f638,801,FALSE,2159,1358,Dire
2143b67dc7e7b23c18bd6d7dd3ca49ac,817,TRUE,2471,1654,Radiant
b66c723c5061935956ef387db414761c,1724,TRUE,2221,497,
36db70961a69bf4f77daa18fe6d22832,419,FALSE,1151,732,
4e5e25d0ce5e727f64f5e957d615f9c9,694,TRUE,1502,808,Radiant
cef87385912a721b0e5958fd6d449ac5,2018,TRUE,2105,87,
fcb85deadb2369dd7414ec20c04c3780,1341,FALSE,2608,1267,Dire
e6ff68e6e6e79f1126c09c212a594d69,852,FALSE,2306,1454,Dire
b863a77bb0e3a71d9acbb47f06641f9a,1260,TRUE,2577,1317,Radiant
f282f99e0abfcf50a1015582acf0e4a8,541,TRUE,1830,1289,Radiant
d0f45ebb12a14b23dcbb774e8a5eef03,121,TRUE,1475,1354,Radiant
93fe788bb7629f16034189c177803179,9,TRUE,2010,2001,
5b29a2719bc853f21fef53ecb6a597a8,468,FALSE,1329,861,
068172fe6e25405b3cd16099b1f377f7,788,FALSE,2367,1579,
88a02b59bea17882ba3bac058562ee09,937,TRUE,971,34,
97b2742ed7fa81e019c5082191a0fe3c,2395,TRUE,3053,658,
fb2278612065c8ec3592cdc502bc9d6a,393,FALSE,2275,1882,Dire
4f9d094d14c10a309dd253afa9c541a1,1912,FALSE,2951,1039,Radiant
c3a7adca4349713d540ae111c5a4fa97,250,TRUE,2874,2624,Radiant
77f7adc31af749f331ba04119585e767,1769,TRUE,2036,267,
4aab2235630e0bbd32c37d464dfd7582,1433,FALSE,1742,309,Dire
005feb551021b05029ac1ce127466ecd,1273,TRUE,3145,1872,Dire
1d71df98bbb2828e453f1679c8673810,1070,TRUE,2481,1411,Dire
fd12d947b6607be3be2f08634cc9410a,1416,FALSE,2641,1225,Dire
b7dbf2dd48f1f5ebc6395548baf2b054,1927,FALSE,2790,863,Dire
a5f220adec42dadfa9909272051a56ec,2115,TRUE,2811,696,Radiant
83c3c3839aa9fadc515c15bef153e16e,1688,FALSE,2538,850,Dire
bc9bfe156a404eb2a2ee0fa4ab4b88eb,400,FALSE,1378,978,Dire
81c6ae9faf121edad042360cfa3582fb,16,FALSE,2003,1987,
88122f7beef3dc7948b598461378eef2,1502,FALSE,2865,1363,Dire
257d323f216173b8d328a7dcf06f743c,375,TRUE,1709,1334,
687496cd5d661421aa292af6ee1298ed,1756,TRUE,2371,615,
0f3c286cf00c91953ce2d5b01aedcc7c,703,TRUE,1331,628,Radiant
fdec161ba99825125da50f91fe22472b,1148,TRUE,2520,1372,Radiant
e7990d0166f366162f3165b6fee689b0,1078,TRUE,2854,1776,Dire
07ade550369bbebc2342935ae0a14d52,2618,FALSE,2840,222,Dire
00d9b8d726d3fcb45b8da5a7f6373ffd,373,FALSE,1279,906,
63606a6546e9bb03df8ae0ec856f2ca9,1626,TRUE,2514,888,Radiant
0eb28081f05c1aea3acdaac7e85f9387,737,FALSE,2123,1386,
72a757b4d261446fd9f1a96dd25d9c88,1104,TRUE,2209,1105,Radiant
ce51b1a7e6c70b1f4f5b4aa39e962a98,254,TRUE,1749,1495,Radiant
ab786d948b8706ed1a17324b6a445b8c,284,TRUE,1178,894,
bd49af499c8b1743bb35df94dc8d953b,1896,TRUE,2618,722,Radiant
7e77627e71c6f7eddd1a8d154c37a389,788,TRUE,3065,2277,Radiant
d52dbfa33445ea7a6791bfd7cc2bcc73,1662,FALSE,2058,396,Dire
a823ad46072f85d221881d8b34fadb01,743,TRUE,1283,540,
0bda36070f931aa3062ad939566ed1f6,2461,FALSE,2870,409,Dire
ef6fa9c014253b845159b14f3d13db12,1423,FALSE,2381,958,Dire
7fc55265e4efd880cf69f82e64620fe1,1928,FALSE,3244,1316,Dire
7ea8b22e57de5212a792e63f5401c8c5,367,TRUE,1649,1282,Radiant
fd6ab8f1ac4861ab01465151aa6e38aa,768,TRUE,2555,1787,Radiant
def0b1045382250c1f155fbed8c8389c,1888,TRUE,2772,884,Radiant
d0fd912753eb3d207f73bfc6856cc1a9,2218,TRUE,2321,103,
ca189e783a852b7802f5039eb9f55805,1167,TRUE,1752,585,
cda14be1df7e44aa3e860f0d52250fbc,1282,TRUE,1803,521,
bceced22ac68c8c962c180aef6259395,1052,TRUE,1632,580,
33bd0086dcc02d0b7d7d4ddfb1b5f066,1881,FALSE,2171,290,Dire
73789f6378d980c30824afd59c402d97,238,TRUE,2448,2210,Dire
93425b30354a96f9d7376b8d667a898d,715,TRUE,2193,1478,Radiant
3364ff99a69189aa99c13783283f7495,1232,TRUE,2007,775,
7a44e2728384213885ba6b080389a0c0,789,TRUE,2208,1419,
7b26a1487b7f13730eb5da22d50d1b3a,1084,FALSE,1732,648,Dire
1ad7f26d5293048c5e3b579179e3c8f5,1356,TRUE,1755,399,
6489448f171dda7a279c5841aa5e33d7,593,TRUE,1728,1135,
5aca27d4ec0a8d2af48874f76e440bd6,896,FALSE,3298,2402,Radiant
7518187e46f02e3f506987bcf6bb59fa,152,TRUE,2137,1985,
e99ae0dc04802973c7eb2288db8911cd,32,TRUE,2659,2627,Dire
9cb21c3d6c342e0b6f0d55ca1dec3b9e,71,FALSE,1483,1412,
d8e48b5a044b0dcfb3f8c10c78baff53,159,TRUE,1617,1458,
694dab41f2eb2f4d256aa11e06d67d99,1672,FALSE,1765,93,
ccc6adbcfdd271b5d908f843e04d17e2,414,TRUE,2239,1825,
57d20c2c2eac5dc6f023abf81d102d06,210,FALSE,1457,1247,Dire
0e43de39c0d44cf94a89629906e68f6f,605,FALSE,2164,1559,Radiant
7580937664decc88d63d35c5ada1535c,1977,TRUE,3508,1531,Radiant
254e306a4cfc0af99426f7c9153c7b0c,1565,TRUE,1802,237,
b3f915bdfe0fcc9106667c6327b8e539,1742,TRUE,3003,1261,Radiant
8bdc21ff70e6a7dac6066911324d1285,2059,FALSE,2979,920,Dire
42adf9215369ec12c8768e041069d5ef,3081,TRUE,4056,975,Radiant
5a3dd1eeddc74478926c1c2b1a8bd041,686,TRUE,1795,1109,Radiant
98be5993fdcf2240a25d4de25b09fc6d,983,FALSE,3315,2332,Radiant
03cd99f3d2ac4742366296531662f6a8,2048,FALSE,2639,591,Dire
2932c48add1eb3800b06fb99344768a1,1861,FALSE,2228,367,Dire
8d8fe45ffaa996a3a26e4f09b1286f2c,2111,FALSE,2248,137,
d47b2e983cb3dc5ecad17ab931454a3c,2025,FALSE,3711,1686,Radiant
e1c284685a5fbd1358466f4558fff128,1046,TRUE,1507,461,Radiant
9fa900f6175b1e2bcbf979bd67fa1a24,622,TRUE,3105,2483,Radiant
cd05e7292f15c5cfa73df4a194973fbf,644,FALSE,1665,1021,
0878dc0f3237cb65a9d0ceb7589f6586,1024,FALSE,2228,1204,Dire
2be0a82ce414e8d269c426f5dfddda43,822,TRUE,2745,1923,Radiant
63d8d9292907d29192cbf75b2819103b,926,FALSE,1981,1055,Dire
20d6b3ddb954bc5be3f708d24c2d4e6e,1465,TRUE,3551,2086,Dire
52aee5e67d513f2979b55ec8dc8eb4b2,1242,TRUE,3179,1937,Radiant
240e42f70241ab743cdbdee6c0367d8e,73,FALSE,2652,2579,Radiant
446cbbcebfde8053cded0257f7d52286,630,TRUE,2920,2290,Radiant
ac09286d8c748fdc9a2cb4d44199740f,11,FALSE,3382,3371,Radiant
8e6ecab0829158ef11ae82fb7dbb2ae1,842,TRUE,2487,1645,Dire
1dd97514979f788ad99ef23b369e1248,1362,TRUE,1541,179,
578013acd135a5549b8a2b200c93edc4,1255,FALSE,2222,967,Dire
086dc80812a2797185385c99928cb1da,139,FALSE,1341,1202,Dire
c3119a36d78ef5ba688b7a43ed3ba824,238,FALSE,3063,2825,Dire
e6a59ef5c44b532e8624f32ba5aa6c1f,40,TRUE,1629,1589,
fd19007815f9f63c00ec4c48d5906d5e,1343,TRUE,1935,592,
2f45261d0979ebb6b6329c674c6c3be6,315,TRUE,1089,774,Radiant
3bf9a3adc078dd6f22c5428db3330ff5,1374,TRUE,2240,866,Radiant
1a171f943740bade23c6754bd7da2ae6,2093,FALSE,2565,472,Dire
0205fc443684b4f6eab19f503eac5300,1116,FALSE,2077,961,Radiant
d50b7d7f6b665af792e54e4717bc31f2,1473,FALSE,1765,292,
2056af30fe81a8449944728daa8bee5f,812,FALSE,2436,1624,Dire
3127cc19b4f8eee3934b523d4c714683,70,TRUE,2245,2175,Radiant
c4c6e05bf09e1474493d1272c6eecfb0,682,TRUE,1977,1295,Radiant
b39472fdd8a705ced077b630828e9c38,1136,TRUE,2337,1201,Dire
e0426e39bdf64cdead51689aa0aea34f,423,FALSE,2896,2473,Dire
5b148da9996dd3a0d27940cd11a4cd35,936,TRUE,2014,1078,Radiant
c5d8a1c420733238ed93a7af4479c348,817,TRUE,3552,2735,Dire
463f527e072e0b6f32be13336a5f080b,1772,TRUE,2160,388,
5fa4b7f3ac2879f6283bda6376acad57,400,TRUE,2419,2019,Radiant
0df246a08f9e276acb23266a8594afc2,451,FALSE,2057,1606,
787697a0c38b098e507b6d54611b035d,993,FALSE,1766,773,Dire
87631724385f06cd6105c7fecea0d34d,736,FALSE,2010,1274,Dire
e1d12d853011fe901a71909d7879cc5e,2564,FALSE,2822,258,
3e0eac37115e7df20ac0f33d1f4e5d7c,2117,TRUE,2181,64,
4e413cd8dc83f52167f0483a24e1a60d,2408,TRUE,3038,630,Radiant
9e170329d9e1b0e87670080cddceada8,522,TRUE,1337,815,
60dbbd97a509ede761de587311da7797,38,TRUE,1200,1162,Radiant
8d3e561aee50fb02d00ee91bc5668a45,1701,TRUE,2544,843,
958d6deb4a99a2a87365b204f80ac33c,87,FALSE,3392,3305,Radiant
277413fdb7b4056d579677536b14e34b,1025,TRUE,1578,553,Radiant
3a29223a4af714d4272456d60f080ac8,918,TRUE,1719,801,
f461078d1602b9f49e34536ed785e034,1562,FALSE,2529,967,Dire
78c04f736480929d130f29ddcc1798af,1313,TRUE,2196,883,Radiant
e4095c7563fe167eaa692c8bf01180f5,1571,TRUE,2453,882,Radiant
85fb19164ca1c258d6812e5660242e8b,1438,TRUE,2279,841,Radiant
8a2456039d1d2b0050da31c438c467b9,522,TRUE,1191,669,Dire
2aafb5e42f509ab34a729fe5686b098e,34,FALSE,2193,2159,Dire
982bd50da9732b9c5a9107c16eb38194,1993,FALSE,2675,682,Radiant
c65b68b3219d4cd6ff3000c18f3f2e99,197,FALSE,1236,1039,
c6e18e88cc8f8c63c98d8b926f99cb94,1834,TRUE,2033,199,Radiant
17f9ae8fe320a3207c54292478bfe6ec,836,FALSE,2500,1664,Radiant
594f90bee57803246408202364d495b3,1257,FALSE,2534,1277,Dire
21b1da743bd2580fae4312aa41f753d1,1460,FALSE,2212,752,Dire
ed783aba56b7ac7beeb615748658a768,1374,TRUE,1457,83,
cd907345533baf0e0c815ee54df895cd,780,FALSE,2059,1279,Dire
7975068fbbcdd1dd9fbece62ca785b8e,353,FALSE,1890,1537,
de33c7edf05aa9bdb23537556a16b47c,2430,FALSE,2467,37,
391f6b26c28cd3fbc9b8f6f3a2051f8d,1863,FALSE,2498,635,Radiant
8c913335e5e7af6d8a302d63a6111e35,2415,FALSE,2983,568,Dire
84b50bc93746b45efacda7bbb9337150,1556,FALSE,2296,740,
2ca7e99259bd16770bd80e15c0961f5e,2409,FALSE,2918,509,Dire
74479af12afba983372b7efca7d4711f,718,FALSE,2780,2062,Dire
3d4e4baf833f39a920e41fec9122a6cf,2550,FALSE,3368,818,Dire
da8d60ac776eeb966d3dd7eff501bc66,126,FALSE,974,848,Dire
87c90789482c2031e52d4c71b00d7bc2,257,FALSE,2250,1993,
be76edcbef962a8e70aa40f348480589,1935,TRUE,2421,486,
c0d63c3b5663e6f0c36ef43c625248cf,274,TRUE,1539,1265,
0969c10d37b8d0b17d5caa764709d1f4,460,TRUE,1931,1471,Radiant
e36742dc0604b7913af9441ef2d9d511,628,TRUE,3226,2598,Radiant
7e3615182f61e73b85b18a1fec1bbf1e,1895,FALSE,2240,345,
80e48026f6fc9050510db51894ed10e0,2291,TRUE,2388,97,
ba4582a7eff32d36f7132716f4044bae,1006,FALSE,2005,999,
337c44dec3599c324a6b17748bdb6b8e,220,TRUE,1769,1549,
ace5a89d5ecf4e2d465dacaa9905dcf8,1636,TRUE,3008,1372,Radiant
b651f3567e563af05e302358afc451b3,1527,TRUE,4398,2871,Dire
80513d1e8d121b1f039b65d92041aad6,947,TRUE,2001,1054,
530da0a1d7e92ff4bd6fa284b6d4aa4f,1855,TRUE,2559,704,Radiant
33359a43bbdeccaba43f67971d8922bd,1146,TRUE,1782,636,
70a1109951b264d2435f3a60298eaa5b,129,TRUE,1817,1688,Radiant
ffa92c55189999bda67ad49c52fa857f,262,FALSE,3232,2970,Radiant
dfba9c550cbfab307941efb0003744e1,3053,TRUE,3268,215,Radiant
fd49615572c914a81a6b44d3fc5c756e,729,FALSE,3089,2360,Dire
8b9967c6d2fe7fb593b04657a25b174c,1172,TRUE,3208,2036,Dire
87c77967b22ca25111d886a724fc7ca8,190,FALSE,2139,1949,Dire
2734f86aca3ecda0817c84b6b30c769a,896,TRUE,1179,283,Radiant
c27be22a3c442d76eb09736996be47b3,478,TRUE,2532,2054,Radiant
1bf162c3da3b86594f39ad0fc0b992d7,206,FALSE,1173,967,Dire
d969dc73de97b14e14e594a4b681e54f,1035,FALSE,2005,970,Dire
b2785d802cc6d90a74497360b317becd,272,FALSE,1334,1062,
a178e5b005879b8d87fa1e05ba043f3f,1631,TRUE,1962,331,
e5d7d046e48bc5f6591f872623d540a8,172,TRUE,1672,1500,
6ff15199f79730635e6d31dce21fffa6,757,TRUE,1565,808,Radiant
ababc45872a8d28c0a8d434e35467e93,1776,TRUE,2723,947,Dire
a0ce3046592c08272566fe70e9032cec,1043,FALSE,2004,961,Dire
37e84628f9b54ae41efd459c85d91404,400,FALSE,2453,2053,Dire
2e6ba32f08c0524a6fc2bba1ea0dcf4a,101,FALSE,2443,2342,Dire
8cccd6759805628e9e7ca24a039b15e1,1495,FALSE,3293,1798,Radiant
cdb454c526a5056af89a818ab542b1ed,2015,FALSE,2287,272,
d03782ba34c88cc866719f1ab81e77c7,734,TRUE,2343,1609,Dire
faaef5f113707e6a0ba164383317c65a,1645,TRUE,1684,39,
c9709e85448ab10fa9454d0757ccc719,40,FALSE,2036,1996,Dire
4380d8fd1b1c2e6ee16e964b6346e20b,895,TRUE,2031,1136,Radiant
9545eda731576d12671e2e9e7452309b,466,TRUE,1258,792,
dc1dbb63365ed7860afc0b0ae1a75f7d,1570,TRUE,2070,500,
a1e788900a0384bcd6a1717d71a74b00,307,FALSE,2502,2195,Radiant
7a8f66b5e91956d52777d291085c45ec,65,FALSE,1633,1568,
da6dd5e136d883d641a118380268ab61,1069,FALSE,2524,1455,Radiant
f12a4a3a26d0233e7b7bbeaf9c09b9ec,2329,FALSE,4547,2218,Dire
a473cacaeae426d5eb4222b92d072fe9,488,TRUE,1952,1464,Radiant
d2243dd72481a6e3de1b6c3c699b135e,1340,TRUE,2497,1157,Dire
e8d30f09e6746a426dab6082ae65c85d,2050,TRUE,2704,654,Radiant
29ff6c431d357f21ef24e83e6189d4ff,1220,TRUE,1578,358,Radiant
a9d0d75b9a2220ed7e48ad635b7dd5c9,500,TRUE,1304,804,
489cab1f46430bec0ad68b5a74c5660c,1975,FALSE,2319,344,Dire
e873311b9b76b4d011e3e4b8ff755513,784,FALSE,2177,1393,Dire
71adb1b746fe4140fa5551cbd4270895,2053,FALSE,2181,128,
ba23ee35b533a3befe918507856fd0fc,692,FALSE,2670,1978,Dire
198d095f0b0b14757c54d5b8a84c49a7,103,TRUE,1500,1397,Dire
1df3cd6b88bedee171a47183f3e29555,1207,TRUE,1903,696,Radiant
b79c5aa79fccdc63d5cafc4caab4c3c2,1182,TRUE,1655,473,
347da4214d2bfa9f2cfd573abc3e186b,1194,TRUE,1493,299,Dire
1f89cf27df8c3d742df2ccdf2a271afa,404,TRUE,1010,606,
f113ae02287ca1671a5b25bad0962d88,961,TRUE,2302,1341,Radiant
f91e0d622ed015b26c9dc863b04399f9,1205,FALSE,2032,827,Dire
8be73add21c0dc286552e2ff58512761,862,FALSE,1921,1059,
f9b248d365f0f78567e66c6f2dfa81e8,64,TRUE,3218,3154,Radiant
5098d0d293f1beb717ee50ffa14c8f1b,1154,FALSE,1844,690,Dire
bdd97692e638e17aa6877a3ca679e237,541,TRUE,1571,1030,
d1c2d3c3237f4d4a339891f265061dd1,388,FALSE,1889,1501,Dire
747a765f21473a5560d576d51e4ad5a4,75,FALSE,2631,2556,Dire
dc1a7fc3f8d4fcc3df838b7cc81c7666,1758,TRUE,2258,500,
78d4a8407f4dcdb66b65fc1043238673,1578,FALSE,2318,740,Dire
71215f0eb3a32693fd65a32a7c07f931,108,FALSE,3131,3023,Dire
d0a9707217309420bb22bf3895e89ec9,131,FALSE,2511,2380,Dire
5fd533519257d5c2ff3d879958650212,2529,TRUE,2587,58,
17b6b5af2163ca5d42d749b7a414b560,1029,TRUE,1451,422,Radiant
8b4be74f8b040c6c4476789917531f5a,543,TRUE,2745,2202,Radiant
40317f098c639d823456389e3fe1517a,1052,TRUE,1883,831,
cd6d9c2612f3d55c943ce7ce1ebde5b3,474,TRUE,1638,1164,Radiant
cc8b760d07303086e7fe382d2238815c,2904,TRUE,2971,67,
df2188c39c1e01e9f486038be30b04ee,213,TRUE,3056,2843,Radiant
57251527dbd9ac14f1ebc259507a9ffc,1435,TRUE,2215,780,Radiant
68b821190d1404a046e0a1fbe96297d5,1020,FALSE,3041,2021,Radiant
2ed8fdf460ee40c2a521bfd74afe759c,1328,FALSE,1956,628,
86c580dd4dc3308f260a18978019586e,1038,TRUE,2473,1435,Radiant
848c194733a1383ff21677097dde0a74,721,TRUE,1857,1136,Radiant
e61df243ecfb16fd14e69eeea32fcf16,380,TRUE,1842,1462,Radiant
8e26aa61c41f7f60e830454430f07f98,1529,TRUE,2547,1018,
9cb9008c9b7df97350d86574f50d12f4,1022,TRUE,1598,576,Radiant
32bc13bd47c6feefcadb7b68ade33ba3,511,TRUE,1031,520,Radiant
fbed2a43292dce2c8f70bcb9384203a0,1375,FALSE,2381,1006,Dire
27eaf0b873373f16e160b70e478dfeb9,937,FALSE,2967,2030,Radiant
179914a67863e2f12982de11c45f767d,1340,FALSE,1576,236,Dire
7c0f895d2fea7ca27686baf675206803,1833,TRUE,2280,447,
42172a575951fe2468ac720e45bbff0f,1135,TRUE,2004,869,Radiant
e5cd43d1e1683bf64899599ce5f763ff,726,TRUE,2835,2109,Radiant
36c5e5b8e4d3d123bb31f35d99c45f2d,710,TRUE,1355,645,
62c919db3f826cbc226049385b266abb,1710,FALSE,2187,477,Dire
c516a4788e126651e4abbbe60bfc891d,246,FALSE,1971,1725,
e8c7504870f36613da051b67583f9406,203,TRUE,2666,2463,Dire
31f214af161166c900bd56d5fede278c,498,TRUE,2535,2037,Radiant
84a7f3f9753f49d952dd394f485b8f34,1064,TRUE,2563,1499,Radiant
cb6bcaf6c80131f17719368ede89f416,2254,TRUE,2668,414,Radiant
01028e0e9501549d321449143c87f6d8,1330,TRUE,3139,1809,Radiant
a5472805c4db3726f4ab5b37d47e0aab,1032,FALSE,2555,1523,Dire
9fab181b16c05e573329f13e9ea00cfc,1956,FALSE,2525,569,Radiant
4a1f4f221a2dfb5fd8c9b70f8951672c,111,TRUE,3804,3693,Radiant
e4e75c49481b82f39f99f9e8c58ea943,898,TRUE,1505,607,Radiant
8d5ecca5aafea68772d84af97865ddbf,964,TRUE,1051,87,
58b75221960cc8cb5d2d04e3f7799a9e,551,FALSE,2159,1608,Dire
cccd0afd43939389015719afd7f232db,3091,TRUE,3647,556,Radiant
eeff83190e7ba08d62fb28d5144ea9a2,1440,TRUE,1794,354,
595517e023d3ae63e893f8708fdf5f8c,961,TRUE,1707,746,
e3fcdb5d1a3bb17f27f18646ad0aa548,1004,TRUE,2351,1347,Radiant
f328add2ae483cb001768fb328e6d221,668,FALSE,1912,1244,
9a5882b692fe19780c870186c1fe2453,1487,FALSE,2256,769,Dire
ec9a81f7ee6bdb7cb1da631d0f0a6b52,1794,FALSE,1872,78,
36c14778814bb521ebb79167e6cdb949,1019,FALSE,2159,1140,
8e431980e145f43c49eb712f031dafae,421,FALSE,2112,1691,
276c4a8640fa53901cd1dedfb6349deb,759,FALSE,2333,1574,Dire
e6bf45d840763dad57ff79003a9ddad8,2794,FALSE,2839,45,Dire
d0af562a8aeb3ad71095d32c6fe0d5b9,1211,TRUE,2398,1187,
75bab8622cc656bf0297aa73163b0c7b,1574,TRUE,1912,338,Radiant
7c1d4912547bfa8db2c4535d59b29eb8,2179,FALSE,2649,470,Dire
e478f60d942b20b513d0a8f3ead866fa,316,TRUE,1252,936,Radiant
5eb983909e163983b9b5871a35c79ac0,532,FALSE,1298,766,Dire
ea518bf3c1aa2f200cdab68065d10d80,828,TRUE,2013,1185,Radiant
c535a84a7300a14d47a85ff91a73fc45,1634,TRUE,1954,320,
3fc798522b11201a0787647dd8966455,183,FALSE,2420,2237,Radiant
7c8a4e17b00b9ebd8fc6e1d530c8421d,1785,TRUE,2184,399,
8914ccb40a3cc79d5332bb1d6c552509,857,TRUE,3115,2258,Radiant
6149f2a02770c26853251228d9a63b66,587,TRUE,1369,782,Radiant
e5bc3ecc0beac63d91340305a6193ca2,1684,FALSE,2492,808,Dire
9620d1868299750ad5f8c16147259a6b,452,FALSE,1719,1267,Dire
f5831a4fdcec727776b5e20e7c049f82,924,FALSE,1984,1060,
a749a6da7352696a81f852ead4b254f1,615,TRUE,2506,1891,Radiant
2ffca09360994da8fdbd9eedc4859c2a,1414,TRUE,3294,1880,Dire
5ef34acbb23f570226c4ada0430932a6,1216,FALSE,2434,1218,Dire
688e93d044108b6bbcd00e3ac8946163,1261,TRUE,2134,873,
fc465b1358c7aeb7715f9f7dfcb93840,1021,FALSE,2093,1072,Dire
745a8e54878f0044b07171b145332060,386,TRUE,2410,2024,Radiant
1cc14c70366f9bcdef35eb8a45dc80c4,26,TRUE,1721,1695,
107672708a5dceceb17f467fb41fdf2f,737,FALSE,1395,658,
197e14aa2718428c376c601d600fbd3f,156,TRUE,2174,2018,
f83b87def966b2f91e91724cd36b8543,2188,TRUE,2504,316,
c6b66722fdcb5ac4697951e336176e7c,2295,FALSE,2999,704,Radiant
cd4c169a9d6fec0bb38d459fa21d7e0e,1933,TRUE,2734,801,Radiant
5e5265eede04107e6055874b1a57f924,2377,FALSE,3182,805,Dire
e7ed22ea355f23941830f6a95c9a68c9,1525,TRUE,2729,1204,Radiant
c856455480bf5822a74018922eede6c2,306,TRUE,2848,2542,Dire
ec6f6e764cb96dfb3b5f0206258be8fd,2748,FALSE,3360,612,Radiant
01ae9a2c177c646d7070fd18eecfc75a,684,TRUE,3463,2779,Radiant
49c97ecab826e5a7d151f06a34d9e98d,984,FALSE,2601,1617,Radiant
9827b365ce48b46a8d76745f2dd41681,2347,TRUE,2678,331,
3ebb1d0563623c5d0efdb993c3c5b58d,2620,TRUE,3093,473,
5f584d5110ff9382ae1f13078705dac7,1463,TRUE,1812,349,Radiant
4f3c8f38077dcb03ad308f557fcb839f,2204,TRUE,3190,986,Radiant
8bc50aac992a081892448d062774f89f,2863,FALSE,2981,118,
c8db195d16b0be7349b0cf25e68e2e44,117,FALSE,2422,2305,Dire
b33133b646b8f866afc4f067f507e4a1,462,TRUE,1905,1443,
cec279dc8e3281cd0af0fad0246b80db,516,FALSE,2170,1654,Dire
cc6778a14ba164d486d41a3be0808706,353,FALSE,1047,694,
18df6b023c5db444e17afb61692a1bcb,563,FALSE,1643,1080,Dire
41534372ac669226ff7f0384e187be27,369,TRUE,1377,1008,
8c0f8f88236ff2b18c20461163335bcd,263,TRUE,1447,1184,Dire
c569501fbb43f237aa256072ab6818a2,716,TRUE,2089,1373,Radiant
39de9e3b474fe1d80cdec6958df2c468,3011,FALSE,3296,285,
9c43c8c6f5909d6b8586601b0e9480fc,2420,TRUE,2796,376,
e38a1195b3785dbbaf8f288453b4e243,699,FALSE,2722,2023,
fc2ac1aa8f9cce88f2bb548b656131b8,48,FALSE,1668,1620,Dire
28e98c78ca754201c02440b6512d9551,1528,TRUE,2049,521,
bb138994a214707f0f8d1a139e17e2ba,562,FALSE,2922,2360,Dire
d56ad3cc56ea9f381bdeaa2af71f1857,108,FALSE,3571,3463,Dire
c6850bfe104abb7d421110cf14acb6d4,480,FALSE,1762,1282,Dire
b58cd64d6dfc60714f9ca17348223fe2,975,FALSE,2774,1799,Radiant
8d7303ba790028dc7b780b7538deae36,1873,TRUE,3445,1572,Radiant
26104e7ca4792a95ef41ea19a3b6ae96,54,TRUE,1988,1934,
daf535470f749c4fa1973d1c7f751258,1049,FALSE,1568,519,Dire
eb4c6d5cd2e7c25a1dece5617bba62c3,1093,TRUE,2668,1575,Radiant
8220c4b5ee29cec1df762115885fef3c,1379,TRUE,2506,1127,Dire
e258bd19afef3044592653c2ee372b4b,2733,TRUE,2919,186,
fc01ef5a7e5ba8d0ce4ae35048351d88,709,TRUE,2644,1935,Radiant
cf8795aa756f7d832ddae7da711b8091,1462,TRUE,1989,527,
9bcacc761e296f9190acf260cce30bab,1058,TRUE,1555,497,Radiant
d2d279d0ea09fd342430828bb9ed2660,631,FALSE,2445,1814,Dire
d51b39f82569d94c8155b8e76655a3c7,1798,TRUE,1953,155,
781b1089fc7a0b977e865a13b1f8b879,2284,FALSE,2687,403,Dire
76227ddb84feeb193671ed5fd75bdbb4,2726,TRUE,2797,71,
182879decc12ed7b03a8931f0f1bd2be,866,FALSE,2888,2022,Radiant
21c2d9712c61df88cd2f407a37d8493a,2761,TRUE,4117,1356,Dire
355cd5a789c1314d1db61f2d3ec404f4,711,FALSE,2296,1585,Dire
b29c3c2d9e6f0312396b394a1e51ceb3,528,TRUE,2440,1912,Radiant
383b18220e4acf487bbf5e3dff483532,1486,FALSE,2845,1359,Radiant
7ee7210b7494cdb053a998eb2d0ce817,1309,TRUE,2377,1068,Dire
1f8c618fa5619c142d1e133253bba8a1,133,FALSE,3137,3004,Dire
29b8856dbb3025168ff32bfafce47b18,1551,TRUE,2014,463,
cfd51e05e29f4be72a230bd43167c4dd,1343,FALSE,3074,1731,Radiant
e21fed1fb08dafe832c3594d6656b438,1424,TRUE,3282,1858,Radiant
27c4df4d66fb6aca571c6db667246a1e,2910,TRUE,3867,957,Radiant
be9c167d64f17373d7fdfb27312ddd5d,65,FALSE,2481,2416,Dire
a7e95efd0c78baf6806fd1272f41b8b2,676,FALSE,2050,1374,Dire
aaaa60a5131ba5f03a12563ebc15ba2a,497,FALSE,3001,2504,Radiant
c4bafc3341e5b3eeeb73585c8678a33f,3176,FALSE,4180,1004,Radiant
184033aa8c45096d1b131a3534b5c588,290,TRUE,2221,1931,Radiant
37791fd70c587de1f6ae1fd58b0d9281,1242,FALSE,1939,697,
3585ba3f12ef19bf77c1da91ce16fe19,504,TRUE,2537,2033,Radiant
725ec4b525a20f3088842bea2a22132c,15,FALSE,1634,1619,
298be8c4893a6bc68f92bdc734a31e01,1171,FALSE,1905,734,
9c2b6eaef60b3ac402ce02f3c5c22255,797,TRUE,1391,594,
01bd785a913aacf0df801e26c368ea27,1857,FALSE,2885,1028,Dire
93df2083cab8c30b2202abbba1c484f8,882,TRUE,1784,902,
372905100557b0ba8cb6d8d377a1419b,46,FALSE,2211,2165,Dire
e8f639777817fb9e78f250ad96882848,1519,TRUE,2875,1356,Radiant
991d6bb851b80b9407e240b15df04ee7,2247,TRUE,2280,33,
06efd2f7cd238f78cc0be64415c88a67,1068,TRUE,1809,741,
dd83e232d0a0d18540a7dfbb26922a76,203,FALSE,2685,2482,Dire
bbc3667af8894ee1d4346867c2d52b59,881,FALSE,2804,1923,Dire
8c41051c5c7410a70ec3746b1b9f6cd4,1231,FALSE,2180,949,Dire
0179c63509d3de2f529d8033787aaa49,1452,FALSE,1952,500,Dire
d73e518f4bd1272b364e04c24af91c0c,134,TRUE,1985,1851,Radiant
3cc42c8b9892150256dbd217fe250894,701,FALSE,1672,971,Dire
8a029e164cfb7f560ecd4a22a2b6eb9f,245,FALSE,2508,2263,Dire
bbeb13af49dd320cb7ac64d993c40cbd,687,FALSE,2336,1649,Dire
0a6ae882bde06a3b163abc2843464b69,2139,FALSE,2992,853,Dire
3f3e99c632d6335828cc29de1fff853f,1292,TRUE,1328,36,
cb1d6b05fe9b31a89b2f8ec2711b36b0,895,TRUE,1442,547,Radiant
1c618df91c8ef7c53aae2e502c48185f,1157,FALSE,2353,1196,Dire
496aaa901cee977d12eb0412eafef854,1815,TRUE,2634,819,Radiant
e6ec39d9054832637538aee3664033ee,258,TRUE,1945,1687,
5aaebb50f8103dbbb1ec642148edb11f,2675,TRUE,2767,92,
75c37a137a45dd1e5ab0fe82af832504,366,FALSE,2248,1882,Dire
ba9f5a8d2a35b4700c848443419d48a0,1013,TRUE,2042,1029,Radiant
20ca5a1ac0e67c5e742b85e47a88f152,2024,TRUE,2315,291,
94ed28cc3432a680640d16867dd07bc2,3256,FALSE,4064,808,Dire
7ba2a3ffa16fdeb69fa3e308b2570ed3,2131,FALSE,2240,109,
4ecf4ccc07f485533643f33b931bae55,30,FALSE,1625,1595,Dire
24078cb06291b74ab9541f4989f16782,246,TRUE,2312,2066,Radiant
b1278bd43ecbfbdddf16a638c66456a6,349,FALSE,2140,1791,Radiant
78ab3e7cd0725d16389053c55179fad1,99,TRUE,1208,1109,
a437299bc69825e0c2576495605702f7,361,TRUE,2197,1836,Radiant
609d9d8e91e2c5c384a68099fe93843d,399,FALSE,1139,740,Dire
6c25d95f836ca183dbc966e9c2f1054b,2763,FALSE,3196,433,Dire
4cd4497d38913846b740539cc7379b14,2690,FALSE,2821,131,Dire
18bb77469d485fd662ea0f1e2a0f5b0e,1042,FALSE,2385,1343,Dire
3822e66b629895ccbf0d908addf9972e,1293,FALSE,2251,958,Dire
e64bbe601d303fc47a79409331addf25,3240,TRUE,4648,1408,Radiant
d3f1462d9e49aed1c9e9f2d1970b1cbd,1513,TRUE,2573,1060,Radiant
9df690a62a287a0ced56f2cea1ba2343,10,FALSE,997,987,
a71cad2e4895b4d15c2fb7f244886089,219,TRUE,1941,1722,
de15dea77675c06d612e1a5e185efe53,1061,TRUE,2577,1516,Radiant
16187d6031dc0bf018a34e71117c2903,2243,FALSE,2387,144,Dire
ab08687617e9923b79f955c395ea76cd,153,FALSE,2002,1849,Dire
e5200bfb33425c6315f37705a5713973,143,TRUE,1904,1761,
84f7d32d199233059c312dc61df554f2,881,TRUE,3388,2507,Radiant
939c3a81696405c133efddc9fb0e2db6,205,TRUE,2014,1809,Radiant
feeb1170092bb453640c0a24291c1ee3,553,TRUE,1512,959,Radiant
4a36886161ad735ca62942494e6fb809,889,TRUE,2206,1317,Radiant
2698e6e371e996c8bc63c854ed5d7398,2030,FALSE,2517,487,
eba1425f05c4a74960e441f966d3db7a,800,TRUE,4106,3306,Dire
a8feb25b274a5ce9d9f6200721821421,368,FALSE,1074,706,Dire
62c59bb27ca554883b7ce6e9534a71c5,309,TRUE,1408,1099,
7b73eb227247b03f66a52dad8621dfbb,1699,TRUE,4491,2792,Dire
e10322276a46f610aff2fdd5cc3a4ddd,176,FALSE,2518,2342,Dire
c662640039d574aa6edd6b4cae7d65d1,1248,TRUE,1737,489,
7e2644e53fb142cf68eccd9f7aa092db,206,FALSE,1915,1709,Dire
6ac52cc2777ed2fc4ed00c6ba48da4bc,784,TRUE,1006,222,
eee589e0e177cbe9c01902a58e974eb8,159,FALSE,1738,1579,Radiant
2a609a0f05a3b092a6e1ae90f7aab316,850,TRUE,2132,1282,Radiant
83f3fc61b99cbe80118425140b1bc46c,1553,TRUE,1795,242,
223cfc0d9664f13e8a46cf0b6a97227c,906,TRUE,1808,902,
8d4a5d8a6a5697d019abe79e97ebdb54,153,TRUE,2082,1929,
2c266d498465ca7c327f1978332b4ea7,1597,TRUE,2734,1137,Radiant
b3e1396162a1fd094ee86f4a7af2f44d,1456,FALSE,2522,1066,
93ec74e0f8e92c5fdc8be3c0e9528292,276,TRUE,1672,1396,Radiant
483076eaa227489f6d6077f542064331,828,TRUE,1531,703,
3a51a02d944079922fb51130ce06712e,1803,TRUE,2042,239,
553fb9796fe3cbce02e282f8088beb49,913,TRUE,2575,1662,Radiant
30939498ef46f8a08ef0fc6e71ab34af,429,TRUE,1744,1315,Dire
7d7f5e10dada28b2f1defa3e91ca15e3,2805,FALSE,3215,410,
e40663b42ed9cab8289fddae8d786052,193,TRUE,2717,2524,Radiant
4b0490ed03e8a0e5b989fba20262fa87,1356,TRUE,2290,934,Radiant
a661655eb69ec1dc934c4df65204fb77,299,TRUE,1983,1684,
4c069a464d44bf7baef2fb050cb67164,497,TRUE,1559,1062,Radiant
9bfca718defd2c3855385f2067f78351,2156,TRUE,2985,829,Radiant
8ece4f303d6794d285fdb980caf0179b,1209,TRUE,1830,621,
e1679d421ec0be81bcc693067c4abb4d,1995,TRUE,2196,201,
62262b61b7cea640dddc2e5aecb898e7,64,TRUE,2097,2033,Radiant
48807543c8ea0db766dec46c340a50b1,1479,FALSE,2770,1291,Dire
5cabfb06f940edf824d051bb65445e47,433,FALSE,1783,1350,Dire
204fbb6e2e424922c7e7da833cb3d976,174,FALSE,2425,2251,Dire
d87f3795ad49d167430620551f67c2ba,1812,TRUE,2593,781,Radiant
a61c6dcb40e0df77827692b25316ea3d,627,TRUE,2829,2202,Radiant
3f9e2599a2a448614ed6af903c03b9c6,1081,FALSE,3171,2090,Radiant
490c1a673874dc18013be8257da3b837,1172,FALSE,2707,1535,Radiant
d4afe639c80d530310fa88eddd134a98,1258,FALSE,1351,93,
06ec60adb53d2403227c37c77bcd4930,932,TRUE,2157,1225,
fab278a8e136101003eafa65545e4d2f,639,TRUE,2470,1831,Dire
8d9de3d06ba4b81baa239381cea2506a,896,FALSE,2398,1502,
fa367b284d626fad06406ab4577ef825,689,FALSE,2862,2173,Dire
9d7ea5ba21230f42a8066fe6496be794,534,FALSE,2305,1771,
223458423e50ae649d5081cf93d143b7,83,FALSE,2422,2339,Dire
83ae27c5cbfb8ed35ed9a00ce20d8410,1163,TRUE,1814,651,
faf16992d03eb9fa8e79c4921fff0da5,326,FALSE,2102,1776,Radiant
5ee4c49117a7af44effe2bcf715090ed,1305,TRUE,3152,1847,Radiant
193d54e34a03fe44d6dba84059640d37,911,FALSE,1563,652,Dire
b6e37c7bd810c2cca4ed2784402bdd9d,314,FALSE,1688,1374,Dire
129bf244d8fd1cd38a6d7fad69a94481,158,FALSE,1380,1222,Dire
228f3f533a508b12db157e72375dc4ce,1499,FALSE,3454,1955,Dire
5c694a458c5ada616beaff6ad6c5ded4,512,FALSE,2703,2191,Dire
57185fe225b2cbc3309f4c1e259810f2,968,FALSE,2492,1524,
d346a17fafbb32666c4971e82c81f331,1397,FALSE,2177,780,Dire
d8f1c46af8f46ba08c8025dc6a6d989c,1409,FALSE,2011,602,
9876555967a64e07744f861280c6d0be,350,FALSE,1728,1378,Dire
dabb7e7e3322d58dfc3178e897d04e1f,1280,TRUE,2727,1447,Radiant
391584cf06e8b6ae4052227201650279,1735,FALSE,3037,1302,Radiant
e15596ea301aa442815945eb767060cf,1164,TRUE,1884,720,Radiant
507686a42af08ce00ffe495f79cf8ffe,274,TRUE,1950,1676,Radiant
00baf1535e6063e5fd102cabbf3b8ff2,1407,TRUE,2487,1080,Radiant
710eb7c10a32c400e4d2833caf1ae7c2,1438,TRUE,2196,758,
c87dddda8c6a3d38eab53aaab2ebc8cc,767,FALSE,3074,2307,Dire
93922e123c08dc830e80e205c0e62fc3,1112,TRUE,2099,987,
9ce7cc8b69ad7dc66a9e77ec1cd8fe3d,451,FALSE,2571,2120,Dire
ab81e8e8da05cf5aa7bc698f00c5be0e,644,TRUE,960,316,
5acb3a64abd555105b7e2ab33a205175,726,TRUE,1337,611,
c715d5a5bfd2d50209580ba327164faa,2026,TRUE,3173,1147,Radiant
938ff0720bc6aeb635d3617b63c23a6c,1031,TRUE,2044,1013,
81d57346e8ee9cb96ea95de6f3dcabfc,530,TRUE,1308,778,Radiant
9b4f4433ed33cd0b43c4205b169aafa5,2129,FALSE,3740,1611,Radiant
bfbc78cd70a545073e95331624903ffa,2852,TRUE,3617,765,Dire
2dadcda603036737f23ba05334b8854e,1983,FALSE,2362,379,
4d0f5feb3a1cfa517b6cf384a489fcd4,1662,FALSE,2581,919,
f1d8245cd70d1a63a709d9079d6517b3,1791,TRUE,1985,194,
61d0077e9fc06aad51aeb578e16fc37c,1316,TRUE,1793,477,Radiant
1ab9323718fec45496f1660415815f94,2111,TRUE,3011,900,Radiant
b4dc628bb3a0cc92203889f15b2578a5,1158,TRUE,2317,1159,
218ce67c05e05c97b76b06e57643247b,929,TRUE,2393,1464,
b4b192bf383fe071bd6309b93a7d798c,1252,FALSE,1921,669,Dire
1f4cede604f81e621f3556b3d1062ef8,782,TRUE,2273,1491,Dire
7d220c09b50601ad5b51a1028ad623b9,1622,TRUE,2110,488,Radiant
c7515ec66993922ede1a5763be6203e7,1937,TRUE,2043,106,
e0e655aa9c1d63f7fc75e9153eff5109,365,TRUE,1823,1458,
81caec2659507110161f6ff311b6a215,2130,FALSE,2363,233,
271d0a1c4db0f5239a2a50ef92e65f44,6,FALSE,2228,2222,
d85560200d16a947232047191f8c00f4,476,FALSE,2194,1718,Dire
43898185bcf2c3acdfefcf8bae13894f,1084,TRUE,2253,1169,
b9cfa1a9cfa2fdf7111d8f772393eef8,2302,FALSE,2557,255,
24a4d7ae4e9fc4e6754945d877f413df,2018,FALSE,2509,491,Dire
8164a9fa56e9178d6f8ada9f0b779486,2085,FALSE,2734,649,Radiant
5609dd4aead6d5c76e70239dce45a66d,185,FALSE,1970,1785,Dire
98e1f104922980b216ad6b6a7215d02f,112,FALSE,2001,1889,Dire
ac44834b2e10913cfaba2b1b5668da5c,717,FALSE,1717,1000,Dire
63148fe6ce060875ee5dae58b28e6ab3,270,FALSE,2197,1927,Radiant
dc3d7b03687ad55b6dee6a5a68506563,1399,FALSE,1471,72,
eb05b3a7b99297e372287bd0d91ceaa9,572,TRUE,2416,1844,Radiant
2b64a2a064bf092825a26f5ecea78944,1777,FALSE,2456,679,Dire
7dfd3ce165316b0e22778490bd038cdc,701,TRUE,3428,2727,Dire
1acce60892727d27e204f0f6fb7bfde4,2060,FALSE,2580,520,
23988fe2ed211f09f47d932971da8a56,167,TRUE,1797,1630,
f3022e98b1fd28495d948cd995beb91d,905,TRUE,1386,481,Radiant
3d83a234e28588385e5693accd25b928,888,FALSE,1915,1027,Dire
2c9f80b6dc9994292311f79a71496a86,3129,FALSE,4047,918,Dire
15f7dd12f94cc3dfe217b1a960f40417,1197,TRUE,1425,228,Radiant
35a0d3ff89b4be2ed15d3eef8dccb98a,2090,TRUE,2336,246,
fd4cf64f4a79780d4d3daffa89ddbf9f,74,TRUE,2024,1950,Radiant
1a9acb74267ab60bc763ec0c72d7a60f,612,FALSE,2284,1672,
1784d34bad7bd4467f00104736b7d1c4,443,TRUE,1529,1086,Radiant
744e4139513181bead61213914f86ade,1856,FALSE,2301,445,Dire
4d82c8cc4d771e1eeb71192672710036,1288,FALSE,1734,446,Dire
d898e70fe89b181ddc310e19d62e1a56,1410,TRUE,3468,2058,Dire
59ca610bc8a1e3e73220980714bd8bec,1022,FALSE,1905,883,
6ee6f5f3854269465f1ae0f30c1817bb,789,TRUE,2047,1258,Radiant
23822943f1bd36e75711c2c5804756cb,184,TRUE,2551,2367,Dire
943f8881ca242ea58bb74e62aeb49b56,1151,TRUE,2545,1394,Radiant
f0d84264800040a5256a8bfd4c364d31,319,FALSE,1099,780,
5dc1e44463b4e792b527c232778add8e,903,FALSE,1791,888,Dire
3d22b89883e919a871b226de726e5891,833,TRUE,1060,227,
0789e1a0a8c9125d69c941762b3f2bde,1172,FALSE,1455,283,
421a56938b64574de9af2e6ac042837b,1154,TRUE,1561,407,Radiant
c27831ff44f658f6516d272bc3f73e1a,537,TRUE,2227,1690,Radiant
ed79208f4a6227e87168f75eb8b9ca16,1678,FALSE,2531,853,
be3308c616a7c6d140ed7a0b8c539672,513,TRUE,1939,1426,
ba3f49ac72bfce5670c2b2c1b058002d,654,TRUE,1584,930,
9c1415d2226a64e56e771b9093a33bf5,1689,TRUE,3155,1466,Radiant
0d575726b880156188f70cc3c66802a5,985,TRUE,1897,912,Radiant
5ab9ec67777b96d204a70f61544c45aa,1798,TRUE,2779,981,Radiant
2c2ed1cb1b499e5fc7577376a8cc629a,546,TRUE,2083,1537,Radiant
917793715f0d49d604e0461045e175e8,1250,TRUE,1880,630,
2d46fe11e829b7e43f7daa2a47664ca7,431,FALSE,1877,1446,Dire
1f84c28dac29689057145e510ea44062,796,TRUE,1725,929,
020b609582cb24f6ebf3636e14550921,1506,TRUE,2141,635,Dire
15ae0ca41f2719d1f84ab21223ce1901,323,FALSE,3089,2766,Dire
57d13ff14e118ccb00c0fae638695498,1027,FALSE,3091,2064,Radiant
ab4796aa2b66b353a2791af0cc1cc0b3,1621,TRUE,1821,200,
2257f8c2229b951bc93d3d3851f31a9f,1736,FALSE,2062,326,
46133811361fd79fff5bb06c15e95ee0,1852,FALSE,2262,410,Dire
7b6075f03d000544a6047adeb15297fc,984,TRUE,2735,1751,Dire
9bbe338c50df211555f894db17717a19,1501,FALSE,2175,674,
8739fb835f702bb31f5a6183801536c0,1426,TRUE,2645,1219,Radiant
c7476700ecd7d468345780dadfaf1c94,148,FALSE,3028,2880,Dire
43d13dd93dfae1f7896ac50a02b15aaf,48,TRUE,1866,1818,
fa27fe5c193ed39f57df51e16aa1eceb,838,TRUE,1833,995,
f6f546bb51549fd599b2301696e13c9d,450,FALSE,2551,2101,Radiant
131eb538b2182277b888dd3a1dd25a9a,1579,TRUE,1765,186,
cc5aeca36067a61b7e5e509a491e1148,1952,FALSE,2027,75,
984de898d79722beb7316cc29e94f72c,19,FALSE,2306,2287,Dire
03a8d84f24855f7be71e450eb6d8d93d,534,FALSE,2749,2215,Radiant
d9c9c8c753d35fd232e20313af491209,1228,TRUE,3691,2463,Radiant
f82dcaaf055cdbd0a253bbfcbcb7ec7e,1655,TRUE,2510,855,
750968b1fcefe9745159918e129c301e,708,FALSE,3386,2678,Radiant
f802dec87192950eb9b60e75d9ac4faf,2137,TRUE,2316,179,
0fc83b2013b93b1a522c7bfe4fb21032,504,TRUE,2288,1784,
ee968b0f82472e4f338ca680138aab1a,95,TRUE,2798,2703,Dire
4a6559b2218faf320f6316e64061b86a,123,FALSE,1855,1732,
31f3f6551047f1f4edbb6fed80520aee,371,TRUE,3009,2638,Dire
a972fd45dc689e09d4e041ca183e570f,207,FALSE,2338,2131,Dire
97b33ce9de27d517fd9e537b971465bf,2060,TRUE,2646,586,Radiant
540ee890c0de875fa8fa0ebc39f876a6,767,FALSE,3137,2370,Dire
dc09ae99e1faf5b4029748fb413d2dfa,1055,FALSE,1912,857,Dire
eaf75714e73c66864556191addf76d52,1767,TRUE,3262,1495,Radiant
ff103ab2c8084d4906c8aadd6cb8481a,2480,TRUE,2668,188,Radiant
37167607fd08ad00b86ed00e53bc48a8,1715,TRUE,2726,1011,Dire
81d328b0c7e0eb4ccafa2249d45c5acd,1229,FALSE,2273,1044,Dire
7ce80fc00e6dc444dc980ad305df8082,23,FALSE,2281,2258,
64b2713d99bac8663b100b8dd9c7957b,1402,FALSE,2071,669,Dire
18da000fbefa37d6cd33e1f360cce004,610,TRUE,1225,615,
f3a6068b918073d2179c59f54ff32bfe,529,FALSE,2206,1677,Dire
51d6f21e77d07e8013506cd13a78cc09,325,TRUE,2315,1990,Radiant
7cd4be20afbf4325ebd76dcf6298dc70,759,TRUE,3088,2329,Dire
304473908bcc2afbd6156a559d291346,162,TRUE,2496,2334,Radiant
5d143934e984e7ab8801229fb62abcc4,1781,TRUE,1835,54,
3a53d94a8dd1c36b1dc811386d9f09e0,2213,TRUE,4419,2206,Dire
bfd89b7ff1fbf0d39f8cf00ab9534493,1328,FALSE,1474,146,
b6e813c9cb751b4625232bcf775a2a41,416,FALSE,2340,1924,Dire
52a573096bba4692bf14fe5683085916,1186,FALSE,2439,1253,Dire
2761d598368cb3efa503cb952a598e83,1187,FALSE,2200,1013,Dire
8571147ad2dc7319003726b3edc79f1f,2178,TRUE,2640,462,Radiant
90fb625157b46c82f2876598bf48296d,758,FALSE,2192,1434,
74e06ffebc34c86fb4fedb290c89a53a,311,FALSE,3255,2944,Radiant
7f2a026d7e6fe0df40b2715a801919e1,1685,FALSE,2805,1120,Dire
03e0791cb948596a560c84733da5ee42,372,FALSE,2512,2140,Dire
8f2b78d68fe06e54fcdbdcfeb6bc04b0,1079,FALSE,2184,1105,
df500da7a70a17c730382cbd7a9463ca,126,TRUE,2327,2201,Radiant
746edbfeefac998dacc065edde86c53d,653,FALSE,1263,610,Dire
06bfb66742d09b7a4461ad5044b4beaf,1150,TRUE,3076,1926,Dire
c5a5c6873eb9310b1a469820aa08f5cc,1477,FALSE,2421,944,Dire
e9b4d9124613bbdcff016d5bd8192dcf,1301,TRUE,2797,1496,Dire
b8d63d55504480dba6b991de45358557,914,FALSE,1338,424,
1cdf57ae10f86178c3a0286e6f4f65e4,1433,TRUE,2055,622,
cbde3f2f05469abfc3083a85f89c33f1,405,TRUE,1573,1168,
c8a3301f6092a0acb277f8500d82528d,1186,FALSE,1835,649,Dire
80efd58722af4d55ccd3971e28389822,1813,FALSE,2076,263,
7fff01f56e852d9f3169dbfd337e90da,475,TRUE,1113,638,Radiant
23c5e68c44ad549edbcffd54a88cfa7c,463,TRUE,1029,566,Radiant
5d4326cd6b92f66655c102490a576e66,732,TRUE,1725,993,
55214e14e04c50aa2b345dcf487e00f6,649,FALSE,1624,975,
5f472aa06876ffec33872c653df75d66,1669,TRUE,2644,975,Radiant
3de0c673e4b69d5ea4083092c0008371,507,FALSE,1645,1138,
c9f115a5bad621c84bf92798e997e81f,2113,FALSE,3137,1024,Radiant
424c91e99892a896fc63ad6e4601b0a2,557,FALSE,1738,1181,
5cae83b58a0b57f1355a8413acacd5a2,1845,TRUE,2070,225,
66ac287bfb467c92f861324d22338049,76,FALSE,3083,3007,Radiant
b1a160e8948754e7f28bb4d657faa58c,34,FALSE,2255,2221,Radiant
af8fafd62aaadf8aff4f8330e333194e,861,TRUE,3069,2208,Dire
a2ec00ae03384d8a5163889a664c0b1e,830,FALSE,1951,1121,
7431aafe6e644ee38022f61a7c17b511,1108,TRUE,2615,1507,
44a6478e4563b7d8b3fd9c8841871ae3,535,FALSE,2859,2324,Radiant
aeae5db3e572eba23f41123afed42e06,1547,FALSE,1642,95,
fffead994cdd0b729755096bfcb535e5,2371,FALSE,2586,215,
7ca6ba9f76e96664a2bddff923460b9a,704,FALSE,2201,1497,Dire
d0d8b8dc290103508ee1346a5232393e,1525,FALSE,3065,1540,Dire
646ac1ef314b0e388db53d5a1da7ce22,1187,FALSE,2581,1394,Radiant
2bc7d66ccd5121d9c4c91c83d724d490,721,FALSE,3139,2418,Dire
d9eadd5e4f0426890ae1dc9381fc686a,948,TRUE,2079,1131,Dire
afa4abd8b6d63618eca9c894f4eea223,976,FALSE,1670,694,
2aa907228380da09dc8389b0efba8adc,1462,TRUE,3081,1619,Radiant
ae44921b22a45d0ec34033f141d5b496,1782,TRUE,1909,127,
ca71627c6bd7a94a6fe7d8795d624f4b,287,TRUE,1893,1606,Radiant
2a1d2bb77629331c2ac33c9766077ebe,1058,TRUE,1865,807,
a32fbaa0fb39bff025eda79089dcf6b1,354,FALSE,1583,1229,Dire
cbe781d8d059bdce1441ab37dd03c53c,989,FALSE,1188,199,Dire
8076f254d008732cd2f6a72c81e2f9bc,82,TRUE,1805,1723,Radiant
ec879729eb1e655b4442ab17cf0917ff,367,TRUE,1869,1502,
b50af545aa27e5842000024df90fb9d1,657,FALSE,1920,1263,Radiant
32393d6da37e3a44ff8c98b234309dd3,1115,FALSE,1619,504,
59c0e72ca3da01c9aabb0b0e92ebc9fc,1821,TRUE,2125,304,
854a3f0d69b5de911dcad0fbf5eb4415,307,FALSE,3680,3373,Dire
e1e482e7c8b5710830b12cb3a1510838,18,FALSE,1002,984,
64f4b29dc5fd964dfaa2df047ec835f7,2675,FALSE,2791,116,
6b6c4f0edb1c915b4e36f699338ceba7,2049,FALSE,3021,972,Dire
b194c97435bb30a7cf65b8f2adcbe545,427,FALSE,4273,3846,Radiant
0efee9bc05d36ee1b55b54b16935bea3,469,FALSE,3391,2922,Dire
8e420369d9e0261bbdaa307995a8d994,394,TRUE,1443,1049,
9e5b53af717b4283735c49bc2cb3b802,1501,TRUE,2559,1058,Radiant
7923d002d7eecb9f56f10a20c7bb1d69,2123,TRUE,2492,369,Radiant
35c6b9ec12c9bbce9671d4e80fdad01a,995,FALSE,2140,1145,
b2d137b117c4c325486975f5db2fca11,1582,TRUE,2533,951,Radiant
57a4e58eeffeb7c5229e05d9aab96403,974,TRUE,1877,903,Radiant
30f26cb948663b7e062ad5f5cc25c9a5,1057,TRUE,1904,847,Radiant
eb37083bc76a82b79edf8f3eb62099a4,217,TRUE,1824,1607,Radiant
d1a9290c22205f14de9e3fd01f0f349c,1874,TRUE,2408,534,Radiant
78e9139eb92abc24d29c4fd5462111ce,1799,FALSE,2115,316,
590fc1abb56aaa4e55aadb7b0450d667,492,TRUE,2340,1848,Radiant
2762630fab2a678b41325c92d6065725,839,TRUE,2174,1335,
d7a7bf82e9b646e03dd3d9055e922c2e,1339,FALSE,2222,883,
e91ab1dfbfa644431da46c2b37bb879d,1152,FALSE,1611,459,Dire
b6aad5ec53975eb0f56e012216663571,1129,FALSE,1965,836,Dire
61127168b5f7a73a90d80333aef1b64d,729,FALSE,1556,827,Dire
3bf0a2b413d65912e5b98cf8f5e2f594,1120,TRUE,1663,543,Radiant
7448050ee6580534cf8e2bc87c9a6671,1479,FALSE,2217,738,Dire
6d9b4a8a0d0ea54c287f858f36df3cff,2036,FALSE,2073,37,
d39f429ae4fefa2e0b20c77a6a0e177b,1459,FALSE,3448,1989,Dire
d82aa5d58ca5ea92a08516bb051c6213,1922,FALSE,1979,57,
89912f8835cbb7f7065f68bc9a698b53,1285,TRUE,2307,1022,Radiant
29c0fc57457a3fb66137c7c43ec108dd,1986,TRUE,2510,524,Radiant
2b25a99adf289c8ce4bdf3239da48ab0,493,TRUE,1445,952,
dd38ef82f3fcd6dcb8ac74c1e5d51a98,794,FALSE,2380,1586,Radiant
0aabd72e544afaf3a7ceb25c1ea77bb0,2336,TRUE,3302,966,Dire
873037819de1bbd02172638aa1558a96,1609,FALSE,1809,200,
1827a9e34d4ecdaeaa339c76e0867b9f,583,FALSE,2031,1448,Dire
51df4c813a8086d9b7c962e377571b04,2098,FALSE,2932,834,Dire
4615dc42dbe65b0f39d80d0265f75ffb,265,TRUE,1885,1620,
0dab84e548fdf10af94e1b7977d047ca,1790,FALSE,2569,779,Dire
604095cdb40dc979afefcfa42331c496,940,TRUE,2858,1918,Radiant
d754b07cc6a71a6f69a12c22ec2d7ac1,855,TRUE,951,96,
e43e588d745749dd60545cf9d58efb5f,712,TRUE,1672,960,
5cbcf03b9352a2ded840bdf7899293a8,1992,TRUE,2294,302,
f07499c25776554de15a2b4029872209,1426,TRUE,1603,177,
011e2f4a1dbca9b8662509c7a3519397,1343,TRUE,1811,468,Radiant
0bf97e41d00eca1eb1a0d5abc627427a,524,FALSE,2949,2425,Dire
7c2baaa8b5c124d0e27c6bd4a07a83aa,394,TRUE,2570,2176,Dire
61746f2a7ab7f890a2be741197dd8465,1304,FALSE,3328,2024,Dire
a26e74424ab247da6a93369a77923682,2638,TRUE,2775,137,
a3810e6b6f7adabdadd5b5932258633c,169,FALSE,2145,1976,
453b7cd5eb2c5b747dbf0286560151da,1867,FALSE,2490,623,
ce5e9d3536e388d8072c7847c55a0e89,304,TRUE,2278,1974,Radiant
cfc5f9be7080e26d08eeb9b6ece8fdab,986,FALSE,1834,848,
405ab2922609f2b6ba7be4cb14bfa119,1001,FALSE,1953,952,Dire
2d34b51ec4cf3db8148ce042941e6520,1860,TRUE,2077,217,
9307ebfc0f9559b3929469e632394f1e,865,TRUE,2312,1447,Radiant
3c498ae503445fef3595531addac37de,669,FALSE,2786,2117,Radiant
aaf57411b19c08124178af8dc8ee39b4,939,TRUE,2361,1422,Radiant
683c8bc8927c5bf87dbeca42e43a759d,170,FALSE,2550,2380,Dire
66fda32c9476fc29881c691abd38916d,1976,FALSE,2616,640,Dire
5cb5f3ad54478c2f19804b5add55ebaf,1647,TRUE,2531,884,Radiant
86925b049c866686fe9bf0433846e4d6,998,TRUE,1940,942,
5e641512f3af4e28112b615da935669b,388,TRUE,2180,1792,Radiant
085db6828e4de07ecd13425d0fbac16c,2715,TRUE,2981,266,
08eecf897924c1eae68cd34eeaedecd3,757,FALSE,1666,909,
b5ced975566c5b615e06b5265b0df749,2474,TRUE,3067,593,
48b85975434ca5b54e27bcf88b37b8dd,210,FALSE,2562,2352,
aabb7a18d57d73815f1006cec92ba19d,997,TRUE,1438,441,
5261d811bfffd8dabec57b1cda480f90,1266,TRUE,2759,1493,Radiant
9f58a7e5afa129c75c841fff2d27f358,2091,FALSE,2494,403,
9681963c8aed619ed248034980b512a5,487,TRUE,2044,1557,
84e7105e38189fd7555a292273f027ae,2911,TRUE,2963,52,
91a9152ee9fd73cd2053b46969697c04,127,FALSE,1269,1142,
2b0ca641d41d20689f3babcc166f4b6f,1113,TRUE,2506,1393,Radiant
1853107b09e2b040a72d91625d70ca0f,938,FALSE,2136,1198,
3539011934a35da1b9e802f8c8f68608,804,TRUE,1990,1186,Radiant
f54eeec4125ed44827855c610a01f56a,242,TRUE,1031,789,
1c1bb3331743b1f98313f117d19a1faf,816,FALSE,2825,2009,Dire
2dd5a294c81e4017620013db4491340e,2106,FALSE,3105,999,Radiant
0199297b2ab401957212f74841e17131,2307,TRUE,2621,314,Radiant
d57dd08d4b506d0890215d0dee61f710,1920,TRUE,4271,2351,Radiant
752a7f9200a446fbb78f3e34f72f0a20,1727,FALSE,2935,1208,Dire
e7db0eff6808d30c8a53e053ae87615b,190,TRUE,2299,2109,
1ea6a4e2bea2c6d33fd4069dc12f0554,467,TRUE,2014,1547,Dire
95b7592713553d821fccc30d6deb0639,1904,FALSE,2865,961,Dire
040bd437d61d1fe05b7f1e9cae97fef7,1597,TRUE,1646,49,
3b08f858921219f27df1b7eba97770d0,2095,TRUE,2549,454,Radiant
e19574a6663876a5caa852b283c1b0d9,45,TRUE,1917,1872,
c0da1219066e31cb5ff9424ad6c104dd,787,FALSE,2574,1787,Radiant
462ebb05bff46fa611b11d87cc39b1d8,2462,TRUE,2755,293,Radiant
0fc94a30378dee6e6f1fdb45dac5860a,1874,FALSE,2365,491,Dire
1dd933caa341ec63989824a93309c417,430,FALSE,2557,2127,Dire
b384734e250e18aa714366143316bc78,1714,TRUE,2759,1045,Dire
9acec3d76836f0f9f2b7aaf290b0ba06,553,TRUE,2312,1759,
677b579dc49d0ede7085d9891081ff31,969,TRUE,2369,1400,Radiant
96416ec470e9564489efc8deb2075e2e,1399,TRUE,2209,810,Radiant
c10d469ef57d4993781854bcf3f1927a,2071,FALSE,2329,258,
3b8e23480eb8a8879ba8d95c190e3cc4,194,TRUE,1669,1475,
fa15020dc3821580cafbdfa753a8c207,538,FALSE,2630,2092,Dire
1488db10b1376d90fef1dad262af678a,978,TRUE,2186,1208,Radiant
ae111868220588a47a5f1ec2e98924cd,587,TRUE,1544,957,
0b1172afddbd5bf89fc27d01fb0805b1,171,TRUE,1726,1555,
2a3fa24d1927ef7a14102e8cc98efb24,1168,TRUE,2509,1341,
5294f17a8c8f72a6b036b96a27389481,712,TRUE,1809,1097,
e471b0a70162c2c3ec10e8f4bedf4a9e,290,FALSE,2924,2634,Dire
ef4f20a7ab640ece7b3d58aa0f03916a,562,FALSE,1891,1329,Dire
0212e04218708a583376c11c8d66cc7a,2617,FALSE,3342,725,Radiant
83ac679bff33889725806b9bea11efc5,1058,TRUE,1572,514,Radiant
7d750e25c37364197eacd8b7e1c0dfe4,1371,TRUE,2522,1151,Radiant
17369eb83704db1cc2d4c775d65ac6b6,992,FALSE,2503,1511,
cb20e29d0e04683e08c2f70cd5c0df35,497,FALSE,2782,2285,Radiant
3259c86c5139881e3c36d3a45fd4d639,994,TRUE,1654,660,
8733b18f7b60eaa5c4104ae93401e961,1008,FALSE,2060,1052,Dire
2a903a7bb939052b601002aa93f28b59,1713,TRUE,2799,1086,Radiant
16e49266ca013de899587484e9a952b2,210,TRUE,1496,1286,Radiant
dd8a7808e0ca84fd71919a5a57536a49,175,FALSE,1255,1080,
648c76bf865e28668aca9df8e88c044d,3193,TRUE,3954,761,Radiant
c4d00232718bb8eb6e52a4f5d8467018,201,FALSE,1682,1481,Radiant
0bd84ed5a3d4267facccc36f0987868c,1429,TRUE,1654,225,
9bab179c05e17f69cacc479b91946bdd,880,FALSE,1868,988,Dire
4acdf14593598c4fafb9256033cc60fe,19,FALSE,1779,1760,
ce47027f10f632d532690a512de13da7,459,TRUE,1417,958,Dire
efbde4fb4da5b122fe7cb746cf7fe449,1110,TRUE,2652,1542,Dire
ea3464a864fd3e17e45ee84e21d0ee8a,61,FALSE,3665,3604,Dire
c8f9d9d754ab535a9e184fcc3e358a30,3600,TRUE,4152,552,
c055e2928d0bce5399c600148de35dc8,2557,TRUE,3399,842,Radiant
178cc187afb84176bd2d12e574c4d4e3,2125,FALSE,2311,186,
8ce094a536b6d76a6d58b26b28dbcbaf,1123,FALSE,1848,725,
15c08816f1c81a167f5be0bdfc6b66bc,444,FALSE,2695,2251,Radiant
0409a5e8003b3c82d66e6df2af99941d,594,TRUE,2398,1804,Radiant
71868d04aec5aa3b50666f987bbfb58f,345,FALSE,2209,1864,Dire
2cabeddc453b64bb84332039240bb010,797,FALSE,2295,1498,Radiant
58e4edcb159d2ac12d425e11507a4878,790,TRUE,3567,2777,Dire
009becc8c3b3ec91ff49f38523c7163c,1122,FALSE,1644,522,
5af485e65ddff6a637a5c52848dd0fd6,1668,TRUE,2041,373,Dire
b02cce038885f3cfc0a0309360d896e2,2803,TRUE,3628,825,Radiant
60506763671e926e5cb9e345bee4fac0,1804,FALSE,2183,379,Dire
1640c508f2ad3a9dc871e4b97d159417,1671,TRUE,1923,252,
a3bdcec745505d78c229e594263c2e3b,436,TRUE,3124,2688,Radiant
b2c3cc5f830b5979023abe2608e156ac,455,FALSE,2953,2498,
36b3de769d8716077c3d441819c3b556,841,FALSE,1616,775,
adb9724e32363a99e6512c6a6e60c9a8,1212,FALSE,2964,1752,Dire
03bf8043d4f094e3cb072353a9af1886,1527,FALSE,2087,560,
53c556b508ce3c66e5b4703f5f175577,1254,TRUE,1483,229,
ac78765aaa42b01b27ee66200f48db8a,1597,TRUE,1988,391,
7f588414d7a05f48aee7733239b99a06,1585,TRUE,2819,1234,Radiant
d9b9866bc439cc9b416f5662912269d3,2369,TRUE,2924,555,
39dbf0b5b36de341c6cdce69968877c4,1885,FALSE,2871,986,Radiant
b1812d8a51f3d4f9a44e17a165ae9a74,1900,TRUE,2876,976,Radiant
17d922ae7773f9c045d27ecb0ef7d98c,1268,FALSE,4844,3576,Dire
783e7aa9ddf7109b041a73765691b573,164,TRUE,1561,1397,
752d017cea868fd3328c482866005cc2,450,TRUE,1343,893,
797b865933c19a1e46c588319b0318a4,1841,FALSE,2035,194,
adc462f1d215f5c5c39bc75cb0e62fdc,883,TRUE,1123,240,
824aa0b4d7983cbf4513ee3e6cfed499,1045,TRUE,2475,1430,
202ea83a34f315af8f306a02bc5f52da,700,FALSE,2044,1344,
41296cbdf1ef5724bb2783af94e179f2,1237,TRUE,1783,546,Radiant
d198316260ca92b9e194b437f1a38720,2553,TRUE,2591,38,
8895f71814338a919f7b1757e7aa2e06,566,TRUE,2164,1598,
cd000183937ff93fb1bef67576573b62,312,TRUE,3424,3112,Radiant
e0aac2acdabd57481e69b18b82376a03,779,FALSE,2207,1428,Dire
ba6dea4945d9faffc13c3e27d3d6fa9f,1811,TRUE,3284,1473,Dire
c083f4f305485912d5c73ba4fdcb0f5b,1586,FALSE,1822,236,
13ad52ac55df5623b83ba5ebad6608d1,494,FALSE,2193,1699,
db8d22cda3e73d62f82ce5736bd79807,85,FALSE,2829,2744,Dire
1b32d0357fb2a548c83f483bdfe46cec,284,TRUE,3310,3026,Radiant
f0452833a80f09a36936a1bdc6495a8c,2288,FALSE,3390,1102,Radiant
5895bc1ca483236f34808a556ecc9786,1260,TRUE,2186,926,Radiant
46f92cc6d7638e67100031820a850a8b,3591,FALSE,3752,161,
21065f00e0bbbf7ca0e18e3445dcdaca,2062,TRUE,2110,48,
b663aaec89c6ba65f4b293e797f3df57,1742,TRUE,1973,231,
4a30cdec74b2eb660e36edafc5fc51c8,1153,TRUE,1972,819,
06ca27951e5bec041e4a7effdf94458d,896,TRUE,1424,528,
a2355df2dc2c14247933d409d5d0b9a4,1537,TRUE,2680,1143,Radiant
50c4e3f263f9e5612ade6f6861fbdbff,1345,TRUE,2373,1028,Radiant
0c75929f2e75c1fc43ce26c15b75812d,1622,TRUE,2800,1178,Radiant
8abf762f3a7ab8062db11dc59ef165b6,448,FALSE,2330,1882,Dire
89d2495530fc996480dcdfdefbd55013,241,TRUE,2405,2164,Radiant
93d0e8e972756ee2300669d204c97451,758,FALSE,2514,1756,Dire
e445b8521436121144efd4afdf84c182,916,TRUE,1043,127,
3278932dd5354edf94407f01ec1073c6,826,TRUE,1559,733,
ed3b9d0413ddf21cf585f26f4bd34863,318,TRUE,1350,1032,Radiant
62da8486c0d2b974e181deccb2732017,2037,FALSE,2483,446,
7d0d733a857d1438bd4488a980e5147f,103,TRUE,1137,1034,
4b73745fd044127a55bbcb6f5ce38864,1155,FALSE,1583,428,
e62732a67d876bf6c690a1e8410cfc43,2261,TRUE,3038,777,Radiant
2b93aa7524b3f01cbc56771fbc9a91e1,328,FALSE,1796,1468,Dire
04177465af931e84aa3c80007e913f77,2320,TRUE,2407,87,
016efad5e111e2baf80aeb7c20c33a58,1277,TRUE,1587,310,
f2d733820570676240c60b428b61d5da,1432,FALSE,3397,1965,Dire
16786309b3720c4044f1f9f7072e03c2,1199,FALSE,1989,790,Dire
9d13309dea8e02a6657e6afb89e27e27,1780,TRUE,1926,146,
794f3e4628eabd97c59f7942c2b24ef1,759,TRUE,2097,1338,Radiant
a3e44f957d4a31f36d235a897d6caab8,2584,TRUE,2659,75,
8cd6e7b41809df25d7c4d5bc59cb9f59,980,TRUE,1694,714,
b6476cbc1ea289cd5912dc905d6fe1b8,1913,FALSE,2149,236,
22d9975456046d292fbdfe381b11ac8a,247,TRUE,1019,772,
0b666bddf2ebbf77789906bd2d80a0dc,1446,FALSE,2378,932,
d37c5e81ac56fb6e70f8f35ca405fece,854,TRUE,3114,2260,Dire
b66acfed4cd4e62b72c0a8413742f37b,1227,TRUE,1922,695,
4f1d53b171e61b8126d3904ff672c2f4,716,TRUE,2927,2211,Dire
26804faadf0c7d6a61c47f35f333af58,580,TRUE,2144,1564,Radiant
98b165d5680cd0cb21ed03ae08dd80c5,204,TRUE,2088,1884,Radiant
177e0b4d2bbfbb46fd8170ca779381fb,2124,TRUE,2605,481,Radiant
bd046a4997f685f047b1786e10843325,159,FALSE,2144,1985,Dire
8b169edf190f2ba7ce0a024e4e70505a,1527,FALSE,2228,701,Dire
55adb38f6041a42a1fae499dc7ed3786,19,FALSE,1585,1566,Dire
22420b130f20f6a58ad031084cad349a,1549,FALSE,1960,411,Dire
6b98f7828808e7b7f11e587ac8c841ff,136,FALSE,1280,1144,Dire
0d481ac53a465a211bc7d8bdc6c3cc77,437,FALSE,2144,1707,Dire
43336e54a6f9383a5aecdf1dfb744eb9,32,FALSE,2727,2695,Dire
1d0b13d27c9ef3933e629d63abad5edf,1228,TRUE,1356,128,
f15510f4824b5d1c8de09f5c2c46ef6a,884,FALSE,2732,1848,Dire
e849580e3324a55b9a8e9c41104ec1bd,47,TRUE,1141,1094,
96afe230824ac16de94a85cc969d2f6d,1431,TRUE,2567,1136,Radiant
80b7dcab250f0df6b0859561520b01d1,1413,TRUE,1861,448,Radiant
13a9ee7f307f857b55bae71670b4f84e,458,TRUE,2516,2058,Radiant
196f173ee410283cf187b7d74cc3965f,1982,TRUE,3140,1158,Radiant
b0f573231948585d38c89fc67be84cad,34,TRUE,1818,1784,
addd8b60d03ec9cf2ba7245c4084073e,2268,FALSE,3533,1265,Dire
e80778b5d76b3bd184473035219d92fd,317,TRUE,1185,868,Radiant
9257a691a7f4ce8a403a24ae17688f1e,1709,TRUE,2024,315,Radiant
ab2d64435ccc6bc8442b4b8d3c481b1a,797,FALSE,1462,665,
84b15e2cd4a1c3b103278ec070925919,2960,FALSE,3636,676,Dire
bb66661b08966c8fd477759e2c9e6221,266,TRUE,2173,1907,
469b4f5d0e1a053359c84457c984ade1,82,FALSE,1955,1873,Dire
0d73e89b273a650f3d0670aba3c494a1,581,FALSE,2473,1892,Dire
7b67c40e3e747cc801af2b37b2681939,1256,FALSE,1702,446,
af9a155100e396a96174e81a1fa3cc75,2384,FALSE,2468,84,
0f53190c79d07828beec24c1c21aac46,2020,FALSE,2845,825,
59f9976c77965ab6bb9f38a8c1743677,417,TRUE,1532,1115,
79aa43bf3d7b2a677ad85c0db4e51cd8,763,FALSE,2818,2055,Dire
3d4beb5b50ea9a8922e1072b0570d8d7,616,TRUE,1848,1232,
5c1c9cc3e05f342acabafea13be10ec1,1015,TRUE,2275,1260,Radiant
9517fa444dda5e151397f5555d9a7690,34,FALSE,1612,1578,
6fc1fcebf15402291502af4cd15720de,1665,FALSE,1967,302,
94ea2ccbf7a93330864aeac8856df547,1287,FALSE,2165,878,Dire
9b389d537bdd1cb1fda561796eb56643,909,TRUE,3808,2899,Dire
50c2c2d85ce78e28e683afd67584279e,1422,TRUE,1524,102,
fb0af5905353c00d1866fefcf3976107,555,FALSE,2461,1906,Dire
b90ec7e520ef9f0208edee72b1e11154,1628,TRUE,2655,1027,
63839be8b30250c92524b01230726c0f,898,TRUE,1919,1021,
89820d02be3fc0acebdb5598fb65a5c8,1425,FALSE,2700,1275,Dire
b94afaf7944ecd7c65c5ae0bc2eaf5f0,28,FALSE,3957,3929,Radiant
ac2f5b16cc3095f11263b67273630ce0,154,TRUE,1642,1488,
aeb10ee3e7274e183dde8fedf70352df,1881,TRUE,2092,211,
8d0a2b1b0775a022ff0972a3e0262007,1348,FALSE,2051,703,
62c9d539aaf9548a6f4bd94a0aba15be,629,TRUE,2938,2309,Radiant
9b62af99550773c0dfa0eba1e859f644,1147,FALSE,1812,665,Dire
710197c796536a36fcc2538497c3d2aa,2406,TRUE,2913,507,Dire
c3f9e09eeb323a297e26e00b01877b67,1768,TRUE,2284,516,Radiant
d4231e5e5a5b50492a020821132644b5,2113,TRUE,2328,215,Radiant
ceadae5b18a6891864cd0d5ddea62882,1908,TRUE,2076,168,
ac9520cf3877ef26e28a4911de1bd5f7,1548,FALSE,1895,347,
c4f6f7b049e114ae7849bb459b38a976,21,FALSE,1688,1667,
2d10d82de61af7f70a818c22cb8536e9,685,TRUE,1870,1185,
9d5f47e9a7bbc9767acbcece9c9921d3,1546,TRUE,2155,609,
e6bc45568f888391cb1050493aecde09,569,TRUE,1898,1329,Dire
dc60738a98e939dabfab38ac2eb07e1d,755,TRUE,1838,1083,
07b08dd5ad76c37030b859ebea9d1e6c,1666,TRUE,2140,474,Radiant
2df7de6e347c5c470a06b4109fea3183,937,FALSE,2125,1188,
b29218f7f794114bd7c615d268ebad03,1523,FALSE,2490,967,
df6b82dd5226e9c2c4da97a7c6dde4cd,564,TRUE,2151,1587,Radiant
42213d27ecc91a3d4e8677e0040db9d8,1116,TRUE,3343,2227,Radiant
7d72c1cba15e6a54cf5c36ba7bafc1bc,1187,FALSE,2225,1038,Dire
29494c3b046f1222eae35dda4f5aba8d,819,FALSE,2530,1711,Dire
48d1aa3c631e332bd66b8584039216e6,1630,FALSE,2138,508,
376448c7cfc9085523666176c707590d,667,FALSE,1027,360,Dire
5f520c4f18a34a7b1d76f41becb28b6c,2572,FALSE,4433,1861,Radiant
2861c4a549568c0467ae688c00ef114e,1130,TRUE,2006,876,Dire
0066164f10e817308b61830d5213563a,1520,TRUE,4615,3095,Radiant
a4b19ce65ff8f20604906149478821ec,256,TRUE,2027,1771,Radiant
9635b4c0de2ac524311f2f6501908d02,1847,TRUE,1969,122,
2c18821af4f0e2cf7c1fb3d3089ab4ff,1241,FALSE,1890,649,
28d082aed088674ad2c8f89a3deb3ea0,519,FALSE,2937,2418,Radiant
f7083e00dc28bc753778392aa79d1d50,2023,FALSE,2304,281,Dire
a6053416826efbebe199d277e025f460,155,TRUE,2189,2034,Radiant
58604ff02b2a14c2cc9f9019c56327f9,2107,FALSE,2513,406,Radiant
473d2ff79ae64b35276b64ad7b396595,256,TRUE,1532,1276,
b17f7a4604ded0329d89e0d68a8b5a0f,567,FALSE,2735,2168,Dire
aea46082712c6caf511bd5a3c2bbcbec,2232,FALSE,3036,804,Dire
b6432a554333e665ef4ddbe80d337b22,958,TRUE,1578,620,Radiant
de7af6346a9c35e660e8b05a9840e79e,443,TRUE,1425,982,Radiant
e141059b1979ed7cc4321dacdd7f7ee1,2476,TRUE,2515,39,
f53c2b947bbd01f74c12fe8cbab44f09,22,TRUE,2604,2582,Radiant
11e698766cb299d324eeffd6d523dafc,46,FALSE,1463,1417,
684e58126728539e9fd4eacddea42968,1777,FALSE,2565,788,Dire
356ea89ce289a2238aef28995c38c6da,657,TRUE,1742,1085,Radiant
cf36f3cd06b8acf565a46c36ac1c6170,40,TRUE,1395,1355,
7dc88f90fbea9065e4759ae318f7d225,2115,FALSE,2301,186,Dire
33b83b6067f481f321aee5d285df4897,401,FALSE,1044,643,
a86459afa119a5e07f3b1369b5efb42b,476,TRUE,1306,830,
a27443ec556338b20de119e31db93ab1,753,TRUE,1596,843,Radiant
7c66183458e7d906ff51dfcdf68fd29a,1918,FALSE,2126,208,Dire
422f9df7dba34e186b3f1af7b6165400,627,TRUE,1925,1298,Dire
2785ed586901e9584ff96ef3e0690a9f,1390,FALSE,2538,1148,Dire
251c87e26ff0c2ac04ffb0d647bc027d,1267,TRUE,1402,135,
3cb12ff40aa5b249b7b1989619e9595a,1973,TRUE,2180,207,Radiant
20bcd289aa4ca17d5367d5bfac29caf3,1809,FALSE,2531,722,
9ca88fe04008bae6b712a81811c0ddbc,793,TRUE,2476,1683,Radiant
b7ab08fccd419956d57364475545ee09,299,TRUE,902,603,
398d8edd45c621867fb834ea4094a65f,683,FALSE,1938,1255,Dire
11735f4a54fa15a70c721b69f358643e,404,FALSE,2114,1710,Dire
1c4d0bf3e7314f13a6e632460bbfe2d3,1394,FALSE,2889,1495,Radiant
04eee6f7b7055f9d6045e4999f665203,324,TRUE,2423,2099,Radiant
ab4c71006c27372becb8c9bea78df72c,1845,TRUE,3441,1596,Dire
3d1ad56b253c41b1967b3b4f21a09df9,1108,TRUE,1484,376,
9ae787a8d516346039498703d39ae209,946,TRUE,1882,936,Radiant
685a2833aa13efeda94c1d4ac29d7b8d,532,TRUE,1858,1326,Radiant
30b7c2a29351331771398a3e4bc27ee2,1515,TRUE,2914,1399,Dire
895151dc96a1a63e3b6f6378aac299f4,111,TRUE,1608,1497,
da2f3bdd8734e0562f84d59cb25ac2ef,805,FALSE,1708,903,
405b0e271a9ba309a3dcf40ac05f32eb,1142,FALSE,2221,1079,
ba540a0f26f215b378214cde3e21ae61,982,TRUE,1542,560,
360dece5b389b1f5c80b26cb834f8d96,377,TRUE,948,571,
ebff8b253dfab59ab21275b329f07f78,672,TRUE,1899,1227,Radiant
c10bb44daea1c9ff65009332c48e35f9,2286,TRUE,2461,175,
c797d0c318bc8cebc66ed9b22bc3c106,2181,TRUE,2275,94,
d809de9b65902bc4ce0de65356a17a81,1278,FALSE,1794,516,Dire
4cab1e8cfd0c73fd3a3ba5fa76e604bb,2386,TRUE,2782,396,
f6e69c89c37ec863cfc5ab968d1151b7,764,FALSE,1388,624,
33b17a74788d1a97751be99162a4ec95,1060,TRUE,2320,1260,Radiant
183a2a4fb556459004bbc539dec0b799,1386,FALSE,2670,1284,Dire
5193e7ab0612a9f6471654cb47458ebb,1884,FALSE,2766,882,Dire
91f93463b8a5bdc2681f6210739637b0,385,TRUE,2267,1882,Radiant
35e093db7894a4f537ef8592425f9ab5,986,FALSE,1263,277,
56f7a3b21c8e45c304280dd167366431,2812,TRUE,2968,156,
4a91c4223c57ed825c4be95e9467fc2a,815,TRUE,1545,730,
4822ec7dcf13080d28b95dec7f9f0927,2309,TRUE,3581,1272,Dire
abf4051763f50c9129f36c98e0ffe919,2519,FALSE,2631,112,
f9fd43f7b4af9215f649b4925f280a11,472,TRUE,1785,1313,Radiant
3e3ff1a1bc19428ecb44339a64ebec83,1450,TRUE,3061,1611,Radiant
10e3816498a68751f80e9388fcf52fc0,2098,TRUE,2886,788,Dire
04e895c1c0828dd908ecec41e81254ea,970,TRUE,1918,948,Radiant
8e9f33569913b0d4e337553d88c9ad29,1538,TRUE,3104,1566,
e050fd37b8deac2dc187bec3f49180e8,848,FALSE,1674,826,Dire
6ad52ab1c609ec22d9a7ab8719f75a58,247,TRUE,2041,1794,Radiant
b48fe99108438ecebacc22fc8ba934fc,1393,TRUE,2192,799,Radiant
f2ecd6cd48b75acc6738d63b18852c73,1926,FALSE,2961,1035,Dire
1210e790242e11073c5a63764e07418d,50,TRUE,2346,2296,Radiant
011736a3601809a947d63f294a0f5093,1590,TRUE,3502,1912,Radiant
fc9735a367dd91a569e49ea3a9e6a0cc,1595,TRUE,1659,64,
1df28beab2606e79973c22d48dd90a1e,570,TRUE,1239,669,
b9fa397d98bdd23f6821c214f718ad25,2589,TRUE,3447,858,Radiant
41f4849b7a4ce7861f8b230e8416a7a7,115,FALSE,2479,2364,Dire
e0821ca7f0aa7394b01ea956abace97e,264,TRUE,3912,3648,Radiant
5a59c4522231473e4dfc99faf32eba85,1302,TRUE,1524,222,
7c2bf822ef494e5b981fe5a2d9b3d533,81,TRUE,2176,2095,Radiant
5e6db38cd684da2e00cc10a1d18934bf,2046,TRUE,2556,510,Radiant
91aeab5b01d304e00b1d23924e8e3b49,1266,FALSE,2853,1587,Radiant
791c86326bb315e209d7fe146d9b24f0,309,FALSE,2480,2171,Dire
101fa3f0d3925fafa972cf6516e8de75,1568,FALSE,2840,1272,
ed773e2044d64d97593365cbf62cb2eb,2265,FALSE,2929,664,Dire
aa24e752b22448ff168bd05c1ce91f1c,1504,FALSE,1985,481,Dire
8b4d3d253da8e3ac761d34a1266ded33,792,TRUE,2477,1685,
0bbdb81b3a04b1af94c1160b82b07ad5,225,TRUE,956,731,
1cca9ee9adf828d64cb889bd54cac0c7,443,TRUE,1148,705,
ec71fb0174ef6d0bee2faa96ec36c3a0,867,TRUE,2023,1156,
3b83e0ef1b9addcd16b7c0f260e8aeec,1668,FALSE,1902,234,
9e768a14b5015aedbcb9ac57e1df8791,317,FALSE,1876,1559,Dire
e4816f5d75e02038661e7a887c9504d2,1382,TRUE,1926,544,
de936154010ddf6a800264fd53390998,374,FALSE,1732,1358,
da334cd5ed75fafabfd163b031d63561,3044,TRUE,3380,336,
c75029467c40de67d8868777dbe91619,1426,FALSE,1909,483,Dire
5df7935fbf7f54fe40df7b13b6f4e078,1293,TRUE,1557,264,Radiant
756bcda76a6fbdd51171ba8ac924841d,1933,TRUE,2178,245,Radiant
034f8c3ff8c73fa31767bbd190ee4f93,1912,FALSE,2487,575,Radiant
c6628f8d86fac7a239416604a284f1c5,1464,FALSE,1546,82,
78a1f6679d5e6cd5b88be3dfacb7a6de,2692,FALSE,3053,361,Dire
a6f3688b5f661d04636442ccabc07e27,707,TRUE,1763,1056,Radiant
ca06547736235dc1ae60a905d12b42f2,1449,FALSE,1891,442,
97a7f97dc0cb43a10dac04d137ea88e0,291,FALSE,2364,2073,Dire
a049bbbd176486008de79e5a1d592b3c,2040,FALSE,2223,183,
ce0f4ecde8b5c4a5f8edddceff34021b,1091,TRUE,2211,1120,Dire
59ad535d28d268c4d01bb0679b58e04f,469,TRUE,3382,2913,Radiant
c4f3638a718189fe830ee9d2721cd3e9,1445,FALSE,2868,1423,Dire
42d899dd3a6f350c562f595011b04d65,684,FALSE,2212,1528,Dire
8544642ec6ff51a1828bdaf64f593f89,1297,FALSE,3403,2106,Dire
8a0da410df38d6cc3d58444259c64201,640,TRUE,2398,1758,Dire
a9c966cdce52c8d0408f86d8e869767d,161,FALSE,2930,2769,Dire
6d3624b263bccdbdae279400e27de9c1,679,FALSE,1025,346,
779db6d190f160b624b5a01a0e1b62b0,1048,TRUE,2578,1530,Radiant
f2f78ae5a96a29e3bbac0f28d72a8a38,139,TRUE,1456,1317,
54b9c2290a56006d01e3df54b77878a7,29,FALSE,1957,1928,
576d02e1a9a26338d67936ec645e0858,1834,FALSE,1890,56,
f9cba0442ef598ac1d00dd95b6d62928,1606,TRUE,2149,543,Radiant
6dcd6de46286e3e734fdf7ccdd8765ea,2233,FALSE,2730,497,Dire
423189746f41b50de4a244c31c70d499,29,TRUE,2377,2348,
988a8471fd8cc0df2b3eca42b9a9329b,1120,FALSE,1862,742,
c44fb9ae1bf336668f51817d6ff5b54a,1516,FALSE,2970,1454,Dire
a6bfdb57ce425f0e2842f95a3bc482d6,864,TRUE,2686,1822,Radiant
66cb026aadba363ff084c30f1d82d369,158,FALSE,1300,1142,Dire
4b961df3c73a8c9cd2a48238d2377717,428,TRUE,2343,1915,Radiant
1e663145053f7272f2e3e9a2500a3738,1278,TRUE,1780,502,
27773367017f33d7e3214471466f3a5c,479,FALSE,1957,1478,
2d2d2907ef6744b46a3ea5da361705bc,1760,FALSE,2279,519,Radiant
9a646c7a948034bcb20fdf7eb301b38b,884,TRUE,1540,656,Radiant
a3af74725598466380a65ed9c3ff6835,183,FALSE,2672,2489,Dire
df3b361389dfe152e290662fe87f848a,1820,FALSE,2313,493,
c0e6a61b57396b3ed4e6e46874cf26aa,80,TRUE,2919,2839,Dire
281fcc7e11b26ab1e70dbbee8402c557,1352,FALSE,2205,853,Dire
9e3b62ce216108a8e94810878a2f3aad,2200,TRUE,2583,383,
1e09864fd8e861826039d5b02693dca3,536,FALSE,2370,1834,Dire
83d39010d2f9a837fcd369029f820fb0,1998,TRUE,2707,709,Dire
640c5e4f7e0177761d2122d24d4a2aa7,2182,TRUE,2686,504,Radiant
03befb998a8a52c17f4c4bc955f006d0,887,FALSE,1217,330,
a0fceaecb23e2c7d7c67ae7d351d15b9,1835,FALSE,3054,1219,Dire
824231df50f58a7eba8686ed2ffc690f,830,FALSE,1817,987,Radiant
6e25477fe943310c0b82936bfe2558a0,932,TRUE,1685,753,Radiant
b30f28ad82228072840c872f8ea75941,323,TRUE,1924,1601,Radiant
198bfc40409f4d63e370569ef39098e5,61,TRUE,2839,2778,Radiant
b2d58f34eaa30763cab1e0cfb400030f,1297,FALSE,1644,347,
bdcd622a45042393696644015d306408,995,FALSE,2229,1234,Dire
864a6c5f4f0aac4b94659d463c62729b,985,FALSE,1910,925,
1fedf67155b3fedf3d1f439ca2292e7d,349,TRUE,1020,671,
6129f34a5883c4052eeb0cb3930713e3,896,TRUE,1440,544,
e36d1dffb666082ecc2c215f0d6ad151,1063,FALSE,2877,1814,Dire
0267fe1976b7da4e5abcdadefab6b760,153,FALSE,1175,1022,
71f55084625323ee167db284d9383aee,1929,TRUE,2157,228,
0ef58bc3f10899dfc3348ad2300205e6,1573,TRUE,1761,188,
bfe61a719fb6f8ef167033d0482811d1,875,TRUE,1568,693,Radiant
2e425f8eff073e3460abbaf7a85ae99b,1112,TRUE,1734,622,
e4bea255bc1c107120d8688635fe7683,543,TRUE,2701,2158,Dire
822c9c5faccaab0da6ec459632304e12,146,TRUE,2020,1874,Radiant
025a60f0b83d7df79c02f40faff4bd41,1330,FALSE,3007,1677,Dire
c4b5960d542e3be877c5deacff4d0175,733,TRUE,1655,922,Radiant
3f9a6f17684c4bd745746633f5486b23,15,FALSE,3120,3105,Radiant
902965ba87d996ce4c78abc9b102ed39,130,TRUE,2063,1933,
59d5a57412049c0dc8d2de6a4739218b,85,TRUE,1817,1732,Radiant
255ebd280c0cdd6ce49d706b07659692,1201,TRUE,1780,579,
38bf5a3c94a25c95492e613001ed159c,1904,FALSE,3229,1325,Radiant
bd33e84c56556516035077aad5d85421,2205,FALSE,2505,300,
2c72a9a564fce143747ad71372bf7c6a,1048,TRUE,2704,1656,Radiant
4571e61ee0ca3e484031c06dd889978c,1831,FALSE,2151,320,
6bd4366c6557779e3de22f7d3106a388,2870,TRUE,2913,43,
b9b9d487a689dbb3ca53cea3e9b905ba,885,TRUE,2521,1636,
52315f75a7d51f48d46c8cb7857700df,729,TRUE,2219,1490,
246f25fe633711ba4731cc636c0bee59,1658,FALSE,2674,1016,Dire
cfb6ea660dbc2abcf7caf2d8ac1efaf0,1964,FALSE,2314,350,
cd46f7a9c7c1b46a0bbf20df582b2042,392,FALSE,1519,1127,
8f6545d98f92f8ad8c7ba67c75f9fdcf,1181,TRUE,2086,905,
8659151b466504415d92a9808f7ae236,825,TRUE,1527,702,Radiant
e5aabcdadd2d87a92c19af72276f9265,1335,FALSE,2874,1539,Dire
970be57883a682ea284d091e1dffd99a,2044,TRUE,2565,521,
bb51b4be65d66baa0ba690c5e85e5021,449,FALSE,1285,836,
4eaa42fcca7a9bc329d1b8257e217dfd,419,TRUE,1534,1115,
1791be031e0744c6e417f237e4f368c8,967,TRUE,3034,2067,Radiant
5adb5258a6d09cf532c7b0e80d064cfc,1749,FALSE,2107,358,
d4d6319e3b3094fbedc4811f2076fed7,29,FALSE,1882,1853,Dire
9d3b7aa7dfd9538ce59ee15f12975a92,211,FALSE,2585,2374,Dire
00e08316f59b38f10477d572524cf833,599,TRUE,2096,1497,
cc6eefa236d597873d8e1ab0b1ccebf0,1420,TRUE,2120,700,
74cf069b3686ff62eb0132bcaad0294d,1316,FALSE,1739,423,
46c91c4e73e4bdd248d9089bc9e50139,1138,FALSE,2531,1393,Dire
c2955de29b81be340723fa0900492661,157,TRUE,1309,1152,Radiant
6c027430fb979431cee424607897347f,165,TRUE,2429,2264,Dire
d03a9fa610b5d6310a31273f8120672f,1116,FALSE,1820,704,
c14e7e7406e4ed313573bec898991d1f,240,TRUE,1652,1412,
1dad7124975b4aaea2aca48d2f2a51ae,209,FALSE,1903,1694,
67f5fca11ee4fa23c0829d66521c5fe9,204,TRUE,1954,1750,
d39c5767408bc3f95c92630ed79c28af,705,TRUE,3667,2962,Dire
21fecca84faad30dde52ef305fea10a7,1293,TRUE,2482,1189,Radiant
b169fc75542ffa10c27ca0696a5576fe,715,FALSE,2361,1646,
968a275fc44afdf1472c18a21ee2ec1e,906,FALSE,1690,784,
385e2fb1d9ed9d69c995aa5c5c9c0235,1137,FALSE,3655,2518,Radiant
302b4969d5d681010772f1dc911211ef,1608,FALSE,3310,1702,Radiant
c2f712063b20922a1c266e82f517947a,1554,TRUE,2115,561,Radiant
e926a383916e9ac8f78d4af0318cbb81,893,TRUE,1443,550,
71c1f053ac65f6a1996dd508dd1ce7a9,1672,FALSE,2726,1054,Dire
0b89929b448bf65c15839fe4d43d710d,884,TRUE,3787,2903,Radiant
84b7c43b40c4ee2b310fd1457385593e,1759,FALSE,3905,2146,Radiant
eb70fa5e7d122314b3eee15a55eb43a9,2092,FALSE,3828,1736,Radiant
4f0a6d544f80f4244d9382544b15bc4b,672,FALSE,3406,2734,Radiant
fb80cf60a7da2c631c4087ac1979d4c4,632,FALSE,2340,1708,Dire
221e7db3877c3140deee4bafe274d85f,2394,TRUE,2621,227,
819ebff7ea070af66ac91a5e9aa24cb2,1482,TRUE,1637,155,
53b72b76947b311bd325930a7b6811ae,1284,FALSE,2060,776,Dire
f02f0fda5de179e20d5a32a0dc4c05e7,2487,FALSE,2804,317,
14425e1f56d48f7e5fade50a34e15227,1912,FALSE,2871,959,Dire
1e5bdb517a915aded74d1237dea66e74,844,TRUE,1124,280,
704bf85ce75884464270833635310b7d,304,TRUE,2522,2218,
cc40902e61920ecb79f67b192086a2e7,434,FALSE,1866,1432,Dire
bf1c3d80b3c8ba40f5c3d01b80901355,1398,FALSE,2799,1401,Dire
3cb636228779d8b82304adb64c3d8bab,3185,FALSE,4118,933,Radiant
126c2c3ea4fca8186657ade417ebb3f4,1242,FALSE,2186,944,Dire
76dbe24f9ae281b29e98109e237a900d,1197,TRUE,2300,1103,Dire
266de9c31a5529dbe97424e684a169fd,969,TRUE,1750,781,Radiant
99fc3105d4a90d317e5c756eba6391c0,892,TRUE,2589,1697,Dire
5aa6f9f2bf7dcc987ee77179480d39cd,1789,FALSE,2453,664,Dire
4bbcf9fd6c3976e73fef3dc4be0c47fb,445,FALSE,2106,1661,Dire
0b501a1f4ad808da3e7663d607cdf4cd,1117,TRUE,1526,409,
d135b13dbab9545fbc31fed53d5e4d04,314,TRUE,2609,2295,Radiant
d6f4ace87d8b3951e44ab8ad00765878,1247,TRUE,1469,222,
ec6c77cf872bedef411dee4403798ff6,472,FALSE,1123,651,
606727405e42be37641b25234ddf5a49,796,FALSE,1117,321,
1b5b2115b4514be56a507085d75d7967,1123,FALSE,3669,2546,Radiant
0f6f0dac50f70f4af2e1139f3308067b,2679,TRUE,2888,209,
db006eb59bb8f6c93ea5c2a9604d794f,1314,TRUE,2474,1160,Radiant
57327a7a67e60eb56ef65c4420c4646a,168,TRUE,1048,880,Radiant
5de2d9030d46058450f2425180a3d341,851,FALSE,2583,1732,
bb69ff524de26cacf1a9470d5b5549ce,1474,FALSE,2416,942,Dire
a65a9c9a0e5458b75d5beae33c925930,336,TRUE,1767,1431,Radiant
13f2fc866b978e6a23d941374af926cd,368,TRUE,1923,1555,Radiant
15e34e15e92583de84532a4d7831d7a2,750,TRUE,2106,1356,
a34e9a56a2edf793e986f8b03ed62988,1653,FALSE,2487,834,Dire
12b6132c03ff7987d6a8979ee34d0f42,1407,TRUE,2163,756,
e8d4045ae187f47b76c22559d91c0593,612,TRUE,1136,524,Dire
a85a59e3352d81961b8b7c9ab34f12c4,1303,FALSE,2345,1042,Dire
862a79f2fad09078cf6c592583aebdfe,660,TRUE,2386,1726,Radiant
0626f7912a806acb6bc6bcd49907dce5,927,TRUE,2021,1094,Dire
0bc1f978a281ad6d6358fc5431925ca7,1703,FALSE,2207,504,
53d4d5dd5f42c7a2ca4337b7a6eddd76,509,FALSE,1752,1243,
01cb8a6368522e0e0bf4c4f8ae12205c,1086,TRUE,1968,882,
07537a3b0f3efe28a5ba2de6396c0914,1140,TRUE,2249,1109,Radiant
a7e79ffef85152e5af8cb4c32626b596,1667,TRUE,2506,839,Radiant
aab5ca1712227ff9f364b478cfc92993,1041,FALSE,1473,432,
199daaaad06d3cd06b6b442da5087446,868,TRUE,1099,231,
b69f407d0390025abd01fb37c826165a,842,FALSE,2519,1677,
5f77412d69cc07cae520b2d668a942cb,801,TRUE,2571,1770,Dire
4f7cbaeee59ab474d5dc81368daafd21,1509,TRUE,1930,421,
e275f6e8322f4652bf2047770480bcc4,375,TRUE,2990,2615,Dire
d4d71919d51c8af398e49157100fa934,1314,TRUE,1703,389,Radiant
36640cbf514e64960a14e724f0b0046e,351,FALSE,3047,2696,Dire
8389c0f87b5d792cd47f667230886d19,4177,FALSE,4499,322,
e4a49c3cef1f826828d9a4a661f85015,1819,FALSE,2181,362,
e3bd426cefb8873d526a687c06ca8cbe,2320,TRUE,3999,1679,Radiant
4cdb35f330327a40fb3b00b3f68aec01,1743,FALSE,2173,430,Dire
354bc7603c3e8e76b92ce3c59f2796be,1419,FALSE,2062,643,Dire
be0b006ef3b800eebf5b6a7512130b65,1113,TRUE,2248,1135,
b7f7241703888c80cb579ca8e141739e,493,TRUE,2556,2063,Dire
3b6f7a6ee4c9f55de49480e98ec71f07,1727,TRUE,2624,897,Dire
07e8f1e06d28736a1052425f352ca61b,356,TRUE,2661,2305,Radiant
9408489551ee97e5a6a9ce56b991f4bd,1471,TRUE,1877,406,Radiant
aec7624d57d3386d44ddf4df61e97e88,336,TRUE,1891,1555,Radiant
62d3ae51ffec0efb5c39f8116a646b54,1572,TRUE,1684,112,
bb67a859a85c86264b3d3bb2e550fcd6,2613,FALSE,3134,521,Dire
4444790d0fe678dd02df765ee8efa830,1065,TRUE,1655,590,Radiant
d20867cc774ac28df42104d946caf33f,2526,TRUE,3218,692,Dire
e884b8899aa033d10addf55685f07689,1051,TRUE,1370,319,
0e93f8e471190ec07e6511e056e0d579,1769,TRUE,2311,542,
ba07bcc404eb7ca23180a79765250d69,638,TRUE,2361,1723,Radiant
c33774758c7c896ab67c9edd3f895be2,1450,TRUE,2411,961,Radiant
5cac56f0aef11915b200da2d7f2af50d,2528,TRUE,2963,435,Radiant
1103adee2001b4c5524ee272319f9336,230,FALSE,2275,2045,Dire
49078749b329fb4b89e8d3a7bc46877f,1377,TRUE,2514,1137,Dire
acd0ead414a21af309befe24302edc84,2012,TRUE,2662,650,
eb38c0fa6f1e0a0ab107c29bf4e579f3,1176,FALSE,3282,2106,Radiant
2acd1270e3307f8854e6f32335c8364f,1218,FALSE,2539,1321,Dire
a3aac40fa92648270802b0bc9008de80,2640,TRUE,2928,288,Radiant
461e615d06e14aece2f9297c616f8a12,294,TRUE,2367,2073,Dire
f800c98baa8752a6d93cb278b3d73e2b,1842,TRUE,2837,995,Dire
a6fe5ac7de4de7653db5cc9a1508019e,1639,FALSE,1970,331,
d924f7cc7c53641337fb93015d35be4c,417,FALSE,1978,1561,
4ce46cf9d23409588ef12fe5a386db8e,203,FALSE,2438,2235,
23f0a2a054fdd6f56614b74d27782eee,591,TRUE,1913,1322,Radiant
8d75ab4ff596060809fb8465ad0cf4bf,2461,FALSE,4072,1611,Radiant
2e996e665a0a1152d69c5cf8e694c623,2848,FALSE,3992,1144,Dire
95015be57dd1ab324f0a8732525fa710,1431,TRUE,2332,901,Radiant
5ed59d3484e301c1f5d70a97eda12e22,956,FALSE,2155,1199,
3639a2c56a632a7625f9008fac83355c,136,TRUE,1383,1247,Radiant
736d025629b47ee7ab10cd331ff46f96,421,TRUE,1855,1434,Radiant
143086ca3612f51c1d2bc352750d69af,1251,FALSE,1934,683,
4612397fb16bcf6d1091ae38edc3d3fa,945,FALSE,2262,1317,Radiant
5099dce11d772065985ff17bd3635228,3270,TRUE,3552,282,Radiant
d9509ed74a53395fdbc17bb727ea5801,810,FALSE,1055,245,
5750bef0e2d3f3e591cd341c4803e320,6,TRUE,2459,2453,Radiant
f5e514d7d8c2e30fa57a3b99e222ae42,795,TRUE,1388,593,
0e8821bd62cc78e02d7ff23525759c98,992,FALSE,1771,779,Dire
9c42405b0870068a9d38323c0e7d32f3,1040,FALSE,1777,737,Dire
29bfd83426134b294863f5c44f937a98,1256,FALSE,1474,218,
bc5d1ed4e19cf06112760ed4415e85a2,56,TRUE,3164,3108,Dire
bbbe4b6ea1ad3be6b3d7107a974d7dac,1635,FALSE,1672,37,
b64db478394d7954fa5e7b7c07160137,738,TRUE,1917,1179,Radiant
fab0789a1f66482398401a1498e0df50,924,TRUE,2029,1105,
a3cc248bc6b648c9e420c2ac9820cdc9,1263,TRUE,1812,549,Radiant
b904f184158291513e6bd81abe45e1ee,1835,TRUE,2423,588,
8b2a67ee844cd38891e18f9c1eb4dcf0,1872,FALSE,2481,609,
a948a8e0c42f7a1f11785bc8efb3fe17,653,TRUE,2317,1664,Radiant
68ed230275e52223d3faffb4fa045c62,727,TRUE,2546,1819,Radiant
0e1121409c40b6432ce8d42572297caa,1491,FALSE,2538,1047,Dire
a4bd21bcba42b7435d013e1500ddc392,1143,FALSE,2514,1371,Dire
04ab024e23801f187740a90d33e8122d,579,TRUE,2513,1934,Radiant
b3cf31fb54384d5660a010d75227018c,1722,TRUE,1815,93,
c5711be5d9b653c3f35e65b03c3b3c0f,1560,TRUE,2006,446,
d9c7c2c44165f248418fa13253c9ff30,950,TRUE,1711,761,Radiant
64eef6c2457f8309581469b296565726,2459,TRUE,2606,147,
16c75e847b113fe7829a48cbb9464c23,1229,TRUE,1584,355,
24e0ded3ee1acae4eb039932a6f27d90,124,FALSE,2828,2704,Radiant
6be866d635f4ee845f004314d7cd2c4a,1238,FALSE,1397,159,
af332b83e279f800f3d433612cc1d795,383,TRUE,1725,1342,
536a8a989083843ec1f46089ebf32e0c,606,FALSE,2478,1872,Dire
f75d446cb5809157d9a92811f669043d,1575,TRUE,2517,942,Dire
5ad2e5d220de06441c1c9dde00680ef5,2071,FALSE,2525,454,Dire
f6f31812323708f6352a8ff284ec4283,1936,TRUE,3362,1426,Radiant
55c4d9c2659370f551c9bb534c9f1eab,621,TRUE,1555,934,Radiant
fbf94714a08ace8895710fa039d78542,16,TRUE,1960,1944,
24d976e16227417dd9945779a9252c5f,1840,FALSE,2785,945,Dire
52243646a66106ec75ff2df54f9be92d,313,FALSE,2078,1765,
076ef28b3edb7379aee6eac2edb2e3e0,2058,TRUE,2209,151,
a2afdaeda21fe8b069d7f649f35ddae2,502,TRUE,1763,1261,
03d902325ffbd8cd2702c82aea8c5447,249,FALSE,2232,1983,Radiant
aaca52b04cc3f44aec31552dbee6a492,1675,FALSE,2067,392,Dire
2e9e11f6e776cec4899937893cca8644,1743,TRUE,2698,955,Radiant
d16eec0c116fbfa7107f4c2d6afcce89,2785,FALSE,2982,197,
ffcac3b9d16f78b52e20ffa18061eccd,293,TRUE,2734,2441,Radiant
354bc405bbe3846f013cc508eef867ce,909,FALSE,1904,995,
c7d94721c567f2050aa07f39e722d9f2,1596,FALSE,1994,398,Dire
0c82e46094446bc5a5b5a29f8659d277,1494,FALSE,2756,1262,Dire
448f065383261e2f0cbcb03d2c22ecef,1659,TRUE,2566,907,Radiant
6d71fe3402fe91bc00e9aef828b7518a,1876,TRUE,2065,189,
420f86f6ecb1444b68bd2e86f915e63c,1470,FALSE,2021,551,Dire
360e30a63bb19f5fc1b103860e91cf02,923,FALSE,2775,1852,Radiant
7b515ad5b59ac48cfd195fe5311ff21a,1350,TRUE,2701,1351,Radiant
bd0510ba237129d8e69534715b6fe0cf,1217,FALSE,2668,1451,Dire
f7981c2fb6662ebbb65b88f1b7ded796,2902,TRUE,4754,1852,Radiant
4f2c5cef2eaef17c778a34625d7dd677,1454,TRUE,2427,973,Radiant
c7c704fb0deffe26256ec0d3a02d6e94,320,TRUE,1800,1480,Radiant
3f4dd5d056143e7c7df0087354361c28,779,FALSE,905,126,
4034de04ecb2033642c4673f593d9c3b,1011,TRUE,1102,91,
31153b830e28e6439d18f071a2388760,1582,FALSE,2326,744,Dire
8ce958b7f694ce9d98a62164fc028992,1498,TRUE,1867,369,Radiant
d8dc6ce620e2c4f8be355ee82fed84ae,1136,TRUE,2404,1268,Radiant
c947586d927ef85062a741b6cb57f229,42,TRUE,1611,1569,Radiant
46cf8b34b60575ba318d3686aacea560,544,FALSE,1916,1372,Dire
c9998cd44b98869cba2978322b770fb5,273,TRUE,2494,2221,
5849f217c32c825fd45da73558655757,1889,TRUE,3312,1423,Radiant
067de31199af99144fb51d4b5a17a5f4,18,TRUE,3369,3351,Dire
eae7ae2081797dffdec2be330e8c700f,677,FALSE,1619,942,Dire
8efc3ed5711e18241e33a771a531d6ea,587,TRUE,2161,1574,Radiant
d8cbb7b3a2d7f1e6bd60fd635b299fcf,288,FALSE,2453,2165,Dire
959b6105ceb7a1cd4524ac48d600a8d6,907,FALSE,1881,974,Dire
0bf63329ca1bf715ce82459254d9fbd8,831,FALSE,1914,1083,Dire
04187a606e9f229d779bb113d7448ae3,51,TRUE,2502,2451,Radiant
f73c562c276ade16924f8dae1d10d4ab,1178,FALSE,2829,1651,Dire
528c726a1e77f62d5f071d7d377b4aff,1662,TRUE,2010,348,
2077706416b3ffb774b994200174c2aa,541,FALSE,2136,1595,
c3547892d186fc2cc8ae7a5de52506db,1009,FALSE,2596,1587,Dire
5f29aa99c250aa53b1b51514f8f196c8,402,TRUE,3444,3042,Radiant
7efe292ca169f326310ef099edc7e3de,266,FALSE,2545,2279,Dire
c3ace0758586d303069097b2eba94443,1030,FALSE,2991,1961,Dire
0f9a348d51b4f45e4487a675a278f921,1288,TRUE,2507,1219,
605ad0a8e9f6c381ed965bb277bcd6a5,1383,TRUE,1762,379,Radiant
0b4d9fae2233633e16122157d6b96c91,748,TRUE,1759,1011,Dire
11f452f5fb880d2c13a859bdd333b03a,2415,FALSE,3135,720,
91b569380401d5a6ba73a3aaf8a3d0c4,1553,FALSE,2196,643,
3064be2d70cc2340d21c8ef41d53d765,94,TRUE,1131,1037,
9572a2fa006e6f7abe8ffad144d58f81,2418,FALSE,3243,825,Dire
13471487742c67420d838b46ca1186f6,2460,TRUE,2994,534,
88cfa17b8328463e0681734984053205,809,FALSE,2921,2112,
0a57d3362d1ee599e45885600de6f332,1561,TRUE,2066,505,
cde48208392f6863e195a45bc5450cd4,1547,TRUE,1852,305,
4debb3a4376ec12b1c07258841051c10,1270,TRUE,2566,1296,Radiant
1dd852fd5e05cf3d5fb0f13bdde17623,891,FALSE,1860,969,
deb9b5cbb4c3d2b860408837fe4499c6,2218,FALSE,2472,254,
9f604395705c67f3ef98ed367dfc0839,2020,TRUE,2622,602,Radiant
5f127c287aa87d377220bc11a4b136ee,421,TRUE,2435,2014,Radiant
fd61f34f9e287dcb943f2399b88ebe92,852,FALSE,2823,1971,Dire
288ce2106be1c52be78d51a265902832,1296,TRUE,2150,854,Dire
c289ef8b0fa24be8b4d77b7c15cf8196,1136,FALSE,2311,1175,Dire
4b56bfe855c681e73fc26328c90c8a17,1339,FALSE,2522,1183,Dire
1637eb5b136daf407bad9265e6247650,1434,FALSE,2040,606,
77146ba967d1c19a03bc7ae71d61bd37,423,FALSE,1684,1261,Radiant
263b4f319ee54cd02c028b540c43b6c2,2005,FALSE,2350,345,Dire
5c0216d32d9eaddaefa6d77b2e65b010,1585,TRUE,1906,321,
1c3ca2749d3232c12f1257791067381f,1919,TRUE,2109,190,
68e414ae4f0416b7c508312a868fbf67,934,TRUE,1430,496,Radiant
3133311ab56949bfb62b3570575dc103,506,TRUE,1435,929,
6a34c0cd65207e2b0c7acd792cf372ef,271,TRUE,1733,1462,
65d683da9c29cc95edb2b540faa77099,237,TRUE,1649,1412,
380ce4fe6ca98e375dbdd9170d418f0b,430,TRUE,2378,1948,Radiant
4db0348f743eb206ef6f6e8b7886d605,1762,FALSE,4590,2828,Radiant
187c6692c0b938ced7224d8c83b228ed,62,FALSE,1281,1219,Dire
b97cb45cb47594a50cff60693aa39116,637,FALSE,2198,1561,Dire
479f30f7f85bbd71482f6e065bb90e7c,61,TRUE,2033,1972,Radiant
0ebf53fac8c39bb11fc2a8b3e9db8349,1577,FALSE,1815,238,
86d98c0a3df83a69579a7f5b34c58b7b,1746,FALSE,1931,185,
6bfbc3bb0d6e480b9fc76f5d1d840156,2185,FALSE,2642,457,Dire
9b9d307bd82a1297e039cc26acf0bf8b,437,TRUE,2757,2320,Dire
204d7042746f1ccdbfbcd07dcc2f55fe,524,TRUE,3094,2570,Radiant
33d3521e4faf58b45a87b5a965feef97,972,TRUE,1648,676,Radiant
5ff66e1ecdba7d59894590e0054f1bfa,1336,TRUE,2495,1159,Dire
a0d660d1547ed521bf3d0c226cf27723,1615,TRUE,2374,759,Radiant
0ceebdb15ed94c6982aa1098907cb186,777,TRUE,1103,326,
dd075faf10b49c9a33b0d6531d7b1569,986,FALSE,1860,874,
791071c849c5700b567c96ae3c0f296d,1508,FALSE,2893,1385,Radiant
38b10ca49713c8d890a79dc322d1b19b,1596,TRUE,3012,1416,Radiant
86cc89899d8f46d8cdc0ec1094cf9393,1192,FALSE,2077,885,Dire
baec6d0f42c7b4a9ca7958ab00effb17,194,TRUE,1682,1488,
7ca195628847794dfbb0ea70b6bf8937,713,TRUE,1880,1167,Dire
30e59753321510c09341765f3caf988d,2463,TRUE,4207,1744,Radiant
91288ae9d6938a25e8c7a51f89f5478d,1235,FALSE,2020,785,
b7ca3d83fc3bad59ab8a442a71ac9562,1496,TRUE,3092,1596,Radiant
c36c78d780a2dc51445340bcfec1f56b,86,TRUE,1465,1379,
c8bbdfe0f98eb5b77aa4a197382df617,1704,FALSE,1826,122,
77c8e8923324bbd67e697c4bc2c7ae5c,867,TRUE,2359,1492,Radiant
67dad85cd5d56ec8a4a510ac539b953d,1795,TRUE,3034,1239,Dire
9ee50bf983581180555b095cce0bb5a9,491,TRUE,2535,2044,
b15cb91afc33cca7830fd99885874605,993,FALSE,1407,414,
354c8d9355f38b864f6cb93520553473,1246,TRUE,1529,283,
c681084c7bbfccf8d959ad7768eeb3d3,1336,FALSE,1756,420,
38baf4f6152962931e26074232442c80,1152,FALSE,1204,52,
2d7476d2e1176425703b8bbc853e2de3,415,FALSE,1970,1555,Dire
b0413b49555cf3b572e0ff707b4d5ecc,1820,TRUE,2608,788,Radiant
2b056de697b1b394838239fbed04e8c2,2906,FALSE,3867,961,Dire
ec2d037ad19d286e2d842a0a589c6fed,923,TRUE,1556,633,
014037666b6a8861657126259fb4a71f,1369,TRUE,2529,1160,Radiant
1033c604c7636ca9e3d41d25c5b951ce,1364,FALSE,2114,750,Dire
7b0fee9979fa5904132575acc82e68d8,429,FALSE,1869,1440,Dire
9b24c79ba9706c5bbc728d60cddf1b07,1362,TRUE,2755,1393,Radiant
ef61aa9170921186ac8bab41dbcd7bfd,1567,FALSE,3063,1496,Dire
55e4c5d54659f65795c7f970203840fc,1574,FALSE,2196,622,
ba134c164660c72fd72db8ec1e40c850,1777,TRUE,2033,256,Radiant
0c3ff2d19c13256ccfd49e0b6158cb41,2226,TRUE,2669,443,Dire
8f364dce5d6d5099393a67498efa03a9,199,FALSE,2698,2499,Dire
ceb240e5b3f6d2f1bc9907345f4eb267,1378,FALSE,3745,2367,Dire
bd7c9c5cfd18e52ed7ded1ea479aa242,817,TRUE,1100,283,
e244cb691d53d7a0aa62142bf0daf181,1025,FALSE,1452,427,
09a4b645f23f4f711b44eceadd8c07a4,1246,FALSE,1585,339,
320d639f5f3072e4cbdb77f183a62879,1420,FALSE,1731,311,Dire
893b767362ac8d522fc286183ab62001,1302,FALSE,1670,368,Radiant
6f40b57a0d50072bd1c52fedef565cd4,1331,TRUE,2913,1582,
6ebb77a9457024760a35a6fe218a4ce2,1624,FALSE,2308,684,Radiant
690ca83f3a9143079d8d762c0b9ae0c7,1063,TRUE,2056,993,Radiant
34006c9825c6af6fef2751429fe8a79a,1214,TRUE,2008,794,
6b7d22fcf81ea14d5806ee1d98940b69,1548,TRUE,1889,341,
5abdaf4df4629a52e51e7cbfce240de5,663,TRUE,3630,2967,Radiant
2863ad37775dacc2e234bbbc9de2273e,1949,FALSE,3984,2035,Radiant
74a3e9b5a93ae21d0a9f813a97e143aa,3632,TRUE,4319,687,Dire
ad98772ccdba42ccf9c5506f44126ae8,82,TRUE,1660,1578,
a9b4af1141286b979e00f33fb25a9d24,1269,TRUE,2085,816,Dire
f4c21591d54fd7e6b0d9e806fccc4b14,1054,TRUE,1773,719,
85c996e25ac6d92fb10c68665a0f184c,1287,TRUE,2694,1407,Radiant
aefbfc85b686b7a8ce99799acc9227f9,1036,FALSE,2633,1597,Radiant
ec3379aabca70a35b459fe3977fdea08,1073,FALSE,1610,537,
be8a043d7e7bf701fb9c26b9e248b54b,780,FALSE,2044,1264,Dire
426117a99f86911a07983549b1e2e937,1483,TRUE,4414,2931,Dire
7ccb6dd7f9e346e74d7a4370fa6c44f5,1230,TRUE,2301,1071,Radiant
96d009ca11ac1bb249c4ed4a2a638854,1986,FALSE,3291,1305,Radiant
fb58a706f3733d629bd0f0eb03814423,1185,TRUE,1260,75,
e28548be23d60bb5bc854e396b8a21a1,1667,TRUE,2367,700,Radiant
5baf441d513c408c456889e1236bd539,1175,TRUE,1821,646,Dire
fa18d0e2a3f40b2581a0f99687576dc4,1620,FALSE,3332,1712,Dire
e4cb98d341d90e03f800bea11c8b0481,2155,FALSE,3346,1191,Dire
42d6dcffea82267c37051cd037b748e6,1125,TRUE,2088,963,Radiant
3f882bde4cdab69bfa9e6fc5e7fdfeb7,315,FALSE,2217,1902,Dire
de164d6ee992ef1663932774aea3e83e,1640,TRUE,2412,772,Dire
b4d8be615d2b49eae90758716d2c7332,617,TRUE,2252,1635,Dire
5bb59adbfdc5b40c2202102c656ef3c9,1511,TRUE,2147,636,Dire
c62536d85ef79fcd6b30a76a2e442928,1945,FALSE,2929,984,Dire
1527c9bfb2fd81ea3d463d67e22ef2c2,261,TRUE,1747,1486,
f789d29811e2c343868a5400d748ed15,451,TRUE,1907,1456,Radiant
7a8c3399ddc658a76488e2b0b16fd26b,464,TRUE,2491,2027,Radiant
da19b8704e640ec7bd3a559908b951f5,719,TRUE,1076,357,
be4ddd726eb6729e0962062b3cdce052,526,FALSE,2028,1502,Dire
990cf10ab770b91611ff1aec1795d6e3,922,FALSE,1467,545,
3f0b34fdfd8bd4fad04cfb6178ba547e,1606,FALSE,2013,407,
91f78a7d58908158d00311749edb5a0e,1323,FALSE,3621,2298,Dire
7b164916ce020585434052101c0480db,776,TRUE,3107,2331,Dire
2fcf0803bd2bb49be8765b0b594dbc9d,541,TRUE,1977,1436,Radiant
ee61a3424b3bbcbf5b4180787e4732be,708,TRUE,1601,893,
b11ed83c11d6f3d0784c6c01bdf07828,1475,TRUE,1803,328,
6ea93dd4c0fb8f86b58f9c89346b37ad,1631,FALSE,1889,258,Dire
0f23ffa79583e70b4fe45343c153a1bf,1152,FALSE,1898,746,Dire
95f6c0164fad3b35edf08edea9ba3a1e,295,FALSE,2403,2108,Dire
90dde8a0cec1bd1c79796d84488f8095,1193,TRUE,2195,1002,
642626bde86e550c1c2d09c6b6c59c30,1318,FALSE,1486,168,
e2e45eec92179738d7a1862d9701dd27,1934,TRUE,1999,65,Radiant
832a4e4bfa81cd2f2e098c57b62382a2,1266,TRUE,1894,628,Radiant
5a8862be0551b467c7257b5a28156148,371,TRUE,3075,2704,Dire
49f0cd11be9304576947f6cf3d4d64dc,618,TRUE,1921,1303,Radiant
4f4d595c72ee2aa131e7071eb2519922,1305,FALSE,2206,901,Dire
3b628cc446102987fb2d470649f3ae63,235,TRUE,2461,2226,Radiant
784900a6a1c7fc608c786e01f717eb84,1568,FALSE,1936,368,Dire
42b28513c9e9a701461d53d7d94b2888,1450,TRUE,1606,156,
26978e40841c8cc95ade513fa0dad8f8,263,TRUE,2110,1847,Radiant
bd8db9f30dbc55b3c6af461548730dd6,306,TRUE,1814,1508,Radiant
e2d1da240441193e5a81137042f7313a,2166,TRUE,2200,34,
5c03feb1a706ca32a4c4f57051bc4a4e,645,FALSE,1949,1304,Dire
fad8c663fb44ae997346f48b9ed58f3b,1680,FALSE,2805,1125,Radiant
079109113189f53578ce062a4dcf47a5,590,TRUE,1113,523,
d91d85ae3772842bd925c8cc2fe51e4f,2784,TRUE,2914,130,
aa2299fdb5997287934ec3b21f2826a9,216,FALSE,1883,1667,
093992348522afa83923cb3759a66d22,554,TRUE,1257,703,
866e177974c4cd4bae55782f9a64538e,1257,TRUE,1882,625,Radiant
93fb508aa2364ec7e44e463d16202698,596,TRUE,1825,1229,
09ed3a8c976f7bc1c66e3077b7a9a9ef,111,FALSE,1436,1325,
5b4b5a1920c2d9370ba99df417cb8c31,2015,FALSE,2131,116,
1a449c33525155a05795d16ec46efc01,1205,TRUE,1615,410,Radiant
04be0050dcd9578c94f00c6f85d8e740,865,TRUE,1259,394,
dcc84c4e42fc6f367f5a40c907b287bf,1492,FALSE,2945,1453,Radiant
2c152547c26be9950c9c0d6b75229d3a,1275,FALSE,2299,1024,
1ecb80f01faedc90d2f7bd66e925582b,638,TRUE,1085,447,Radiant
0c2e9b239bbd25f30d7cfe4d7ea17271,9,FALSE,1900,1891,
494ee7d8557d71f2ada34783273226e0,1202,TRUE,2190,988,
97f42f0641c45edeff6636731b0a4e97,253,FALSE,1308,1055,Dire
8ba076e9f4ee5aa738cac1b94fecfbcd,820,TRUE,1872,1052,Dire
61ab3d3b01dda1069551042fec63a4c6,1561,TRUE,2777,1216,Radiant
e036f68ba7e7a1e37e67bc3f22eded6e,2058,TRUE,2226,168,
7a6c14006044a7d11e5a27a9abc24bbb,1566,FALSE,2202,636,Dire
cc6f7d6e4e49ab0589a13929ee3968cb,153,TRUE,2100,1947,
70a12a208da13ebc2edcabe2e191b4fc,912,TRUE,3635,2723,Radiant
2783a851faa986d8eff23548269bfe8d,234,FALSE,3004,2770,
f4ca377ee40a57183245c838b4740e48,986,TRUE,2682,1696,Dire
f88bb3241e40d79ec1acd248df88bc0a,464,TRUE,2161,1697,Radiant
116e04a388bc70ed4c27f7fbc6d3c540,1224,FALSE,1453,229,
2042234b6da14143dad74068a67097ee,873,TRUE,2860,1987,Radiant
396caeee45f6d1717d19db12affd4142,1327,TRUE,2361,1034,Radiant
b591aa6bc18de4dd8acb39f56d364bc3,1282,FALSE,1925,643,Dire
b0af9b8bf008af1f7b529b6250d4fc51,2113,TRUE,2393,280,Radiant
82eb909438bbf7b8d53b86f97b523760,2412,TRUE,2479,67,
f98fb10199be406fc9d16778f519ef38,1560,FALSE,2262,702,Dire
1dad90e141380af5dd18e06021b71dfd,3932,FALSE,3987,55,
a2c480ac578a0f724491f821d2fed4e6,726,FALSE,1763,1037,
d504287bb1a6cad5d5fe8f8d0c8ba1e8,400,TRUE,1756,1356,Radiant
4fbbb57e8e67d83c039b935ecc0e772a,813,FALSE,2726,1913,Dire
4a1d7ff29cdceca65b7bc3946729f376,2016,TRUE,2225,209,
bb81948b4f12fb13e74fd52ee6b303cb,700,FALSE,2218,1518,Dire
d729c7110e347f87677c41255a840a94,1604,TRUE,2322,718,
56bac673f0d5b51d84c8a5e598f5714d,202,TRUE,1245,1043,Radiant
aea1a939c1cb88945c8a23756849af79,592,FALSE,1828,1236,Dire
1da573ec9d9dcdac4945a1787b652085,385,TRUE,1234,849,Radiant
899602f14ad5d4c13d9284911495982e,2348,FALSE,3480,1132,Radiant
e7cad3cde2b9d7178ab973b6d54c5f91,1252,FALSE,3379,2127,Dire
845a8095b58b907ad67c8f93ed9fb6b8,2699,TRUE,3750,1051,Dire
dbc1ec8452de76a07a5df3782debdde5,1606,FALSE,1663,57,
3fd30a52994efa7499fce3143ad757a5,596,FALSE,1767,1171,Dire
dc3ac5dd2356cef0aadd1c8dc5801728,46,FALSE,1454,1408,
2dcc521df8467aeef778b79761fb9631,538,TRUE,2462,1924,Radiant
4948ad0a38684933fdf9d0bf81a1ecae,185,FALSE,1621,1436,Dire
453fee86e524027db9c61f610e14c015,2882,TRUE,3436,554,Radiant
8cc3e2528f3185e554943041279ebb6d,2180,FALSE,2277,97,
0b2870809a0bc9d7ba96b9a56e962a16,857,FALSE,3063,2206,Dire
25bb2419bf6114d1bcf0b10b85f42788,419,TRUE,2386,1967,Radiant
80d12634bf84dced056dbd91d30fbb51,653,TRUE,2228,1575,Radiant
9602dfe27b927c8a1319ae4a9297d001,1585,TRUE,1977,392,Radiant
3e35f8955dc246952910c0f37b548dfa,115,TRUE,2121,2006,Dire
275d7fa8a39c92a5b288b25dc20f852a,1434,FALSE,1516,82,
9016db43c2888185cbc8b781d6a7c278,237,TRUE,1788,1551,
554c7c9b12c903b527a569700278a8da,736,TRUE,1291,555,
e604d37dd584d4cb17c7b80a1c82d871,526,TRUE,1750,1224,Radiant
e6fe9a2ec4cc7bb1261a8abb9232134f,558,TRUE,1267,709,
cb4ae4b76a8eea2e41bdd8e826364588,521,TRUE,1707,1186,Radiant
f22b2a1ff989df6d86a5c57b28d2f0ef,2840,FALSE,2880,40,Dire
880820ac4831f28ad9c5cb40a3ba5adb,2827,FALSE,3310,483,Dire
6d60a9c5ac670652fb1857177fc09f6d,216,FALSE,2344,2128,Dire
eaf683970b68cb22bd1edfed08a3f606,578,FALSE,1763,1185,Dire
0f60d033578f1f08a8da071a52f3e934,1568,FALSE,2279,711,Dire
ed9b69dc0f6ab18a7b906387166bddd7,2200,TRUE,2466,266,Radiant
8521c93954d7027c7e691d8d87f9fdc5,1080,TRUE,2554,1474,Radiant
b94fcf4cb4d2f4ef7df38c97ee5a1bb2,1494,FALSE,1526,32,
14b63152119c2d00a2110134c7bece0f,2415,TRUE,2859,444,Dire
c5b7f497cff790cd2d378122881f206a,638,FALSE,3182,2544,Dire
9f00af108a037bee44eec7d0a139ac03,1857,FALSE,2541,684,Dire
39e6a7a920a8767d1678ed71930cc07d,562,TRUE,1900,1338,Radiant
16b8d3cbf9a35bc36fa17779797b4029,971,TRUE,2161,1190,
9c72b2f31e143f9f25b34edf2b2ae485,232,TRUE,2100,1868,Radiant
bb443a1a77db097b657119fa848bd026,465,TRUE,1664,1199,Radiant
74e060169583389698e004c4b7edcfe8,206,FALSE,1948,1742,
e4eacf6038b53a7306265c336a9062a9,1273,FALSE,2538,1265,Dire
1dceeaa09038f13ef62b410c228f8f99,245,FALSE,2427,2182,Dire
06149b36100a2e5adcd0ab6102bae2ff,62,TRUE,1451,1389,
cebd6392e6fa86754c1d2d11aa1e31eb,1565,TRUE,1925,360,
85cf80f9318a42a70926daec1afc2053,694,TRUE,1550,856,
0d8f96e2bff0dc8c1b7c02cf775bba39,446,TRUE,1328,882,
0b24ad56d751cc02ac4a099cd76de43f,322,FALSE,1318,996,
867d0546686a4852cabfd40c6a199ed2,1854,TRUE,1955,101,
2111bea3b35fe58531c7a8554f7caec1,1200,TRUE,2141,941,Radiant
18cf7aee3c40f1f34d91849e3a7b392b,27,FALSE,2047,2020,Dire
122f71099405632e630f57c8c54a7ab6,1738,FALSE,2147,409,
45aa1da55992e5e329eb844e4b085e93,1197,FALSE,1914,717,Dire
e5e948acdf4319edde07abce532b417d,1893,FALSE,2760,867,
14074c8ad42ef79212c23d4dfc411023,1468,TRUE,2171,703,Dire
1976faf2198b51dc7d5aef6a6406f4a7,8,TRUE,2266,2258,Radiant
f6b3e3d520af8bd21a969d33b342e964,2237,TRUE,2463,226,Radiant
dc40042595a3552834c4e14d4dd19a59,362,TRUE,1443,1081,Radiant
d953950ad0c605a8fac3e3261ede2d54,133,TRUE,2408,2275,Radiant
9267b0aa07a0b67ced13fe3244936dbc,1758,FALSE,1897,139,
ca8dbbcabc189c583494dead99ee04e6,994,TRUE,1562,568,Radiant
5f5f6d0fa966a99972d9982d579ab5e3,846,TRUE,1032,186,
64453968ac45e40e94b96e8cc5e7b548,386,TRUE,1581,1195,
36e5b902cf0ee51d147eb6bc7e2771fd,3400,TRUE,3656,256,
fb3a8d5f1e255c5437569eb480b5c8bc,935,TRUE,2020,1085,
de0ba297ff9e82245c1e40b7291f16f5,589,TRUE,1170,581,
d5926867a657e579fc9a28f2d57390a7,1624,TRUE,1730,106,
6ac75c57e74a7bf7a32843fc4514d357,146,TRUE,2616,2470,Dire
6ac990eecfdd0bfea25ba7ab9ccaeb6c,307,TRUE,3048,2741,Dire
1f37c25adc4654cab1bac9217e86555e,691,FALSE,2941,2250,Dire
44e7735983b9390be6d2ee34be547b4e,1242,FALSE,2102,860,Dire
3b66eb2bce9984214dc0e3c6aa5dd33f,1600,TRUE,2369,769,Radiant
bb6945dda15c410335b4b3be248a91ab,1354,TRUE,2362,1008,Radiant
ea649226ac32c262246123e3131cfa87,1660,FALSE,2850,1190,Dire
ec1b5e1222a52879e78bd35f5075f63e,1139,TRUE,2282,1143,
a1421b2b3d82b62b26a190d57a266f5d,186,TRUE,1825,1639,Radiant
bff74a5ab4ac72be0225688888186444,588,TRUE,1559,971,
55b96e53a8f2084d5d40ca67ef0d6e64,64,TRUE,1402,1338,
06de7ff799a5118b3a452cce92d3c2ef,2102,TRUE,2535,433,
4b6e8a487f54d10fa3dbab1f202d197f,809,FALSE,2472,1663,Radiant
2f82cfdfb748fa9ff6047c433ffb990e,1204,TRUE,3623,2419,Dire
8742ffebc531851a50ca00a403c7f7da,621,TRUE,2006,1385,
fd6fe75c6a76ffa1a5dadbb015cf6074,749,TRUE,2264,1515,Radiant
9922515c4f14441324c694b13cb21367,1426,FALSE,2502,1076,Dire
ed3826d2d964c7cb0b47d84d76e01a92,1474,TRUE,1633,159,
785ba8c8c12ee51309c2d37756a63c02,1215,TRUE,2672,1457,Dire
6b46cc689824f53591dc7319c94818ac,930,FALSE,1314,384,Dire
99e1749c8c6f8441521b93f51dc8411c,1526,TRUE,2295,769,Radiant
3e8d991e0a472c63f90cf4335992cfab,617,FALSE,2910,2293,Dire
cb0bc5d2c7d750c0a73a446f4c29cb05,661,FALSE,1343,682,Dire
e2fededaa6faedbc91e9b6509080432a,341,TRUE,2401,2060,Radiant
64bb95d9a69ef16666bde0141c10e4a2,355,FALSE,3028,2673,Dire
9c2a6f5fd581c21ffce874428d80ceef,751,TRUE,2047,1296,Dire
9f31669274c8db537878ee5de7803c23,2304,TRUE,3021,717,Dire
f8ee45aae7da9a93be43fff6ab19ae32,1204,FALSE,1389,185,
662597dbc144cc6ae91513f87bdefe53,1708,FALSE,1916,208,
0139234bc4092bb0a5a1bd689fde982f,544,TRUE,1356,812,
f1418d863ac73c3e8ef6c9e9acb06d6c,660,TRUE,1512,852,
6d844c1998eb278c0a1469cca992e497,704,TRUE,1696,992,Radiant
4742e886f389bf7129b8ff5d04c1af03,1198,FALSE,2137,939,Dire
21d68b873821f96a6eb89938d41c5c41,1124,FALSE,1616,492,
97a7df65aa815dff5108ccc3fea7a201,126,FALSE,2707,2581,Dire
5ddfc845e6e7f163e8369d0adf2f6ca0,984,TRUE,2048,1064,Radiant
ac156bd1745433fff48a8b2d3bc1560d,2061,FALSE,2253,192,
184496db12820cfc60cbecb2693b3b02,953,FALSE,1719,766,
3da9d9274e596d8671148f966c9323b0,1443,FALSE,1669,226,Dire
f6ef8469019743909719f39a8c4aff8d,2627,FALSE,3591,964,Radiant
b85428a417dd4f2cbd9f40aad09c4606,1003,TRUE,3188,2185,Radiant
bfe9cb9976a8b5766439cd5fa9b96a10,965,TRUE,3227,2262,Radiant
e4fc1bb04edbaf0c59e6020f0bc8b406,2236,TRUE,3123,887,Dire
a95b052d1c59ca0662d4b2b7bf24c1e4,2624,TRUE,2779,155,
399aa069480b04ca16e845cfb148f701,325,FALSE,2725,2400,Dire
6fdc85ea3ca601ca8aa24b3c448de967,1831,TRUE,2337,506,Radiant
28078677b0a26201241d338fa3826e1b,115,FALSE,2100,1985,
5a58d0073a9a5dc1a23d13eff7f074da,609,TRUE,2057,1448,Radiant
6b153d509e63add294658db17cd3b773,356,FALSE,1860,1504,Dire
0048e685654ce10051ab93f228cc0586,1920,FALSE,3399,1479,Dire
f68eed5c98dcc47c407a5f90afe14396,3308,FALSE,3842,534,Radiant
696529ed2f18cf5879e661f75f1d6370,1606,TRUE,2367,761,Radiant
209fc189b1e4919c04048010db3812d8,117,FALSE,1758,1641,
af0aec1f014b3433c55d13cdfa6c0d7b,1998,TRUE,2841,843,Radiant
53c8b12d0251fbef1c09a6a28be5efa8,435,FALSE,2871,2436,
9e12fb664c21890944b9d45cd227f574,2465,FALSE,2856,391,
c3c980658f052943a04be40b73bcad15,117,TRUE,1923,1806,
fdde50183626af7548c8511e097b449b,1282,TRUE,1772,490,Radiant
a82fe9f24148af62aadc4644781b0386,66,TRUE,2060,1994,Radiant
38d525c8e671644c5c804c0e18d819aa,1865,FALSE,2207,342,Dire
7656ea4df7ef1721107e83cc77f08682,1969,TRUE,2212,243,
500e2217a25ae574951f5604056d1183,1418,FALSE,1986,568,
e7fb73b051bd5fd516cf538710954992,554,FALSE,2574,2020,Radiant
9fa99585ba738b08296b26a46637f9e7,300,FALSE,3092,2792,Dire
220265f3e9d4e577c99dc5251a154bed,911,TRUE,1248,337,
c724665adca763d02b95ed13f0d69295,797,TRUE,1899,1102,
f499eb5cb22190c0bd3405f7a040785a,1707,FALSE,2970,1263,Radiant
86cd22c820c4142a95a5f7f93cf0c122,593,TRUE,1013,420,Radiant
691382fe199dc8938de2424f6ffef950,2861,TRUE,3100,239,
0b0bec2fbc8d7249d410bee7b16c977e,235,TRUE,1360,1125,
98b12c16c983161d377e7020652a2151,1032,FALSE,3130,2098,Dire
63134f08f85ab1a9ce351445e4fdf0a2,6,FALSE,2674,2668,Radiant
d51ddd808c205a4adb1897d35a3d0de3,1175,TRUE,1575,400,
9ff65c4dec8aadc652ee70d220a7109c,2998,FALSE,3786,788,Dire
e646d1d0cb22d15847a4a674d981b02e,894,FALSE,1811,917,Dire
83e583bcd125763f54357eda67147dee,2196,FALSE,2649,453,
953e8916c2acf1c89c46749d1b02f988,1331,FALSE,1654,323,Dire
c31e536e741021ba9763249bf0108c16,577,FALSE,2545,1968,Dire
cab1a37a44b69633df8a29c953fc3541,255,TRUE,2353,2098,Radiant
9c0db6500e1129f03c95c34bcae922ee,1942,TRUE,2011,69,
469d833949fe7005c8c06ba610e5bb57,969,FALSE,1518,549,
7d3714d29706b082669f2ad64156b2ed,2530,FALSE,2758,228,
061837873ec9cd7f8e458baad4e421d5,902,TRUE,1765,863,Radiant
adfe23cefe2e98bd7c18a6058c67ec94,256,FALSE,1081,825,
5a9522845217fbeff20b8bd11f12df75,712,TRUE,2230,1518,Dire
df5fa044aad2853030b500ca2bb8d225,1543,TRUE,2774,1231,Radiant
a030adb8dd93047b4344d598398afcd5,1106,TRUE,1468,362,
cc75d78887b4ff5dae1c8868310ce276,34,TRUE,1870,1836,Radiant
ef9681f35af88f3fbf7d6d7df0cac4a6,10,TRUE,1454,1444,
8f824b99e6a2d883e69518a6617efaef,981,FALSE,1087,106,
be50bf5996efaa51a1e88cb4088df140,1611,TRUE,2832,1221,Radiant
5cf8211b306801f7a08579f23b29741f,588,TRUE,2346,1758,Radiant
671eaabd3a470d44c981edf7ecf848eb,792,TRUE,3204,2412,Radiant
a4d3c613ed8dd77433c435796623faa3,1435,FALSE,1525,90,
72761279218421674b864110a12bc1a3,149,TRUE,2213,2064,
13cedb00d016087c3d25c18eb2669f7d,3233,TRUE,3746,513,
c8681a6cbe710b476673f574d408d425,558,FALSE,1043,485,Dire
fc38b63e3d33eb1985f540560d790a98,341,TRUE,1954,1613,Radiant
ebd2090716a8f4bd9d128758642406e8,1425,FALSE,2280,855,Dire
882b4a004a13f1668f65bb8babeeec53,1505,FALSE,1769,264,
f133ea883daf79246bc950f8a6dbb96d,1772,FALSE,3588,1816,Radiant
99c524a5e7ed5f9cee7478901fd8691d,1906,TRUE,2101,195,
5c333c55112b58a369a4c4985b2d7b85,1998,TRUE,2326,328,Radiant
1872a8c9a858d7ff9cc2265921446a98,859,FALSE,1896,1037,Dire
462ebf9e4a145c1119a8aa6480c295e4,3392,TRUE,3968,576,Radiant
ddb1db87588d13d6e8cc699c5b9a8ad5,1172,TRUE,2294,1122,
99bfb6c6ce1af725f558c309147c0eb4,2585,TRUE,2764,179,Radiant
7726a72f3fc2bda3e77fa7ab9ebfd94d,591,FALSE,2233,1642,Dire
0eaeb32c63144784b7ed017003f97ab4,2412,TRUE,2606,194,Radiant
afb1dce98216e30b3f96c3bb9f597d01,1391,TRUE,2608,1217,Radiant
297c32ae3a77ba04393b0791029e4c8b,1102,FALSE,3079,1977,Dire
c9980ca4dde8c1711dbc8483f39776ed,15,TRUE,1289,1274,Dire
e132f1fc15e7d07bf7af1df1823c2199,2622,FALSE,3053,431,
bde2c117800dfd7b3b45d244f3fc8553,992,FALSE,2538,1546,Radiant
4fc3361ec07e6e7910be25ace4193aa6,706,FALSE,2277,1571,
d08a268addfa199889bf585d88525de3,1386,TRUE,2740,1354,Dire
527c113b43ed3492e4a94b69843e1282,1359,TRUE,2415,1056,Radiant
7c62fe07aa9e5150c01143d7289cd9aa,1514,FALSE,2153,639,Dire
afcd9bf54d4101685a1cce310f3514bf,835,TRUE,1492,657,
4612f8b3dbe4375760a6f62b3f2ea9a6,958,TRUE,1885,927,
a5f4285780d79690c6f1e0cfb845a57b,95,FALSE,2540,2445,Dire
f0a8f049d20bb2cc1386296184592a9c,852,TRUE,2806,1954,Radiant
1eb1c7bd2461db361db592c5f8250318,1513,FALSE,2446,933,Radiant
98e90e636d6406fd5a9c1be60c328e69,2777,TRUE,3469,692,
5abe6dda902cca060a140ddd4acb1275,1410,FALSE,1946,536,
e0ce9a8a4067bc65864801673facad88,866,TRUE,2216,1350,Radiant
9105112a9259ff2d97174a2dba5fee7a,1864,FALSE,2162,298,Dire
7d2cd6bb7028ce9cc6d8c9a9bccff902,588,TRUE,1261,673,
f32023be4741d230a72acfe0ab39182f,1483,TRUE,2821,1338,Radiant
b8a38347a3254cd66dd287800998da1e,1409,TRUE,1742,333,
36b82f38df0b9474e185b06b4cb34a56,1458,TRUE,2847,1389,Radiant
7d872f578969aaf5d428d6f72410eef0,1800,FALSE,2394,594,Dire
78f622a84926b8f0f3a2c051933066ce,747,TRUE,1539,792,Radiant
ecfbd011e774cdabe0d46688fb7be8c8,1023,TRUE,2543,1520,Radiant
6911dcb238714c4ae9e93af7ab1960cc,419,TRUE,1700,1281,Radiant
fc9088d1155ea7b489a756ba939a135d,314,FALSE,1158,844,
b7204695d8e557828859e1f0a022a6de,2242,FALSE,3435,1193,Radiant
e1e6251df2a4dd0a635d46819cc4d81f,739,TRUE,2132,1393,
a47e5a6edbd638b5c20e015ceaed54c7,100,TRUE,1964,1864,Dire
f5963c61349cb287f746491b9f92655d,1192,TRUE,4486,3294,Dire
b1f5171c39c8b76c84e9b6cfec82ad73,558,TRUE,2220,1662,Radiant
aaea8dfe623ea4c8716f771a5e27e028,548,TRUE,1641,1093,Dire
5541c292640966820bc072915206f4db,157,TRUE,2077,1920,
83cf70195a3f2e1e3035df25032ebb6e,1991,TRUE,3164,1173,Dire
d89b2387f0506932925ef6d3eafbbf41,71,FALSE,2657,2586,Dire
8d605c424c3aa5865c0594c0083789a1,863,TRUE,1628,765,
98294aa2a67f2bba00474e50666186a0,348,FALSE,1869,1521,
ef5b89d6639ffaca020efd116fe42719,936,FALSE,2599,1663,Dire
e39799d41e5230fa4cf14bd473dd086e,711,TRUE,2502,1791,Radiant
206b015856a28057c60de53bfad44142,1557,FALSE,3666,2109,Dire
482ac0205c41d419ac8e89e08048e8b5,1211,FALSE,2198,987,
21bc32e8edb93bede269a61d34f39ff0,1346,TRUE,2529,1183,Radiant
497e8e4961df9e97593714501cad4125,1173,FALSE,3271,2098,Radiant
fdae21719d32a7c2004154586e01aabb,432,TRUE,2097,1665,Radiant
af2d83e21148a156f796bab3341752c9,148,FALSE,2511,2363,Radiant
36f1d7bd4e27193b3176902fae50c880,1046,FALSE,2051,1005,Dire
ac4cd365e13cb200a24be7da459f7835,2664,FALSE,2912,248,
4a1856c1a23b0e3da3e51c59d4a56a0e,56,TRUE,1474,1418,Radiant
d26e62d0e40c69d9038dc20533f3a6b8,630,FALSE,2675,2045,Radiant
f00f18bf84ca038dae4ba71a354766c2,439,TRUE,1961,1522,Radiant
127622187cdc5e5fe31bb3aa6170118a,341,FALSE,1886,1545,
54131aa51a96031189fc8fe261d8ca6a,717,TRUE,908,191,
67c1ad4985ae7fff3b9d9b6acf43197c,224,TRUE,2015,1791,Radiant
27c44e765df9fc63917f1842f0948226,1765,TRUE,1951,186,
021077051dc96dfa75069ea23a05f72a,914,TRUE,3704,2790,Radiant
3748917c12d32f8f19f11c09367c5904,910,FALSE,3394,2484,Radiant
a8bf87be72f18e8ed6b27da759af60f8,1464,FALSE,1666,202,
ba114067bd5d7b2992c536c71e5609c3,582,FALSE,1520,938,
5c68866de71ec62288d576ef2370cf12,588,FALSE,2150,1562,
44e903c4be063fdb473e7bef521f0cc6,2130,FALSE,3082,952,Radiant
94f458cc37b94bb0c0f0ad6c77e4fb7c,2002,TRUE,2386,384,Dire
902c14e5741cb7cd18353ac7bdd4ba7a,4,TRUE,2259,2255,Radiant
35f129411c8daf7264416e0df8d4becc,508,FALSE,1678,1170,
f9242944a3f00dd0a60eb4a4365b8e80,3071,FALSE,3103,32,
72afb1cb16f1c9af64663d028b9ac28e,1739,FALSE,2103,364,Dire
c181f17ac9871662c71359ccc809c1ed,1048,TRUE,2017,969,Radiant
b8c83b24da14224ad2100a1a8f4e5f9d,123,TRUE,1891,1768,Radiant
cc6e06d15f634a204aa6022153767576,3031,FALSE,3196,165,
810914afc6f5e4cafb68b9f2cf49b5b9,2006,TRUE,2197,191,Radiant
d09da40588af0f8ce638ecfcce63b181,1180,FALSE,1897,717,Dire
1238903a132aea8728f8b1d8dde43f05,1001,TRUE,2536,1535,Radiant
da8c8bd18085f738b65c28c19f01565f,2023,TRUE,3659,1636,Dire
0a843e356872fb141c81e8985186215d,986,FALSE,1452,466,Dire
accebe27c9ee918dc09e4c2462d5fb33,372,FALSE,2787,2415,Dire
30c02b38c303fcc8f7ef3edefdcece27,537,TRUE,3173,2636,Dire
e5fc0f86fe4ccd952b79a03e0e6f110c,1225,TRUE,2032,807,
d63461605d90d5443f806b57b408dd43,1261,TRUE,2248,987,Radiant
351ed4079296b364bfb5594ba419bc89,382,FALSE,2149,1767,Dire
70bc2e0aad4be409f342b232730a4feb,514,FALSE,3629,3115,Radiant
d6983290a597fa96247317dea720e8fa,185,FALSE,1876,1691,
242887fd89c99da79920ce6c8294bda8,172,TRUE,1385,1213,
f31bbe25f7490caf53c89b3fdf0befed,1914,TRUE,2258,344,
a0c80ed4baf53e5718fce2abaa6779ad,1716,FALSE,2087,371,Dire
50571e8e0a831ea5436def89564a6a91,316,TRUE,1508,1192,Radiant
854a8f37b9da500f5840b942b27963ad,2312,FALSE,2480,168,
289c3f9a8f7fe25832242fec41ed3734,301,FALSE,1534,1233,Dire
6d5dbb18135f49270f177b54f224f14c,1037,FALSE,2243,1206,Dire
af9a544357595f1f6e7a7b16f317a1ce,639,TRUE,1669,1030,Radiant
f9fca0882ec21f40998694ccddf239a8,446,TRUE,1747,1301,Radiant
f1ad0607b343df6878255dc26b7f33b0,1170,FALSE,1475,305,
d7f096cdb0b34cef0b52ed9400bf33d2,1,FALSE,1347,1346,Dire
9f3e295ddc4711b53bf88c4fb455d99f,1054,TRUE,1554,500,
b3e2a43082bc0024f70604bb209153cd,2353,TRUE,3448,1095,Dire
ed06155d45025952c97a9151d3f5461f,1330,FALSE,2332,1002,Dire
8600d2f1b4adb2fee211d6aa67f437ae,719,FALSE,2978,2259,Radiant
85a7adb702fafe1f79e6dd3c52bf31c2,394,FALSE,2267,1873,Dire
1c9eb5803282d5e5d6c965033326de9c,579,TRUE,1436,857,
0f41ef61633b4b65aefeac52bb14a9b1,2091,TRUE,2123,32,
6b183f784801ae9f8e5e7942802ebd7a,461,TRUE,2051,1590,Radiant
247adaa66fb5369efcf654f63774e242,2415,TRUE,3253,838,Radiant
cf3c84b9ee8e192618a359b0b9281dba,242,FALSE,1748,1506,Radiant
2377d07b31546aac01c189b0fed548aa,1142,FALSE,1501,359,
c5a8f6a0f65651142b3ef3d19aa7fb5e,2117,FALSE,2597,480,
c1146be6438aaa392540c0080baa878e,624,FALSE,1043,419,
5e145c68a53193ec70e204d34b311b13,2718,FALSE,3376,658,
c2083b56668458ff0f9168a7b7796a70,1926,FALSE,3555,1629,Radiant
3c202f3bd39128901283903d2433c66b,232,FALSE,2078,1846,
515478418b9f755e85e13e399b502843,1241,TRUE,1295,54,
bf71f1f1616e6b8bde7bf047b91dca54,1688,FALSE,3314,1626,Dire
338bf106fb2a61a9b0981b0198e49ee1,529,FALSE,2656,2127,Dire
441e149e08990ad9b9698e213a22ffcb,1644,TRUE,1920,276,
4dd1d944d45da43409b4f6ce8bb1d4d9,1281,FALSE,1642,361,
f72227d929312df4c98c3507787ec9ab,608,TRUE,1281,673,Radiant
d57e50421f505f2c66d47dbb54871e78,200,FALSE,1643,1443,
e207222822e79ad11b7e0a6367c0312a,2243,FALSE,2677,434,
f8794a104dad032538ac386dfbada738,118,FALSE,4350,4232,Dire
8d8f73bce365f15f3b644ed6f03ef98d,306,TRUE,1148,842,
c573ddc57bd632a11d1ad7cdd72663b9,1494,TRUE,2443,949,Radiant
c3334852874681f03623aab0e638a102,153,TRUE,1338,1185,
67a738fc9350e4cc43fb8bf0ad11714a,2345,TRUE,2684,339,
4962e5ae82e52964aba51b0f5306994b,1270,TRUE,2665,1395,
b22d28a706d34cb79208a3c357634bd9,2162,FALSE,4116,1954,Radiant
1b651b9a0e32021101e626f7ccd57140,199,TRUE,1958,1759,Radiant
7acbaef07d3a61eeea77f15389304591,1116,TRUE,2240,1124,
6291ada9f9d0fbc5ee01932e7c0efc12,165,FALSE,2477,2312,Dire
4d06629e17995383ea64e23be41e260c,662,FALSE,2182,1520,
416e2c9282c7b693a74109737fc4d9b9,1655,FALSE,2161,506,Dire
971badf9e664e3cb3737db27c6c1ac3b,140,FALSE,2783,2643,Dire
3248ccb45a34670d68f1e1ee1fb818c3,1780,FALSE,2143,363,
48eaa90323240aea31a3c0ba223f6271,1187,TRUE,3057,1870,Radiant
b529e6b3a7c7cf4b9e58ab09cb7aad47,1802,TRUE,1931,129,
f7a9f88d0f28b9951aeaf4d4e21e6965,859,FALSE,2516,1657,
50e6d245dfd2859dbef2e2ef54764383,2091,FALSE,2272,181,
9b3593a02388c134fad47dd463f77e64,1091,TRUE,1520,429,
80d8b10dabcbbe48bbc601e3b1adddec,1323,FALSE,1995,672,Dire
9da873062cdf8ec5efa9af629a63b949,455,FALSE,2127,1672,Dire
7b9e4ef4fd03b57baaf410df02c9d610,1735,TRUE,2767,1032,Radiant
6104eaeb169ee56a46d86c8cccfc61d8,1384,FALSE,2084,700,
b037330bef35796bef0dc0f5dc9c832f,1485,TRUE,1812,327,
7a465a7d90ee306e3a8bd06230ea5815,1120,FALSE,2392,1272,Radiant
d6ccfaa2e4bf803ffbf9de75192143cb,513,TRUE,1306,793,
e69d9f43d21a07ee995d69012ba1ed60,2395,FALSE,2663,268,
1a4480e005285f74d171d9f71019b16b,996,TRUE,1518,522,Radiant
fd1e9322915f58e057324ef647e4b383,716,TRUE,3092,2376,Dire
93e5aad06eecf742aeb46e9338fdf450,515,TRUE,1483,968,Radiant
b94d23d12675fe55322eefd5a3095799,991,TRUE,1408,417,
b592432406ce1f26c664ac49505735f1,788,TRUE,1737,949,Radiant
f0b83629fdec417d36962315a0842156,1772,TRUE,2237,465,
9638ad37e4a62356d20210cb848a44e4,788,TRUE,1901,1113,Radiant
929b5c93565c28739cc634487c2da569,2734,FALSE,3838,1104,Dire
792cae6462be95f7014990be01d1ae58,1387,FALSE,1782,395,Dire
7273770a10126660992cc61c2ed926ac,3625,TRUE,4618,993,Dire
398ea5040f5e28577273d010ce64b643,1549,FALSE,1761,212,
60d229920962845af1322d6e7a5c0328,1452,FALSE,1963,511,
236aebcee5efa24fe434f45389a6a851,404,TRUE,2044,1640,Dire
1786df5e9134e98c16dc35f6fd9e2f00,30,FALSE,1944,1914,Radiant
61911e047202343c4f02b972bc80768d,2417,FALSE,2861,444,
093131becde7d2aa7f8c1e4ae9bbe07f,771,FALSE,2003,1232,Dire
41286daa607d9f50410ddbad1bacd137,382,FALSE,1606,1224,Dire
1fd3fbbb208f587847b1cd677b97ae22,1653,FALSE,2692,1039,Dire
9b6a39e91573f537abd32624d12a75fd,1188,FALSE,1955,767,Dire
85f4a933cc5908d45fc7345014586a79,1966,TRUE,3339,1373,Radiant
0f9ed4971f7707db195d2bb48b561be2,549,FALSE,1985,1436,Dire
71192805d8823eb426f26bf71f382adf,94,FALSE,2546,2452,Radiant
0806739b20c100aec86c5a42abd3a430,509,TRUE,2735,2226,Radiant
d9afe982346d8753683defdaa9a4e931,19,TRUE,1391,1372,Radiant
ef2d26c5195e31345381aedc6e3fe18d,1293,TRUE,2185,892,Radiant
610a38265a9da66db1d6bde8157f6581,1188,TRUE,1747,559,Radiant
1ca38fe1699a355b512238be850f3fd8,1702,TRUE,2469,767,
c4c6cba7b312c3d33577c8cbbe696796,1078,TRUE,1821,743,
5632b351f099377dbcd64979ba58b1ec,1476,TRUE,1738,262,
9b5d7007e99f4b2274c884d6e78becbf,164,TRUE,1841,1677,Radiant
331604790b1cdb40ee85fa31a283915d,276,TRUE,1863,1587,Radiant
2e963abb562d0451cc53d2532adcb82c,677,TRUE,1444,767,
a45f8ba00687b48ebbcf6f50e101df32,287,FALSE,2351,2064,Radiant
c823eebcf6d8880428be845c45274334,277,FALSE,1473,1196,Dire
9fe8dabd22a5c0c1003779c9df1d8efb,1933,FALSE,3195,1262,Radiant
1d99361965bb37900980ffaeffc34920,1626,TRUE,4881,3255,Radiant
340861abcbcb8ee492666d753f6625d6,508,FALSE,1119,611,Dire
a8db94eac98323a72e74b62c8ded0ed7,1229,TRUE,1720,491,Radiant
227cc79dd4fb64e59e1b15e134295bb6,1439,TRUE,1597,158,
fd216769706d2a5047a3a932359e293b,209,FALSE,918,709,
2792a0be681663d6b9663fe8160ec2b2,704,TRUE,1542,838,
0141fdc7b0522b710d77242c8a9ea087,2124,TRUE,3617,1493,Dire
f7923ee559ae8349a2b0cc06b01e3b29,616,FALSE,1946,1330,Dire
15887377954889795d5d09b86a196025,2406,FALSE,2536,130,
ff22d0500f2c111190cc09feefcdf573,2206,TRUE,3288,1082,Radiant
de5454e1a628cf6f8b6d827121844d25,38,TRUE,1763,1725,
1c860e79a4a8bcfebc30b8a1d9fcbadc,624,TRUE,2099,1475,Radiant
366c2ee2107ce49d49b951abcf687903,2306,TRUE,2836,530,Radiant
9f27a5b78b71d1f143b802aafe461f5b,1791,TRUE,3355,1564,Radiant
0051886e26e5efc61b27e8598d595239,1300,TRUE,1555,255,
f695d05ed3f051111d26e3f89cab1c06,2709,FALSE,4408,1699,Dire
4c01d35c0d67e4bb3d4e597dca980bbd,1941,FALSE,2130,189,
9be540d1583c274d716c1ee4fe675999,2168,FALSE,2957,789,Radiant
6cd7178dc3594606ff7644c0cb7c3117,2252,TRUE,2521,269,
a35618b312fd036e2a0499811490b037,789,FALSE,2713,1924,Dire
d3cbb0292834f96de75b1bbb428806c5,685,FALSE,2490,1805,Dire
403ddaf6e5249c9aa56675fe1e89c875,91,FALSE,1612,1521,Dire
62b9402df288f9d4d6cfb65cd301f282,365,TRUE,2300,1935,Radiant
51571ae168d7a5bf8d67ca4e224b9a29,749,FALSE,2101,1352,Dire
f3cfcb1800f6aca1a565f3b6c6f68c57,1309,TRUE,3412,2103,Radiant
25df952ba915455c1fc59b934a772e21,1098,TRUE,3890,2792,Dire
49035f2cca59447d9cdac37de5f54aa6,2388,FALSE,3236,848,Dire
6a721b0c8405cc826e842fedd7ee7e2f,769,TRUE,1724,955,
eb5d1277326e3f1456f8369d71fc9749,973,TRUE,1738,765,Radiant
aa33b23f3d3ebc8e51c785d0900bd5f1,900,FALSE,1472,572,Dire
e909c778823bfe8463ba94ce75c8b838,412,FALSE,3058,2646,Dire
d5d96344c4d931d86052641eec206600,1280,FALSE,1744,464,
5d29adc5d1ffc50957267418f3a46642,2317,FALSE,3080,763,Radiant
43e8568c25124b907c4ca91692ef3efd,687,TRUE,1208,521,
8a84e0c53e08b8c3601b24c1150eb84a,759,FALSE,2393,1634,Dire
f604af7172535dc682097aa358de593c,265,TRUE,1844,1579,Radiant
450d2cb522f1958558f1c0531f86e8b9,601,TRUE,2437,1836,Radiant
9d61ec5d3412bc5ffd6cbd84ddeaef5a,718,TRUE,3171,2453,Radiant
45d497a15c5099a0345bf959807c6e85,2114,FALSE,2903,789,Radiant
206183e7314581a085e878c9c035625f,2210,FALSE,3401,1191,Dire
1e7145c74f21b8b80cc9af7ed118c4f5,1197,FALSE,2783,1586,Radiant
454c13db065a8606b3cbd32184b8577b,2283,FALSE,2632,349,Dire
b728f7358eb68ca40b45938b9c65aa44,439,FALSE,2183,1744,Dire
3af751281df47b18c21ff12bdacffa3b,66,TRUE,3563,3497,Dire
198bfc726a5f581fd8cdebb0bd4bf5be,181,TRUE,1260,1079,
d7c4f3e7a3ce22668e9afe136b12ec83,46,FALSE,1938,1892,Radiant
6d367044190e484d78e95a9602b0d1ea,1158,TRUE,1788,630,
0eecec7fdc3248b62d7c5753efbcb2c7,6,FALSE,1848,1842,Dire
006b6c07db2e99b33a4012114de993ee,2732,TRUE,3112,380,Dire
2a9e7a53f49533e6e28a460600ccc967,564,TRUE,1983,1419,Radiant
881b03577d658d7094e1733363f343de,992,FALSE,2168,1176,Dire
9edd131aeb3b1f6305ccbcff2f44a2b1,123,TRUE,2337,2214,Dire
b73c12b357af75932aa6d516d7d776de,1824,FALSE,4147,2323,Dire
0d9eaf7bf945ea9dc956c454e19d66bb,205,FALSE,2037,1832,Dire
811558b70b914497f4b5438005ba757e,746,TRUE,1957,1211,Radiant
d20d8328d470876bbc1eea8915182cd8,985,FALSE,1293,308,Dire
e2d505e672f40e3a259e8eedf69e33ab,1615,TRUE,1801,186,
cb73837d002083b7c5ebd7f21e84b72e,1307,TRUE,2512,1205,Dire
d4fee9db3911dc462f9cc9239eb96ff1,1219,FALSE,1562,343,
e541c838271698eb5a2182de1419cf48,2336,FALSE,2602,266,
275d8a4f16ae13f7079d12e6dbfb129e,985,FALSE,2604,1619,
b92ee0c3bee010214f61472e54c03ec7,1809,TRUE,2409,600,Radiant
f2528e8abda798cb2bebfae873b63614,809,TRUE,3002,2193,Radiant
444d11f86d3858373e84e8f75e665819,1673,TRUE,2584,911,Dire
723c79cb276a588188a6534d90402d9d,1203,FALSE,2356,1153,Dire
4dc0ccb22a88829ec46bd5074cb645c8,940,FALSE,3331,2391,Radiant
b142e6b7611c0f6ad96e70d18d9af1fa,860,TRUE,1411,551,Radiant
76ee6d92f13b2dafac652dc7ce060d37,519,TRUE,1414,895,
903dc1608a713c659be88bdabf442de7,1081,TRUE,1274,193,Radiant
7f8d1aed00fea478b60fac025bc45923,2285,FALSE,3132,847,Radiant
a57adee21a605d8509ea9b263587eed5,289,FALSE,1789,1500,Dire
dfb56743002fcabd5d5d16b77623fe02,977,FALSE,3077,2100,Dire
0c28014851ab498a1c63c7b413a25924,802,FALSE,907,105,Dire
4cc3921da17122a28970f243d4096c93,216,FALSE,2671,2455,Dire
51441a92ef6feaa3e15da2566dffe100,1732,TRUE,2641,909,Radiant
546a3ba7d3bcae2136e3bff8ecb11a01,1096,TRUE,2394,1298,Radiant
5bdabf4d93025f8202d9e579070543a9,242,FALSE,2061,1819,Dire
5e8455842b02ffc58291019bd4a13f1e,327,FALSE,2561,2234,Radiant
27f17d1328727fe3f2fe9ebb36f2366b,915,FALSE,1641,726,Dire
502f2a8779e0349fc85a91693fe609ed,2616,TRUE,3049,433,Dire
0901976e34653d43ba03d9a94c3176c4,670,FALSE,2802,2132,Dire
170620dd6905ec3410c164ffececbd65,2061,TRUE,2313,252,
c90816e77b27689708c93e6472692b60,621,TRUE,2196,1575,Dire
2935b3a6ccf4ff080062d0d7035e7a69,1984,TRUE,2949,965,Radiant
b43e76ce33050bf68ef18356ee5e8826,149,FALSE,2036,1887,Dire
b45ed8d963a4e2baf7ab3daaf380b709,131,FALSE,1442,1311,Dire
b775f8704b1b4b325299a36785ad0d2a,1444,TRUE,1791,347,
817e9d3dfd29334b7374cbc5a3f8c420,1144,FALSE,1648,504,Dire
58af4d7e20bb3d0e1d3a1847309a4ee0,582,TRUE,2087,1505,Radiant
c0f6162629c7f513a7d739d538f5779b,454,TRUE,1964,1510,Radiant
be42635b44385728729edbf91e4ca267,317,TRUE,1642,1325,Radiant
6a3a9c49f43c1c3106385590562288f4,361,FALSE,2755,2394,Radiant
c30dbf77edd3606568efcb7412c3d096,967,FALSE,1373,406,Dire
ba27ed17de0dddd00f3a9707847dac1e,1213,TRUE,2791,1578,Radiant
f400803e70ad136715516e01bafe5563,700,TRUE,2195,1495,Radiant
cf1d21a20aa29d1d78a929b767131551,1139,FALSE,1317,178,
04687d2edd7f3f9075ea7ea77aa82738,421,TRUE,2154,1733,Dire
c62f24083ee0f3596e275392255f90e5,1330,FALSE,2579,1249,
f298634a04e298cc381ae5bdeccaa2e4,3625,TRUE,4312,687,
44e24860a96bfa8b09697a68258fbcdd,1784,TRUE,2112,328,Radiant
3ae1ff8f1e7805d37c863b32add55216,62,FALSE,2567,2505,
78652f565435e6f7e2016bb2c9c919ee,2745,TRUE,3004,259,
fe81a40d086683d21153ed2f829a6c38,1141,FALSE,1887,746,
20031d083e5a66d1c201b0951fa332f7,113,TRUE,1544,1431,Radiant
0689133fd2b2bde4443a82d128e576f6,1871,FALSE,3376,1505,Radiant
693bbf634ea2c3015233b45e456cda64,1325,TRUE,2422,1097,Radiant
c9c06362060bf49ec50166fda9adbc04,690,TRUE,2906,2216,Radiant
ae676197b9c0fdbb46fa3a7b797171a0,1324,FALSE,2616,1292,Radiant
a37f223145837689ad7d3561a39133f5,49,FALSE,1843,1794,
02ccc85a295b9c1c93ba9598092cffc4,325,FALSE,2992,2667,Dire
fee20b04c4ce1c63dec359aed40006a5,1010,TRUE,2668,1658,Radiant
70df68e5c46f6581986a84edbe7764fc,1326,TRUE,3176,1850,Radiant
266cfca9f8a09cc8fcb25580b459111c,198,FALSE,965,767,
a534dab497673f47c136dcdee3ac0817,1989,TRUE,2651,662,
9cf800ecc5d4a9b57b5997331526f4a2,1633,FALSE,2733,1100,Dire
2f2593314223873287b5f8fe3e957b96,1651,TRUE,3075,1424,Radiant
9e755818c0fbc5476d6706ee8ee389c2,1434,TRUE,2222,788,Radiant
170d28a7febcaa4df07f4bd3b8c69b81,688,FALSE,1585,897,
a265e7d5e696e51990a3699648e1aeef,2039,TRUE,2695,656,Dire
af9aabd83246c46ffacb5cb35589d90d,1732,TRUE,2573,841,Radiant
ee92efcb020cd7532ac59b9a563a3178,2100,FALSE,2661,561,Dire
9fdfce7c436df97fbbf4f26acc6bd8b3,239,TRUE,4093,3854,Dire
0bc0860320eb01753bcfdeda211f32f9,2595,FALSE,3157,562,
f6d70af512dbf1bb7609d29d4e337b72,667,TRUE,3685,3018,
23ddb30f8d45ff9d0c0ea06c258b363b,777,FALSE,1621,844,
268e5e26e76ebc8fa1a31bb1bb286c4c,1054,FALSE,2148,1094,Dire
d323e94fc5f2775cf31cdff5195dfefc,1094,FALSE,2039,945,
844f24c91bff98893b636a35390a1b29,2770,TRUE,2890,120,
a4c2dfd52b5f0402955e44e3bf335215,3422,TRUE,3764,342,Radiant
b5189900de789d24d0fd1388a5855803,1072,FALSE,1531,459,
15e787a6d0b543ec653807fcb38e451d,30,TRUE,1955,1925,
92db6b1c80d0562a3617e5f4944eabe3,1129,FALSE,2005,876,Dire
d78c19d833e1602a21f79288f26b9299,2777,FALSE,2942,165,
6647e8abf2f4f2ffc9635261a062038b,1941,FALSE,2379,438,Dire
1a2b16322408953c03edd86bbf07630a,166,TRUE,1199,1033,
ff80bd1276a08f341edee8649a781493,276,TRUE,1971,1695,Radiant
06f3cfa60a65df740bcd2b1b35e6a279,635,TRUE,1966,1331,Radiant
de1fadc825e21703600f9f0eb91b0fbd,1259,TRUE,1694,435,Radiant
412156d800744231c5d22f5cf2e5316b,1932,FALSE,2314,382,
2e8edef1409d4320a28303243abc8f00,3628,FALSE,3783,155,
867ec3eb7d4818971cb72b9b02182922,1288,TRUE,2099,811,Radiant
ddc41a7c1eb517b666272d028bc4cfd2,1975,FALSE,2685,710,Dire
9668fbce00abf50a3807df6829af3bd4,2294,FALSE,2692,398,
5c87b632ffe85e74c3f93c4489daaf2c,2111,FALSE,3062,951,Dire
21e082a7dbfd0337956216121eab6159,1637,FALSE,2993,1356,Dire
f6503bc7348a2c63e8624998f6c6f52e,1228,TRUE,2240,1012,Radiant
e5975033e435af3e4d3bdb3abddb4ccc,1510,FALSE,1622,112,
02368d70de1312c29776b51f539da917,28,TRUE,2091,2063,Radiant
6ee9c33d3ffe5df28c26fd9f83a54d84,347,TRUE,3066,2719,Radiant
e5748e16b99cf537473cb6fd68306d5f,677,FALSE,2270,1593,Dire
8bbce7ba2a20fec956ff55b4d8d4b243,1082,FALSE,2304,1222,Dire
28efeae6189a3d71b1d6dc7040771560,971,TRUE,1978,1007,Radiant
7f3d66ef51a15aed7f5d0f7fa6648454,2802,TRUE,3212,410,
bd5f74927fc41913c64b8e32f90829b6,2841,FALSE,3035,194,
e456e8f984a7c3de01c62712be77cf72,552,TRUE,2733,2181,
4b8d80c97f976792de19ba2af7022c58,1649,FALSE,2506,857,
2e3c6f3189e16a982b2eb1f4d97d2c03,985,FALSE,2340,1355,Dire
72ff208d733ec08bfb70ef7b1a8f189d,354,TRUE,1937,1583,
c79a35feab4beeb0a852ecdad73e2641,1211,FALSE,1332,121,
1b35c518f79840e51cc40249428a4ab4,2255,FALSE,2570,315,Dire
3633a54cf4a6fe78632fdf34ff02b76d,231,TRUE,1780,1549,Radiant
52e84a965a7163478107bef3d22fcd83,1042,TRUE,2660,1618,Radiant
c3590958ac863bdecf7eebce6c663c8c,62,FALSE,2447,2385,Dire
3bbdda0a4d8bd1e1c049b029c89e8a9d,3185,TRUE,4224,1039,Dire
926fa5ace8ee9ca8cc7fab80b2a3a829,2171,FALSE,2546,375,
22660e5a8e4c90f73d91bd52c5440ee9,2145,FALSE,2577,432,Dire
19fa98a451230bf1ea92b4de82e5ef82,650,TRUE,2760,2110,Dire
a780b9a7b5da04f4cb0c60b28d746504,545,TRUE,1908,1363,
6d8c8011026e4a1ea9f2c1a0bcdafb89,641,TRUE,2337,1696,Radiant
418fd5436d17b4ec606da902cbc2696c,1393,FALSE,2910,1517,
00afae319142971283457fd7227d793c,523,TRUE,914,391,
5eb4e58c3cae981fe89208e616e59e64,388,TRUE,2002,1614,Dire
b68fcff417ce52a106d89b1ce0e7ba2f,2057,FALSE,3302,1245,Dire
082d4b0818cafce7ec3844a1fc442060,921,TRUE,1884,963,Dire
c34806e05416fbaa63db1b4a4c709fa8,1086,TRUE,2040,954,Radiant
944eaebc4f03ad3bb04460d6c678a9b4,94,FALSE,2896,2802,Radiant
b0f1b7db331872d74ba93893807f8293,993,FALSE,2049,1056,
5b9933304644d630acd74e5aee685695,3428,TRUE,3485,57,
f634946d384c1a6117107f00c2de93c9,31,FALSE,4003,3972,Radiant
4e3b4e6a225227a7770c1a2551a893bc,1596,FALSE,2732,1136,
3f06ec4083c6c96dc9236be68fc85685,263,FALSE,3371,3108,Dire
81da0dc4bab9a6f61fcddebb88d3b546,329,FALSE,982,653,
93a376a5ba75d655f3a8df71cf5759d1,659,FALSE,2793,2134,Radiant
8b0a2cfdb7d0a144c68137632a396b0a,1270,FALSE,2523,1253,Dire
2edd2557b84df5e6ac7bbbfc85b84610,156,TRUE,2219,2063,Radiant
84a4d8b4e73cce0cdd69255348c2fb4f,351,TRUE,1721,1370,
64e107190267d347b9e1238299eb208b,2139,FALSE,2268,129,
9a4d1cc40c4b52f394880781d19aeb73,78,FALSE,2176,2098,
ddf84787516c094b87e4ce2bc7c99270,1448,FALSE,2235,787,
ee277b286d95e4e46e1852001d18ac40,757,FALSE,2939,2182,Dire
5c4d56295a4256a46d49370bf0de24c2,2342,TRUE,3707,1365,Radiant
b9f7be86195615fdc0bc0c409c6c4a24,3039,TRUE,3857,818,Dire
70f914dad751b77a8cb3e9a6890785cc,1075,FALSE,1994,919,Dire
5a8270fe4e2f05b9508a8512ea87309a,711,TRUE,2970,2259,Radiant
6afa09eb1c1e12e53c3133b692590ee4,1704,TRUE,1974,270,
85c41ced90194649747c351a5678e483,1080,TRUE,3334,2254,
f54c3c5f52877d41b7cb59ec061eb091,576,TRUE,3910,3334,Dire
3f8f7f19ca8769efab076177f136bfad,332,FALSE,1814,1482,Dire
479d1c6d12c7667c1879ac93f5b2fd49,1141,TRUE,1806,665,
35ab988880de05e46d93e97b7db3a60e,1789,TRUE,3629,1840,Radiant
b2dde9d5f77853d3c50fce417d904192,1743,TRUE,1883,140,
06289eb1248b1625e0307ee6388a22e6,1369,TRUE,1467,98,
c18e35e53d9d78b97d9c65ee2f6cf431,1125,TRUE,2203,1078,Radiant
3c76d90311d98c81b45a42a728e79df8,1380,FALSE,2371,991,
91a2eae86174fab7324e5395287e1634,479,TRUE,1173,694,
f34cbac141db1e3562e57660a9c7ab2b,1342,FALSE,2081,739,Dire
0ca609b93ce3af5d24093186c67b2f74,531,FALSE,2334,1803,Dire
345893588a5197416f31b211004e360f,401,TRUE,2891,2490,Radiant
60538da9fbe015649619ab726cfb57e6,1645,FALSE,2237,592,Dire
73fd28f153aa82aa473d01058a09d06b,1888,FALSE,2295,407,Radiant
aef60e4dbb2253b67b5572cb7beb7dd2,1255,FALSE,3501,2246,Radiant
903c377918afa64f777162d9e0dd1fb1,1758,FALSE,3649,1891,Dire
9939360eb3b5c8caa9723cd52e939a74,917,FALSE,2699,1782,Dire
f890d73e87960031aa96b73c35098c6a,1209,FALSE,2176,967,Radiant
8ae0804edbaa864ff762d9dcec5b0c0a,379,TRUE,2512,2133,Dire
79f1582073680b25946a2693f41a54e1,730,TRUE,2461,1731,
3be88280d68404ac783d1f69ae7c55df,1219,TRUE,1975,756,Radiant
0254eea2593a20ca9ef8c49caaf94de6,65,FALSE,2719,2654,Radiant
a5b716391279653c2b1fe5afda22c647,931,TRUE,2205,1274,Radiant
97f2c79e5003319f0097dbefbf9a9d5b,60,TRUE,1023,963,
dac0b383fcfe523b47f1bfd64592d7ad,1810,TRUE,2195,385,Radiant
ca5a6c1e10a0b407da2b4a63a65a8053,370,TRUE,2230,1860,Radiant
a84a8b9b4b033825c1dfd211a2c56b16,993,TRUE,1043,50,
d84dc7e9185a8e21726be7b1d7275c9b,1004,FALSE,1516,512,
f776969d9af18b89bd490b283e052775,1734,FALSE,2823,1089,Dire
6661c79e84ee20bcd4712c77e4c45c33,263,TRUE,1814,1551,
05bd945e7731af5bdf18939368e72161,148,TRUE,2502,2354,Radiant
124eadb10412fe1b4d2d07bf16c16eda,174,TRUE,1739,1565,Radiant
b1e530fba922f70510094a9d1273d858,572,TRUE,1540,968,Radiant
df15714594f6a555ab06a0120c206bf8,2506,FALSE,2599,93,
e0bbe1e1246ac171626445e23bf17084,1070,TRUE,3926,2856,Radiant
9b7dd9c8181721bf6bed3ffd242f8800,219,FALSE,1680,1461,Radiant
378f89d066a575b6c06f2955d7ff030f,1768,FALSE,2240,472,Dire
ffc81fb21194bd6deedbc977eb30ce02,1191,TRUE,1449,258,
abb4c9a59daf63d66ea5fe8878a34586,637,TRUE,1914,1277,Radiant
1feaabb0d207416ad805dd91e21ad389,2365,FALSE,2652,287,
519a562defe8b1d886ad5d3f59747cf7,2458,TRUE,2894,436,
0247837433c4e0849393763b221d0a25,2233,FALSE,3144,911,Radiant
85d0e9a66ab7c14a9a23601ace585650,98,TRUE,1118,1020,
4f76295e0bac0dd0a067bf583ed03dc6,1267,TRUE,1767,500,Radiant
ef154b6b8e693de906f2d355285c38af,1039,FALSE,1298,259,
02ecdee69c1d3a5edb9a52ea8ec69128,2552,TRUE,3601,1049,Radiant
d543663b0251446353ebd623e6794c7c,295,FALSE,1793,1498,
20eeabd5a79e39697c4d0dbee6140fcf,1192,FALSE,2643,1451,Dire
3e40f939caef3dbe6014f29895fb57a1,1055,FALSE,1403,348,
63c642af6ec7a4304fdd2eb8577a67bf,56,TRUE,1056,1000,
e72ba901cd6555fbd991ea1181d8702f,1179,FALSE,1433,254,
aa5d1ba50ec167ac4856407e16874b68,8,FALSE,1573,1565,Dire
a751c8333bb27775fff464e5689ac0b1,1246,TRUE,1337,91,
5e9051b8fe51fb03cacee6ca31b27ae9,1486,FALSE,2603,1117,Dire
6c829ecff0a6e455469d55ab20fa51e9,1435,FALSE,1885,450,Dire
61fd10d7c30ea87fd7a30f9eea9181e7,2277,TRUE,3063,786,Radiant
32038e551312b2e8ca82b5e87bfae742,396,TRUE,2101,1705,Radiant
fbe80d029450f15cbe0b53168d2ccb55,1099,FALSE,2347,1248,Dire
1f836522cd482b98722f8068aeb42ce1,237,TRUE,2868,2631,Radiant
8548cc31c679fe41c6ba91830e4956b2,606,FALSE,1079,473,
6b9c5b869e11cdfc2b05092522a69fe2,98,TRUE,2049,1951,Radiant
c8c716d00310bbb33a23f67140b23e06,1311,TRUE,1546,235,
ea97b5caf9b6a82713e8bf68edaee818,1577,FALSE,1788,211,
3a62b3ba2db2f485a9e2d0473a55e70e,1656,FALSE,2355,699,Dire
6618de4e39cf48fa3c4be845bf01d9b1,518,TRUE,1950,1432,Radiant
240966366e9e42c3c9d6cb4596790fb6,2602,TRUE,3092,490,Dire
d98172594a65b72ffa43f4af3c62e412,1164,FALSE,2539,1375,Dire
43b00755b409c2f469799b69b68d7fa3,471,TRUE,2107,1636,Dire
9568ce71c56487c22b5ff43c0d167f0c,946,FALSE,1852,906,Dire
1562f2adfd3be8375b8c6f9f25a64419,1059,TRUE,2545,1486,
ceb689fa50b228420843eec22594fe48,153,TRUE,1735,1582,Radiant
dded68a5a32de4eb1ea5b4e99cb5e9d6,1111,FALSE,3309,2198,Dire
3852c2580f5ec9bfe998d69a3456b1a2,335,TRUE,3002,2667,Dire
cfdedd1614c42730fcde14265b884cfd,359,FALSE,3085,2726,Dire
f90eb7454387822424dc210758ba061d,331,TRUE,991,660,Radiant
c8e1c5ea16442ebb78718fef57ff478f,682,TRUE,2928,2246,Dire
c4eedbc1a35c900e182ab5f2991f21eb,1224,FALSE,2931,1707,Radiant
873060026244aca3a6f0a81f5a5fb115,836,TRUE,2181,1345,Radiant
acb6f34c6a3b3e94a1ce12a1c0f2491a,1394,FALSE,2881,1487,Dire
5684757d078856eec7e404381b530643,153,FALSE,2121,1968,
ed1c23cd563198078697f33083128c42,1251,FALSE,1306,55,
dd07dc1085f37ad5c613790095b4b2ce,1404,TRUE,2194,790,Dire
0c64aebee103b660ece7f0de5857b934,1827,TRUE,2875,1048,Dire
f9726c9beecff85ee12a3592dd49ff6b,455,FALSE,2492,2037,Dire
36ffeae9ee43c349e30cc3a838a18b5e,2640,FALSE,3075,435,
e6afcfc1cd16baaef27f3cabc563c702,1510,TRUE,2671,1161,Radiant
9556349f6ab137e159bc3f5fd9a77c43,354,FALSE,1751,1397,Dire
af95b9354655fd6e811c6f5b9e5f968e,2344,TRUE,2470,126,
8bbc5a6864bfc045756ca5aa45d9adb9,2210,TRUE,3802,1592,Radiant
8b2943ab3299accbade76f719155a2ae,219,TRUE,1580,1361,
15186fd31c95c1ca85a87d8a19452915,944,TRUE,2132,1188,Dire
3f09de3e99224e4c7a8baad4845c07b0,2235,TRUE,3575,1340,Radiant
a18dbf169e130a4ad7801decce265f41,650,TRUE,1367,717,
6690e82fb8c607dd72b9d65fec803e62,1125,TRUE,1575,450,
5a6bed34edef0f5d31554177490e4ce0,525,TRUE,1918,1393,Radiant
693cf8ff9dd7aec0391c2658074790ef,1407,TRUE,2347,940,Radiant
824be1a8aff631a321c1675f3ed890e1,2227,TRUE,2939,712,
4d8bf5435339707f7509f97492d902f4,384,TRUE,3310,2926,Radiant
4e6340639bf941d9e86c9da59a2b1564,1513,TRUE,1880,367,
5269d108dfda88059b6735bf202659dc,893,TRUE,3413,2520,
70068652552536ada00f04ce71c4e2ad,664,FALSE,2574,1910,Dire
43ed827a7ce10b89f239a828a7d09734,1207,TRUE,1621,414,
3879d0c5dd5bfc0c31b45d216b18a09a,117,TRUE,1284,1167,Radiant
47f4194248406823fd1a39b84778b084,1746,FALSE,2703,957,Dire
ce8663e1189e008cdaac3b5b47c3a3d6,742,TRUE,1809,1067,Radiant
c0aa84c04cbc1eb67efc2d7ee4c8009f,847,TRUE,2007,1160,Radiant
11404145bb882ddac750f9efe68ba2f9,260,FALSE,1370,1110,
55d006c834b0156bb6f70d05cb22a33c,978,TRUE,1073,95,
7e248cf11caf6b1f18914d60b785e6ff,456,TRUE,958,502,
d7371783d259a679308f41babbb07886,241,FALSE,1422,1181,Dire
e6171f0581fe765f1ed340531b651d7e,479,FALSE,1459,980,
567fa3ee263accb01c171cd8e23422bd,320,TRUE,2802,2482,Radiant
cb6e15133efc9320491b56e7f39f3d19,1782,FALSE,2199,417,Dire
1348dfba237e075d32ba01cf69501643,804,TRUE,2426,1622,Radiant
6da2f7a236b7f292b8fb94f8b4d5a2a4,1603,TRUE,2323,720,Radiant
14f90e8ee1b0fbaf5bfa84010dc509cd,1856,TRUE,2132,276,
b5e70c56fa677341da905f9daa96f013,1769,TRUE,1821,52,
8791d79621854704ec623f755973ff4b,654,FALSE,1980,1326,Dire
571bd4f1fdd90fbe843eae33f64ffcd9,605,TRUE,1335,730,Radiant
35e3916207e90e0c6761e4a659d830ea,1118,FALSE,1342,224,
9f640835078e13756b678c1e1e456bd2,1125,TRUE,1186,61,
cfc1152573b8f52f178a20daff18b0b8,700,FALSE,1488,788,Dire
df96b32a3bd23f19189865291e7c6aea,650,TRUE,2840,2190,Dire
0ea51a2ca987a107e43c3b2d2e2df43a,2398,TRUE,2539,141,
d56adf99953993409d5fa5ac09168227,3458,FALSE,3961,503,
8d9a2eab6f32966f39d8b9dc48433b58,705,TRUE,2860,2155,Radiant
ad25eb7af7ba7496a7809a713135b408,1968,TRUE,2224,256,
6fddb60953be27a63fba31d5d607e95b,927,TRUE,1616,689,Radiant
2edb64939079fa32bbc11b03993ff20a,2684,FALSE,2763,79,
6d7eb1e7e4bb243f3f1e78ed10c8e8d1,2102,TRUE,2495,393,Radiant
a0ae17153f271c495cd2a918b633220b,1197,TRUE,2153,956,Radiant
679b8fb11d9b0468f6f2ed560e9e6d60,1005,FALSE,2304,1299,
62e0e2c4c04b5ee3f8faaa077b488b87,1776,FALSE,2755,979,Dire
804bcfd53924c171d761dcf580c462ed,1080,FALSE,1946,866,
75170954797819802208b407596a2770,978,TRUE,3021,2043,Dire
d0a7533d74084d19d2e8e2d25450a937,1482,TRUE,3148,1666,Dire
8596cb5b38f81e8c172dbfd6f0025878,1332,FALSE,2613,1281,Dire
d6c413b29ff90c6132a1f32d8300b5f7,924,FALSE,1953,1029,
01e7939e2dbdd1d1b2f3cafa276769e7,1248,TRUE,2105,857,
74820efef27169e1fb2a1dfda1a268bc,59,FALSE,1951,1892,
fe2e5fd7af76a1cae5909d1a4bd6aef9,304,FALSE,2897,2593,Dire
711d5dbe727e3d1e2be42d3007b195a5,492,TRUE,2381,1889,
1d38b62fb5e490e59ff178d6d0cf59cc,916,TRUE,1721,805,Radiant
742ad7f0400618995e0edae09ecb24cc,787,TRUE,1375,588,Radiant
64ae385361a160389b8dba318148e301,2144,FALSE,2243,99,Dire
3b6f5e751e32f5e75a0f316599d54d22,52,FALSE,1063,1011,
97f4b293e93804e9edfd7e2f4b4f0def,457,FALSE,1605,1148,Dire
923bd07ba9afcb1b01ff6c10be4bc3f4,1023,TRUE,1609,586,Radiant
65a1bea5c1019e0fd6cfecbbd7646031,584,TRUE,1591,1007,Radiant
89df1335ab9440cb1d788f81747b58e0,732,TRUE,2196,1464,Dire
a7bc95f9ee314dc2ee7d5b86fe6e722e,660,FALSE,2213,1553,Radiant
1ebcc8a55813abd833df34a38bb9bc9a,1666,TRUE,3252,1586,Dire
66379182f2a8bfc4dbf8c61218b9a3fa,2270,FALSE,3020,750,Dire
a31a9b02162bbe0999f27b263134acc6,1868,TRUE,2175,307,
643a02a68952278313ec20579e8fd0b3,178,TRUE,1515,1337,Radiant
2c6f79eb7e7115e15996e2bfb40276d0,1130,TRUE,2416,1286,
3e663589575887a6dc0b9a570a7b99e3,1882,TRUE,3504,1622,Radiant
5cca73c815dd2114a83b1356ea3a1d32,717,FALSE,1599,882,
182bf15903d9738f246076a9e90241c0,985,FALSE,1634,649,
d304eefb5f5e523df6f2fb1362475f0d,190,FALSE,3375,3185,Dire
a263cfe4b608c6edd0d12cd1e04cd331,1115,TRUE,2894,1779,
8f4ad155a1cea037d6c27f3b57fa3d54,696,TRUE,2182,1486,
50db5b1c707b59f2a6d6bdd37544ad3a,1422,TRUE,2041,619,Radiant
1828de0f202d7a001ea1533a1f7ce3fe,369,FALSE,2178,1809,Dire
f5d2e1e939e02f803d6540113edf8311,1422,TRUE,1554,132,
704b4d8e93e4ae4dd9934813ecd8998a,711,TRUE,1586,875,Radiant
d67d9962ccf8454c59240a9be024f918,389,TRUE,1856,1467,Radiant
192c2c762a0992bd108c946c54377c39,1186,FALSE,3739,2553,Radiant
99d222ebb535a4e8bdc6c8f8b98d3a20,1097,TRUE,1779,682,
c5115eac8db2949c0f8ac710829d19e9,1386,TRUE,2894,1508,Radiant
fdd75023dd06af36ce3505d450cf0143,19,FALSE,3091,3072,Dire
d7d219a656b9d9185d80ee77a05188b7,350,TRUE,1738,1388,Radiant
625f4d9f2e441564fbf6e647d540aaff,1488,FALSE,3418,1930,Dire
afeb1a8548838bacd764a343e8153f5e,51,TRUE,3031,2980,Radiant
1f35e9288b00ab3e681673559e2d6150,459,FALSE,1826,1367,Dire
475fc47cc64824b586d2fbe3eee63ac8,1877,FALSE,2509,632,Dire
10e8b85c6d97486bc1fe78ab4ab5a420,1149,TRUE,1626,477,Radiant
f12c6b371775eac636a1d7937ab53120,52,FALSE,1202,1150,Dire
ff5e2e5514985fb905216141e34abd66,866,TRUE,1164,298,
1e72eb48608fa092b58316d3709cc820,1422,TRUE,2981,1559,Dire
bedecf25f2bcfbc990da74fa6933f78f,2448,TRUE,2860,412,
0b47ed133a624fc9069706810ceb740a,58,FALSE,1759,1701,
e2e1f445d70c8113b60a31ce3746beb6,657,TRUE,2325,1668,Radiant
26266d8276e9831ce1eebaccb494c324,35,TRUE,2535,2500,Dire
fc101336013b417da47d3a99038f9a32,1003,TRUE,1924,921,Radiant
7c80380ef982800ca85457cbba844238,876,FALSE,1735,859,Dire
5c644bc942914e76dcedb00f963a39a6,331,FALSE,904,573,
0fc1fa347c665ac06e2ef521de8223ff,944,TRUE,2304,1360,
b0fa844742b92a313dec4ec3bc388f4e,1642,TRUE,2598,956,Dire
7feb6df793e46803e55c63430cbde301,334,TRUE,2453,2119,Radiant
c50ed32c6d8758d1644ad741c554094a,2098,TRUE,2138,40,
c2425ff339f0716e38661f48dea79c3e,36,FALSE,2720,2684,Dire
150ae5c807d2510bd8854e45d81c8f95,2267,TRUE,2568,301,
fe89877d1959fdbf9e3fc4104cc53358,982,FALSE,2724,1742,
588be12e099954c30343337f58a1b875,1716,FALSE,2274,558,Dire
2890f339f65d0b3f81f55e6183eb3969,1826,FALSE,2542,716,Dire
57bbf84616de2b6293096edaebcf9e95,3287,FALSE,4229,942,Dire
43b7619fac50c27446aeac5a619b544e,1759,TRUE,2394,635,Radiant
57fb08be0818b7cc4ef1399820141a0f,2202,TRUE,2390,188,
122f5e4d53c3779f5b7a57e97c1214bf,981,FALSE,1862,881,
513f8e4a7c3ef2af677f413adfc64590,623,FALSE,2158,1535,Dire
c28263cfabbc10feefd1dc34d3f8e1aa,2072,FALSE,2286,214,
9106daed5673781859413950551bc775,967,TRUE,3900,2933,Dire
5522e95634048e2ed20d3428b8d7786d,568,FALSE,999,431,
a079655f92f64076c93876a36874eff0,443,TRUE,1003,560,
4d4220e15bbcbdd7de2f41066a44f943,758,TRUE,2743,1985,Radiant
6d1dfcdcac636b1fd264ac182f7a35a7,200,TRUE,1792,1592,Radiant
a46e85fdc245c7d278553d801ce7216b,1285,FALSE,1989,704,Dire
77e395f712f26583567c199dc68d6c38,1509,FALSE,1651,142,
b596fcac18881c5af042da5154813f7c,2338,TRUE,3080,742,Radiant
2e32a251589f098c8fb117b79ac8ff9a,2466,FALSE,2523,57,
078bda9631c253904f3a3fde2823010e,1378,TRUE,2287,909,Radiant
150881304acd96c91aadd32fec481cf7,783,FALSE,2652,1869,Dire
abcf2da3617275c960a0d89f6150e8d2,1965,TRUE,2282,317,Radiant
5fc0ff759a0d63bb1a0c1740bcd6803f,112,FALSE,1561,1449,Radiant
325b8ab2051f3bdcf1fa9d7cb9371e96,1969,TRUE,3381,1412,Radiant
be26fb72bff0783936afc485f74ac475,1626,TRUE,2810,1184,
977ec166315cb677d37b40c476126904,956,FALSE,2254,1298,Dire
b400c41030f3f3cc8fbf6c2bb0f38f1f,745,FALSE,1238,493,
7780d5435b7cf866e65b151a0b4034ef,962,TRUE,1151,189,
8985ae61bd49b76d04d345f4e7e50476,2050,FALSE,2558,508,
e2c1717fc8ca8786d7de260ee7189b4e,503,TRUE,2215,1712,Radiant
5bd844e04310d3336b67e4ec45881444,1786,TRUE,1838,52,
fe7e83f661581df1facecda0cbaf2609,725,TRUE,1377,652,Radiant
0dd6daf5dbbdf54107111b2a86f53756,2232,FALSE,2370,138,
59ada828d5aa22822a616ef82cbb17c9,584,TRUE,2195,1611,Radiant
14caa07e2e690032b9c53e5b631caf2b,794,FALSE,3124,2330,Dire
d9f6215e7d3692a4da3f91326d45515d,734,TRUE,996,262,
e095f9be98e9623a452a1b50a711f18d,821,TRUE,2711,1890,
36adcf5dbf0905cecb617b8833bdd269,493,TRUE,3988,3495,Radiant
946b3a652f265c373809e236999a6498,451,TRUE,2505,2054,
50ec74c449f36a835b4239c71423cb29,923,TRUE,2004,1081,Radiant
38ba08011d9fc8187741206e03d91e21,756,FALSE,2804,2048,Dire
d1a923145902284ededb8613a4a5ce55,2318,TRUE,2406,88,
ca4e2b4662f28076298df797ff69042b,787,TRUE,1624,837,Radiant
b50efad349ec33f74b406d566d7fe8d4,1922,TRUE,2096,174,Radiant
4c1f2aedac49798306c7eb026f9cfb9c,1042,FALSE,1655,613,
23019a54ded92f0f14eca5a2176ecfdd,1668,FALSE,2564,896,Dire
cdbbe762ab907c7986dc13bee7d4e760,2846,FALSE,3924,1078,Radiant
7e0ecfe4b2102dc63e0cc0e658c7ab3a,1324,FALSE,2044,720,Dire
29cfbb11242a204d9a986d4eead657b6,2469,TRUE,3018,549,Radiant
91d010b32534ee063c5923ce593c4e99,372,TRUE,2663,2291,Dire
49c3278735bf7866a221d14af9a4d9e6,305,FALSE,3131,2826,Dire
be859170d99b76fc06c544ac757ffe3d,1463,TRUE,2470,1007,Dire
33eec8a4ce35ebad91be3ee5f1ce1393,2156,FALSE,2272,116,
428b7bb38d7c50aaecaf2f3cb5dc12fc,1354,TRUE,1951,597,Radiant
859c1fe248170554cf440e75c2e045d2,152,TRUE,3107,2955,Radiant
355be66d9862b86c9c7ec927a87d0c6f,393,FALSE,3023,2630,Dire
64c1bf373b6867e025ba3f923b115847,1025,FALSE,2595,1570,Radiant
3e36c600ba5f3653ba7718035960fbc4,572,TRUE,1375,803,Dire
9348d96893b4b603b70b59f53bf5ee81,2122,TRUE,2662,540,
c1844d8a35ab14f0fe43edb20d145f53,909,FALSE,1025,116,
63511c60828e22dc7e4c3c73949c9e93,644,FALSE,2851,2207,Dire
d0e52c09291109c7fcdf4967e5e6efa4,193,FALSE,2342,2149,Dire
bce929083af550aa8441adfc97007470,1297,FALSE,2332,1035,Dire
aaa40a96eeef523ec2e23d1c5cd2b9d1,1580,FALSE,2139,559,Dire
640c893b13e4f163c558fe18f1aa82d9,1719,TRUE,2009,290,Radiant
f0dff54cb3f35c1e8106833496dc7de3,167,FALSE,4291,4124,Radiant
c8a21ce6938da17458d289607676e17e,1542,TRUE,3679,2137,Dire
98c1a87fae55605ab0e0cd544801c75d,1039,TRUE,2074,1035,Radiant
dad7559b4ef1bf24fc6586385dc1a325,1272,FALSE,3042,1770,Radiant
4f80b39d2c27ac1de317295eea0d4dd2,649,TRUE,2449,1800,Radiant
88da6cee330afdaa6f3664a29133c8d6,683,FALSE,1063,380,Dire
e0cba546233aca0ba017d4610ca99bfa,1190,FALSE,1616,426,
3fc523125f0a730f164bdd20d606fa3b,715,FALSE,1123,408,
78811a9a33ce0fa166277fc9bc169e5c,1385,FALSE,1921,536,
dbb86c17f9aff488b10342d142a70bf8,1396,FALSE,2057,661,Dire
b5178bb1f3ca90a019a75c3fefcf25eb,1323,TRUE,2062,739,Radiant
41b4cf93ce322e5e3e002864e2b6dde7,1572,TRUE,1832,260,
2a568bc1fdbf70b89ecf42fc07f1f59a,994,FALSE,2261,1267,Dire
e326f37cce41b8dfeacf0fffaf8abb8f,142,TRUE,1707,1565,
a6d50117f9681faab4579c0544face3d,751,TRUE,3139,2388,Radiant
d697a48d98d4a345bed3d967c3562278,2030,FALSE,2184,154,
e4685b99880eddab5ed685bf26bc4014,888,FALSE,2836,1948,Dire
fccbbf77012d262feac575c83a57add7,443,TRUE,2226,1783,
4a1588f1e251a4d6b1a1cfe3784a133f,1609,TRUE,2274,665,Radiant
4177822ddceac132fd13f08f73c5aed3,1801,TRUE,2524,723,
c18c44e2c300ac9e36ee71b8dbb06ea2,180,FALSE,968,788,
f8fabbcde506cb5874cf6d229f76e912,1252,FALSE,1982,730,Dire
6cee398b120fad8f53c1ba31ae807caf,1327,FALSE,1649,322,
53faa020625c782f83cd4401d07a4be7,1069,TRUE,2392,1323,Dire
f631b1642f1a70f0ebfd6c46e5e15106,1852,FALSE,1945,93,
d669a82c93ca71d2985ce5dc89a92997,1082,FALSE,3236,2154,Dire
df4cc94d257f7ef3d56eb79f62cad60d,815,TRUE,1045,230,
dbc2c3ab002735075e2dc936e4eafa3f,4,FALSE,2146,2142,
5b95f7653e04d2ef64ea1f96bcf922e3,657,TRUE,2210,1553,
c811717153936c1f02214ae20ad2ad77,884,TRUE,2002,1118,Radiant
d0da099845d53295d4b524e7d9c9b361,2200,TRUE,3144,944,Radiant
4153990244cbb1f97d2bbbfaafb4b48d,201,FALSE,2989,2788,
ac384d12568504616537cd78592dd844,424,FALSE,2761,2337,Radiant
4c078387592d4223e889f3697dbbbbe4,424,TRUE,1049,625,
5d31b11de38271a1723fa12924efe315,2107,TRUE,3523,1416,Dire
85f84b17af38d269e7d0de340be1de12,1627,TRUE,2902,1275,Radiant
2961b797225a0b07bee24e75536799d7,593,TRUE,1278,685,
0ac6222dc8435c5278291e8d93730c96,184,TRUE,2276,2092,Radiant
146e442f0627879a185058d098e4371b,2022,TRUE,3246,1224,Dire
dffc3e194bafd1d78ca546ad8011d1d0,267,FALSE,1431,1164,
1a7198b2f2dba020988f875e3ed71144,504,TRUE,1379,875,
b56d704d64fcb95edb56d1c47e5d9e19,1459,TRUE,3042,1583,Dire
a9ab3609c3d6578562b2520f283dadab,1547,TRUE,3076,1529,Radiant
2e4ba019bdaa69ca4510d64cc515f51f,498,FALSE,1866,1368,Dire
8288058727899f984454905409bb1838,485,TRUE,2994,2509,Radiant
988f34ded17deb7b1eff9352dc3f60ca,833,TRUE,1143,310,
4461477c0fcccc44d9acf57132f6e534,797,TRUE,1324,527,
41044f981d2aa9354355c3f430b2a740,2693,TRUE,2908,215,Radiant
6091fdc8d258016125aed26d4061b3d2,1682,TRUE,2172,490,
f1ce119263320aaea6431c3743dc9c8f,575,TRUE,2207,1632,Radiant
74d489503f6d5d6451dcd0d62bf555e5,494,TRUE,1877,1383,Radiant
d9ad9eaf07b5a6a2834fd5ebde3e2654,1868,FALSE,2715,847,Radiant
2208003e3e06f9049cf8a592694cc098,1566,TRUE,2080,514,
d77ed2fe81ad2b820ce1168b7e399a1c,1107,TRUE,1503,396,Radiant
52cc79fe3d65cfba1a7044e62cbc9d13,1449,FALSE,2954,1505,Radiant
228360704330f79a2f2b2571c8af6909,355,FALSE,1282,927,
111aae820eba6dab7bb98852baea35f2,664,TRUE,1689,1025,Radiant
4fc6dbc7a1d5906e117b02e6270342ea,1676,FALSE,2746,1070,Dire
ec47d886b6a0a033c80c556eba48922a,1761,FALSE,2230,469,
94f0aa9d6dceb2fed208af8f85bad170,794,TRUE,1431,637,
81e26119ba2d93a65e4316cc1c1a48c6,437,FALSE,1336,899,
2e69e53f33ace3b9e7adf9670b753e0e,1454,TRUE,1605,151,
2ccb021ecf071a7f944fdc91dc55f6f3,2328,FALSE,2863,535,Radiant
b265be461036b4b00c19c29dd0a522b2,1189,TRUE,3005,1816,Radiant
e7372409a0e0768759090300f2b6ead8,169,TRUE,3065,2896,Dire
ef10ffd25335c4e21d03a72ba3ac0d2b,1808,TRUE,2113,305,Radiant
aa253df372e291d0d52a3938ad01500f,333,FALSE,1456,1123,Dire
3de79d1659bf7945cf752a46bda8ef77,280,TRUE,1964,1684,
43b29f382cf4691aedb2dff2122387aa,543,FALSE,2370,1827,Dire
d00ed168d0e6ac222b255c8db77f8269,453,TRUE,3948,3495,Radiant
7c79a2a484f2eba8eee2005dbf348a70,1083,TRUE,1583,500,
f3303608287ca703f1845667518af816,102,FALSE,2766,2664,
e694c3fc9541b201f78462dce0e9a543,1552,TRUE,2080,528,Radiant
7425e614fac76ca2150f17daa433d7f0,2224,FALSE,2799,575,Dire
fa9a11ce51a2f485e361f5cad4f2a80d,480,FALSE,2060,1580,Dire
889c15c6112fa2c6514b890e7944df1b,239,FALSE,1856,1617,Dire
3ee3bf69f07400474d56ed7db1600ccb,1682,TRUE,2051,369,
412d14890db654500296e517ba6cebcf,151,FALSE,1423,1272,Dire
091b3eb04050f9873087f48b167bcdc3,499,FALSE,2934,2435,Dire
efdd7e41dd0a6feb9ff8c428c4490f97,565,TRUE,2514,1949,Radiant
2f8e2c87a3059fd0df0f7750cda6304f,130,TRUE,2563,2433,Radiant
852d108e7b6e1f2e3a9d20de6f632449,611,TRUE,3390,2779,Radiant
ef7053a2a4487eff5499bf389112e7d3,462,FALSE,3392,2930,
82a05b532f614e7f145360261af97c98,570,FALSE,2520,1950,Radiant
7c48e1cd1c5d3e2e7bb24c5b7ee99c51,547,TRUE,1136,589,
3aff8896aaa0d5a06192bc057a0b1830,431,TRUE,2046,1615,Dire
dfcc8b4fb146d5eac429114397984393,1440,TRUE,2716,1276,Radiant
12865513853cd807d2a399b66d692584,871,TRUE,1753,882,Radiant
eb831bfa06c7271d04d4952c517378fd,1167,TRUE,2269,1102,Radiant
e9b7d7da7d9ebdbe2ed6773a03933a0d,1059,TRUE,2797,1738,Dire
751cdf16eb349525150878d31bdca9a8,818,TRUE,2274,1456,Radiant
530d94c4ae10de3d0731d497c8d57ad7,712,TRUE,1711,999,Dire
a99e1d1a26e4e7344ba14cdb203fa9ff,933,FALSE,2319,1386,Radiant
0dcd53afae1754d3dccc1125ddfba4ef,870,FALSE,2558,1688,Dire
ff4fa740e8af7da3262a7c46479cd502,1849,TRUE,1982,133,
443df6f304d56ee466242e7cd9f4c1fd,1352,FALSE,3004,1652,Dire
ff5156d1918a29591668e8be07fd67ac,1595,TRUE,2438,843,
19a731d220d7ff5e69e943db84847a6e,280,FALSE,2750,2470,Dire
5fff1b8bf067e56eff1f0ac459826a96,824,TRUE,3050,2226,Radiant
5d57d37528baec7ac5db71411e386fab,1245,FALSE,1742,497,Dire
663e84eb6ef08da84f68c736042e7f89,1699,TRUE,3076,1377,Radiant
f76d6fc32fc0542f10719f35b0dc3864,437,FALSE,2465,2028,Dire
4719efd673882c23a9d47d086d08e884,2167,FALSE,4326,2159,Radiant
9c3e11d1092b1d7fa780e027fe1ad073,502,FALSE,2326,1824,Dire
a05f1a6e087ae3b25c229f3a60857cb3,3773,TRUE,3995,222,
30778825fc31ceff5edae448ccf149fa,758,TRUE,2170,1412,Radiant
eb3f7c67dbf7637ad108f6907ea4498d,2833,FALSE,2942,109,
937e90aef63371d7c52b76909a835954,2854,FALSE,2920,66,
3214a787c8033ad3c481a4074e0766cb,582,FALSE,2104,1522,Dire
b1edc7ed6d7dfee514d9df2d9ac0f5e7,584,FALSE,2957,2373,Radiant
e597e9d6abc78d369bf7e66e824c7abb,338,TRUE,1667,1329,Radiant
8beb66dd1c42ad20c1242883686de975,977,FALSE,2121,1144,
44dd55c8b94178a64141b9d69d16b924,363,TRUE,2532,2169,
84801dfea5e7d1a2bdf0cda8bb715e01,858,TRUE,2800,1942,Dire
527885f5838de1bca01d81da38e7f830,401,TRUE,1178,777,Radiant
79f4e65be26b1c14617c8de51229bb99,2690,TRUE,3279,589,Radiant
e2e87c80fed13407588daaf6516052ab,975,FALSE,1992,1017,Dire
8c5d2d565cdc7779f579f7284b644509,1768,TRUE,1996,228,
a666767e689ac87160c964f2d9c816bb,3459,TRUE,3521,62,
5fdb2c8193dd1781917b9cc0ffdb2443,203,TRUE,1501,1298,Radiant
9906ab41271d3127715c2db5986a4fbb,724,FALSE,1521,797,Radiant
4f526090993ed36e94ee74f7e4abf4dc,900,TRUE,2876,1976,Radiant
6743cd8c4ebc6716f935c9b0fc7e49e8,1418,FALSE,2609,1191,Dire
39440ad22e94b06e38ddc39b9a22d549,2074,TRUE,2663,589,
06dd7e58b2e9d2693e1e91d16801c2a3,2413,TRUE,2779,366,Radiant
f2febe99d41dd0da597a1b42c7de03bc,976,TRUE,2650,1674,Dire
4723a0b24ddcc7de7e202f1b505278bd,177,TRUE,2667,2490,Radiant
cd5a591dfb23693a870e420cd5bfff2c,794,TRUE,1755,961,Radiant
456cc61b275790a8b56cd2d9d3924147,1610,TRUE,1807,197,
f16dd3353d4e8237fd1e9f5d56595bea,2136,FALSE,2495,359,
b7c9d0df31a6e4e232dce53d448f2e4b,3032,TRUE,3193,161,
5d620e830ee2602490ff2f04ffb6314d,259,FALSE,1953,1694,Dire
2c6042ef571958390e2331658ae8e15c,2632,FALSE,3078,446,
a45ae232f74dade34aa64ca715f31802,942,FALSE,2496,1554,Dire
733154e86ab57c35c4514980502ec1f9,953,FALSE,2087,1134,
9fe113063baf98d6a66a124d287ddcf1,969,FALSE,1581,612,
a374ed43ed6ac6d79c41a58ced918791,175,TRUE,2303,2128,Dire
9673e08ce694d12dea130009f1fddde5,1547,FALSE,2239,692,Dire
af0ed073dc8d1786eaaaabf00356b95e,976,TRUE,2296,1320,Radiant
026b034660d1bc1ceddda4b5b5c2e7ad,87,TRUE,2050,1963,
a911a05aeabb953fe90e171c34c3410f,656,FALSE,2854,2198,Radiant
4f622d36eddf4b9f5cc734eda9efc44d,18,TRUE,1317,1299,Radiant
63775f2edd394f3a7cfe69f0e0aaa57a,668,FALSE,2428,1760,Radiant
d5133dbbf632fc49158e5046bea42cce,2207,TRUE,2895,688,
702cf88052f2f4200860da63f46b14f1,3,TRUE,1920,1917,Radiant
caa757d324b137249268ad585e8645b7,2251,FALSE,3247,996,Radiant
3ec1244222234d9012971837b0c496c3,453,TRUE,3250,2797,Radiant
1d64c3001052710dc8edfe7a64fe2848,356,FALSE,2591,2235,Radiant
e5af94360a2b8c61017c704503ebb552,2420,FALSE,3095,675,Radiant
a4667d8ff5a7842ba476fd39be897599,483,FALSE,1557,1074,Dire
86b33570aa73795ed59c2aac748807a3,937,TRUE,1592,655,
08a85879500ff3225a5a424b2af75d0a,2633,TRUE,2917,284,
9b8a660d455b770e3e554e7fb67e1e28,234,TRUE,1285,1051,
813fd737d850280c7e3b8a72bca263eb,973,FALSE,1334,361,
2b04f3569f834f2ae5ba789b7fb7797a,1548,TRUE,2300,752,Radiant
4f51ad15e7eb95014ee2292aae2fdfd6,1447,TRUE,2397,950,Radiant
b2a5af6fd440ceae48b754b878a41858,1118,FALSE,2643,1525,
86ecbc565fd77ca7e6c294afbd5cadc8,1327,TRUE,2131,804,Radiant
99ebcc766ccce6372e56d3cfac6e1531,1509,FALSE,2471,962,Dire
3ff922dbab483ed25874cb3f6159d06c,2200,TRUE,2731,531,Radiant
645140a1cf3a0ef2e09996ffc603d2d4,2539,TRUE,3588,1049,Radiant
a77c4d910a771bd41fade30752be8237,1619,TRUE,1871,252,
4ff42006cf8d7512d63d4b100645ecec,903,FALSE,2890,1987,Radiant
020ae81b8d828e38a7c4eb6f9b5892be,2067,FALSE,3092,1025,Dire
ca61ade80c3b4eacf177a15787ec29a9,2477,FALSE,2617,140,Dire
1b8402901f2637ae31ffe1e62a8a2038,948,FALSE,2332,1384,Dire
15730e3a39b147d5955517a27b9ed597,924,TRUE,1555,631,
c8ed372218d4a5be0250b0b63030b518,415,FALSE,3106,2691,Dire
353252ca7a7306dc26f9496d7f29d0cb,1419,TRUE,1910,491,
316286cf42523387c42aa5d172a3a942,664,TRUE,2464,1800,Radiant
a734c73af92f510503d43217e3056350,2722,TRUE,4056,1334,Dire
1a2ccc3b91009987be1ae8089d519326,951,FALSE,2096,1145,Dire
2c10591ef4a61801a1fa1ac3dba2432c,3088,TRUE,3219,131,
fb4096975819b521476f98a01c946830,304,TRUE,1183,879,Radiant
8a932411fcf0ceb2b0ddffd2bab08f67,142,FALSE,2548,2406,Dire
abe815d6ccd9b3c0175e5c4a7f89126f,1051,TRUE,2298,1247,Radiant
69d34f5486d648e4b96c62491bfb4e5f,1180,FALSE,2728,1548,Dire
31dc197bac936c06a5a3970a1d41fdcb,2378,TRUE,2769,391,Radiant
98e1f3ef966e5eb7ae03b904dc827c9f,3052,FALSE,3454,402,
eea91aba56afdf180ed5c666faae08d6,2050,FALSE,2239,189,Dire
c4e9e90c309e0d08034b7db6155e4769,1201,FALSE,1544,343,
a6ae0dea224ff94cbbb8a7b294572c08,2835,TRUE,3520,685,Dire
f8027bd4eed98d16862d668079761d60,907,FALSE,1427,520,Dire
635678d04f623f1a284db664ecdf163b,695,FALSE,3133,2438,Radiant
e8a3eee3806669021901b29032fe15ce,2444,FALSE,2701,257,
6c39bb7cc702f990200c84bd7b60f5ea,1158,FALSE,2966,1808,Dire
3669634cc8b182b141d8d9fae09d3b7e,621,FALSE,2054,1433,Dire
3b7d0c6383ebdb4048257c289b1ef4e1,966,TRUE,2003,1037,Radiant
1328e1ac91f175cd522f68f13830934d,1109,FALSE,1330,221,
4d131836015e57fdd1a434ee8af868d7,697,TRUE,2564,1867,Radiant
6e9294169cce962ed8812fd7af61ded1,697,FALSE,2008,1311,Dire
94066021e3d0507d173efd18b45ccc47,893,FALSE,1894,1001,Dire
d007c37ffa730bca9f184161a7146bf1,541,FALSE,1559,1018,Radiant
c586633b77235d167402f9aa3c441d42,3336,FALSE,3786,450,
13bcc703a68c6792488ba206fe3b54f0,939,TRUE,1419,480,
44f23cfb78961aef70a0ca30bf99bd4b,371,TRUE,2629,2258,Radiant
1fd0f7d873bedf16e1289da3cbabf645,707,FALSE,2389,1682,Dire
41f082233383e4cacdc9b45520ad2a78,46,FALSE,1336,1290,Dire
734f645462893d04eb6724eadc04b3ef,1044,TRUE,2468,1424,Radiant
01fe14ca63e2afc3ecbae23805bc353e,726,TRUE,2045,1319,
ee13bef7634fd4742c8bfdb0ec49ae0e,622,FALSE,2684,2062,Dire
4bbbccc8f7c36c0d7b93c3a775c327ab,1469,FALSE,1572,103,
f30d20a4caeb8b615821e1e50f7b0765,1422,TRUE,1737,315,Radiant
dbdfb6db532e2578408a84a06c0a3e81,28,TRUE,2666,2638,Dire
21ed39645ce869724d09301e14ccc603,16,TRUE,1271,1255,
709ffc61f216d3de4a516be49322c7a2,574,TRUE,2002,1428,
607b6785ebd831751f71b984399366f5,1407,TRUE,1530,123,
5692db04064551dad221248bd7516845,2115,FALSE,2705,590,Dire
586900c8709f61b07b8a7698ac7319a4,655,TRUE,3132,2477,Radiant
7b06fe3080a62edc733ad1e0a3719ecb,2620,FALSE,3128,508,Radiant
ea880cc6ba6fb49cb937a5571a1aec82,659,TRUE,1388,729,
fe594630554d388fd633ea479f288da4,1418,FALSE,1511,93,
5c74256c6f5980c074bb21175b42d91d,942,TRUE,1389,447,
d7bca77d434907ebff0a868fa13cd4c1,261,FALSE,2146,1885,
655061211a303c5ff1d05184f8e308f3,240,FALSE,1287,1047,
1ed212b4b044688dea6cbe0efd7e2654,29,FALSE,2996,2967,Dire
fc9e18470f0ba9aedb0d875ed9ffdb5e,511,TRUE,1216,705,
0b3c280dfe2fcae3ada3183006cb3985,1707,FALSE,2058,351,
e73a651a57a51e1e88f3a08da15ba393,247,TRUE,930,683,
d1354175b08a58c9f9abc6ef0b862cba,850,TRUE,1206,356,Radiant
6213c331a18cbb97ae6e01926aa1ade5,2200,TRUE,2471,271,
df47a7c4502e936378cc9e7755d87d67,1532,TRUE,2268,736,Radiant
61b4ccf52a0d200dfbbb85ae6d986c6c,3083,TRUE,3435,352,
d024b9ba3e35b24352ba12f905b6a1ef,1790,TRUE,2652,862,
d328f70facd583f895cc8cc58f944964,1712,TRUE,1995,283,
4fee7d7614a6bd95a2bcc20ffe055316,591,TRUE,2613,2022,Radiant
db2f2d2ce80e502a13ab3b0d569970b7,2123,FALSE,2173,50,
4a02f97475873ede01346be9a1733262,3098,FALSE,3230,132,
c9a1b37227b332f0cf2d980972c4ce99,584,FALSE,1942,1358,Radiant
61048f4d4c9f90ff6f5d3811acaeb827,3007,TRUE,3415,408,Radiant
5e55da483dbed943344387668719d3d6,419,TRUE,2362,1943,
aea4ac09c7d407d76a9a2de74cc428dc,36,FALSE,2602,2566,Radiant
ad1de372530b8a871080024f4ef5d462,1500,FALSE,2764,1264,Dire
3cb18435f03faab19f9d14d15a764950,2175,FALSE,2282,107,
08294fb69a4f6d9142809c47717f5681,1782,TRUE,1950,168,
580da58a4037d4bf0fa203538ca9e6f6,3150,FALSE,3483,333,Dire
f4497d3c15464eb49a3de8febf8412fe,1136,TRUE,1808,672,Radiant
e5d85d7836675284821e443f1ba3cc93,196,TRUE,1557,1361,
26ff4ff91808c5e277b7fed0effbddbe,1203,TRUE,2488,1285,Radiant
8fe94ab2408e0b17dac1641169bcb4ee,1274,FALSE,2553,1279,Dire
1d70e5058a573e8ef58102da9bbcdc6f,657,TRUE,2735,2078,Dire
556063b95031d9df50ce52c05353a40f,960,FALSE,2089,1129,Dire
b8d7419910c602800a88ccc4b30ddbe8,1099,FALSE,1397,298,Dire
9e63329294fa57250c8f62ff8a93f0d0,935,FALSE,2661,1726,Radiant
f5bea60250e7a392a0772359e413abb5,2132,TRUE,3134,1002,Radiant
784ac4626686d7a44603b154dd918697,1188,TRUE,2561,1373,
fbed97cfd8063fd821d395c2b905ea22,1712,TRUE,2167,455,
f0aabe36c09c987073f3cc77e53b1163,639,FALSE,2265,1626,Radiant
bea8addeb3df2b3db70bfaf82572d316,366,FALSE,2199,1833,
37d2404fca972213e49fb211c89cd969,686,TRUE,2489,1803,
ba412c877443291994d89a67e83fb252,1958,TRUE,2879,921,Dire
bea87f41ba616a5fd307e4b0e7325def,1033,FALSE,2009,976,Dire
f83fd136f24d87d19b01f913ba35c48b,64,TRUE,1281,1217,Dire
e135adb4be7732d26f0389dd470f327a,1496,TRUE,2766,1270,Radiant
576b1f602dd8facd458959fc1113eef6,1662,TRUE,2536,874,Radiant
d3b1c8ef8054a153432fe2a84e1e54ca,1190,FALSE,2259,1069,Dire
dfa74cebb27a62a0846453b0ff528e60,1496,TRUE,1959,463,
0a7b3840834de3fb4f1c95592476196f,968,TRUE,1467,499,
89626588b3d46b473c3c0b455280cf1b,1265,TRUE,1356,91,
33daedaa4a09cdd9b9ad1d4e229f64fb,1025,TRUE,1797,772,Radiant
4fb79f6c7fd259b9d28867aae5b3dba1,208,FALSE,2921,2713,Dire
a5ef1c1b5a2e25143ff2bbcd97d3082a,1567,FALSE,2154,587,
719b20f5ee0261de694c88cf609bda27,215,FALSE,1271,1056,Dire
b13f68c9f8134b032a770606c4751878,610,FALSE,1877,1267,
d17aacdad3eea079ecd1e292230decd9,766,FALSE,3667,2901,Radiant
772f663ff31e146d4c451d4b4edd8dcc,518,FALSE,1991,1473,Dire
536c4eb6ed5fe9a8db82bb38a9f89baf,1696,TRUE,2004,308,
8d5ab828c14bb3f415bbe5f50aa8d484,2338,TRUE,3164,826,Dire
499eb12c442bdb574aa881eb7d9301af,1906,TRUE,2423,517,Radiant
2043fe1b7e7bf301d3b8b67bcea3c4e0,268,TRUE,1002,734,Radiant
0fa9aa79d6e304459b8a4b03ee8e3d84,3354,FALSE,4113,759,
a45df208e5805ee32344d47c87f90403,636,FALSE,2758,2122,Dire
97dfdee45558e8d6935b9aabb6a40367,2776,FALSE,3035,259,
099c07b6e6ab6dbcefb15e6fd286298a,2442,FALSE,2869,427,
665e2b514aa6d12bd974699226e5dc9f,722,FALSE,1463,741,
de0cc36f39773353ebf4af81088f064b,2123,TRUE,2362,239,
fcc1a5ac7532c558224f29d5b710ee42,188,TRUE,1300,1112,
e58d08c1ab960b132de86883e7c157bb,1235,FALSE,2762,1527,Dire
ef8d4278cccc960a48ba8726b2a8f007,416,TRUE,1821,1405,
e4503722628b2941325c575e9763e668,132,FALSE,2104,1972,
257bec75300503247b46ecd14a45bcf0,2291,FALSE,2354,63,
b887cc4a8b1ecf0d0cd378358f589d73,1329,TRUE,3306,1977,Dire
ff551c213113960f86d78416de7e10e7,3,TRUE,2115,2112,
558cffd98e6183e7308b84e70ae8df0e,265,TRUE,1291,1026,Radiant
3dd3dec77529620ab400ae8aa9a67a7e,511,TRUE,2653,2142,Radiant
f596d3afb3bed65b167adabafaa24dc6,3476,FALSE,4123,647,Dire
c8df8f1f0e194703425ced26bbd14575,1814,FALSE,3891,2077,Radiant
8a6521ea3b1564f8761c7dbffd6664ed,2461,TRUE,2553,92,
1fe18bcaec22915e8aad583bbf029313,1123,TRUE,3005,1882,Dire
da8e5245f86de20d653fe2b35d9451e6,2416,TRUE,2769,353,
414f329ee4aa6c23231a0d48351e79b9,416,TRUE,2259,1843,Radiant
3a30aee337b30c6a0a0cc0b9370128c9,38,TRUE,1626,1588,Radiant
2a425bd97ecd7ebed2596482e6e579bd,1765,TRUE,2055,290,Radiant
e15746eed48de67cfb5d0c62025eb764,113,TRUE,1063,950,
1bb6bb5aa96af8a3d72b9cf19f64c7c6,1002,TRUE,1131,129,
0999747ffa7c3207972492d0eba32f41,1274,TRUE,2118,844,Radiant
e5b7217bdba37ae79e6593f952f91924,584,TRUE,1450,866,
ca18de9ea0ca3db2944aa234f98bf4a5,1217,TRUE,2825,1608,Radiant
ca495585b6ca2bc3fb2cceffdb94a8b5,654,TRUE,2196,1542,Radiant
cc0f34ad6deba9edcebef03416c3b3e0,102,FALSE,2332,2230,Dire
c9ffaeaf6720c297f92fc83b20bf6916,848,FALSE,1861,1013,Dire
7528b3ec718b0c993e469dd432dfe760,1936,TRUE,2955,1019,Radiant
2d5e5be27d96aa5906c2532f454e4415,901,TRUE,1595,694,
caedbc5605595e12f2d04e203652334a,649,FALSE,2077,1428,Radiant
d02b9a98532fb08e5ed3ddf4ac124c72,1390,TRUE,1577,187,
8e126576072ef66933c33b2d4a054ae7,206,TRUE,2600,2394,Radiant
89332b061fd63e3b5ac53f2bd6785520,908,TRUE,1497,589,Radiant
68c3f4d9b96f59e18296dba4936c508f,2534,FALSE,3633,1099,Radiant
f6da7bbe8fb5b63ed38a8fcb0dd6e606,2202,FALSE,2580,378,Dire
6e0f1fa1472a3399c52fccb094c47e3e,1201,TRUE,3267,2066,Dire
71abb54109da4b34cf209df1ccb1c728,1513,TRUE,2424,911,
aa965a2b405e24d71abce1ee1b2449e1,2367,TRUE,2766,399,
78c7d520516bfc4a55aed1cb7b257b3c,1638,FALSE,2789,1151,Dire
461fc4047736020ba2def9f97ef0dc23,780,FALSE,2086,1306,Dire
14cfa960f45f7926889fa0bc01fd330b,1749,TRUE,3263,1514,Dire
ca464dece86628ab7d7196d19cf9ac65,1412,TRUE,3200,1788,Dire
4286ea559b198e3d6d81ba764b65e2f1,744,TRUE,2126,1382,Radiant
2253952f28eec37a4489c73ea4ffca47,180,FALSE,1822,1642,Dire
6f7c968e0829842b67d212e5831da148,420,TRUE,3571,3151,Radiant
b291674120625fc42a3161a961d2b801,75,TRUE,2683,2608,Radiant
8f3a0a0baa376e9aebe4d9a68f48fe54,1976,FALSE,3112,1136,Radiant
fe30cfc5d2fcb0c461882a8d4314fcb2,365,FALSE,2693,2328,Dire
afd906f72f3c3bf9e076daaabaf0d38d,763,FALSE,2354,1591,Dire
de9d42ceb79cd99a138927636a14873d,664,FALSE,1041,377,
cd19547717ed499e9923a01eb91f4b58,280,FALSE,2510,2230,Dire
03eb9913a5ddf2cd9e9f17354f10035c,1391,FALSE,2326,935,
daf206f2edd26a63a89b5e30b2c8fe15,1628,FALSE,2584,956,Dire
15157aa5901e2ab51fe9299a63161005,27,TRUE,1303,1276,Radiant
072721bf1a8242bb6f8c8ced21ad6ef7,1857,FALSE,2281,424,
4719e62d53a3160778ac220057729359,660,FALSE,1322,662,Dire
eaca6cbc0e90392f46ca4502a8b7e827,530,TRUE,1477,947,Radiant
d0d39af5941688f00b95d2a16647bd93,1683,TRUE,2001,318,
095cf198008fd976a17488f846ab6cc6,1135,TRUE,1516,381,Radiant
3cf81f1351ab18ecbf95e0a8ea650ee6,2519,TRUE,2622,103,
7e71b05f2d44022197c6f370f9213fca,1237,FALSE,2999,1762,Dire
5febbdd6893811b976407d45292dd272,1466,FALSE,2405,939,Dire
2641fd8006e99231f41b9accd783f9ec,755,TRUE,2858,2103,Radiant
10dd5d2c1f5797352357c644290501d7,148,TRUE,2188,2040,Radiant
0facc4bfe866042ea29bc122821ee13e,1511,FALSE,2146,635,
c4a824867355ec777fb93ae6002bac4e,433,TRUE,3260,2827,Dire
bc0676ee78fe800b0044ed15ebcaafe2,2387,TRUE,2886,499,Radiant
a35bc11c49c0f40a3f8ad7cb885a9d8d,1184,TRUE,1790,606,Radiant
c5e8e4d551288b5f61c2f439664e2cb5,1732,FALSE,1970,238,
342569fca4f4bdd29d693848354e85b4,666,TRUE,1299,633,
becac755768ecce8f22b710f8cbdde9d,71,FALSE,1646,1575,Dire
6c24e77e7fbd967d751cbbb20854070f,1695,FALSE,2864,1169,Dire
4c96e6a6cbdaf78156777afd3e71ea82,1261,FALSE,2017,756,
1d632685f3600a4052fcc42ebcc7a72e,1553,TRUE,2783,1230,Radiant
229f127e1c5beede96c0c6280762739b,595,FALSE,1851,1256,
9ea32a28decc6551904fe7919b7badca,916,TRUE,2666,1750,Dire
e79a9e96e49c243aa71a39119efcf93f,1459,FALSE,1869,410,
9f938e41646798d1c0652a52deddfa39,1614,TRUE,1656,42,
b5d3ba31b957b3f33bde56d7840a2add,1128,FALSE,1442,314,
625eaf5e194309eb9401c891ac5fe305,2445,FALSE,3077,632,Radiant
0b9e775c262414f0a4a719e120ee2a8d,3126,TRUE,3730,604,
8a7dd5baedf751c28031e50c59057986,2232,FALSE,2986,754,Dire
0987e1345861f20b420b82fe35d55661,1228,TRUE,2311,1083,
851dabde7211c76b4903b86ed2484e10,3168,FALSE,3318,150,
4815a0c7de16e4471cf8ba1725fb5fce,1658,FALSE,2131,473,Dire
02a8216e41901567d620e0c74bd5ac41,213,TRUE,2157,1944,Radiant
fdfbbda94347549954288d828979039f,2414,FALSE,2823,409,Dire
65fc0b0c482f71d6f47364bc7c0750b7,1193,FALSE,2975,1782,Radiant
ffd22b402f6ac73beb4baf768575732e,1160,TRUE,2852,1692,Dire
8c5aea5b60af5200ea2eaeb101f8c978,910,FALSE,1981,1071,Radiant
660efbcb7966eda1d54f9a2438114633,819,TRUE,2150,1331,Radiant
9e6fc107f44799d8d3346f9c71dccc22,941,FALSE,2164,1223,
2b396563600196032bef7161543d3594,1934,FALSE,2246,312,
f4e5914094a27136cd07998b5b0dbc66,2238,FALSE,2386,148,
6f3fa918c1a39638c57c733939083b30,2175,FALSE,2697,522,Dire
f73f51e8dbd9c49536ea625ad059be4a,1387,FALSE,1604,217,
bbb3999591d6b3a6de259796f254377e,1466,FALSE,3257,1791,Dire
99bd0ecb90655feb010f1265965ac911,956,TRUE,1717,761,Radiant
b896e8127ee55faca76958ec4dc2da99,44,TRUE,1474,1430,Radiant
1b074cf4756c7105e2264dc1d0861f93,1455,TRUE,1668,213,
01548e5f2974d4f5ebc6573c5a68158e,1389,TRUE,1935,546,
ab209485afaccc52b6deba2a55f9b652,1872,FALSE,2153,281,
f5a58b316515d4c6ff6f9f1f58271d18,1740,FALSE,2175,435,Dire
9d8c6dbdfc520340b051be403a623278,611,FALSE,2140,1529,Radiant
c6fe74824006f23d44f0006a263babf5,1960,TRUE,2026,66,
9db1b32bf555d364d0dcd8ca4a2026ab,1626,TRUE,1713,87,
e4d408fce65a17ce077e84728e56e045,797,FALSE,2841,2044,Dire
17e9aa380c4da1cecdd2240c590ed55f,1194,TRUE,2220,1026,Radiant
4cadab5e66a60f7ad143cb303bfbe845,856,FALSE,2569,1713,Dire
0a33b34da7bd948aeef00d11240d91d4,497,FALSE,2913,2416,Dire
995ba93d55f5520d6c0314a4b9158b67,677,TRUE,1927,1250,
b49fdc8eefd76647a956129f971bcc43,2213,TRUE,3770,1557,Radiant
9b1a4d636b6dbe8c7ec5826d5e99f136,1432,FALSE,2588,1156,
aa2d9cfdcf0caf6aaee5214350b59077,664,TRUE,1471,807,Radiant
948ca34c4e27d7edd32fd6b504a10938,41,TRUE,2796,2755,Dire
c3a71aee37f8f2b735ceab57bea72379,1333,TRUE,1504,171,
be67576fddbb4693181df8191b147766,349,TRUE,2424,2075,Radiant
3da4285e55041c414d214242f9e42b64,295,TRUE,1859,1564,Radiant
1fddc09e41b27c7cbc21a329d3129faf,285,TRUE,1638,1353,
d845720cce9c14c8447e6df48c297c4e,1157,TRUE,1917,760,
9b19f5f4b48babf3015a11e73337b1fa,1496,FALSE,2777,1281,Radiant
a617e48a43ac9c1322f3088ab034ce89,2190,FALSE,2417,227,Dire
fafe39eb00f46f40810481d3d0c7727e,1420,FALSE,1866,446,Dire
b5900b424d72cd8f6605d5df2e9f9432,246,FALSE,1966,1720,Dire
a0b33d630add48a7e76818882a2b682b,304,FALSE,1860,1556,Dire
a55757525460287ec09da1c08af4135e,1548,FALSE,3017,1469,
254f1d259f50eea8e7634c9e7f3f370d,932,FALSE,969,37,
a838eb2910a8e383dfd38976921f16a6,388,FALSE,1112,724,
c12c6b552a61440a1438106e8254e1ef,944,FALSE,2374,1430,Radiant
60c3213e1c59043d39c89444a15065b3,1345,FALSE,3424,2079,Dire
55b2567173d49dfef039d76427ea6ffc,1611,TRUE,1728,117,
95587e53ea032f53c4b430da9fb37521,47,TRUE,1793,1746,
0daea9b1980828f8e606f7ccf748e1f7,1780,FALSE,2314,534,Dire
5e0c863d19f681046982cc606c62f054,1923,FALSE,2182,259,
986ddfeedf95c6cfbe8cfce3183f0d68,5,FALSE,2382,2377,Dire
f71b99ccc13bbcdae9ddd207c5e40a5d,388,FALSE,1381,993,
cbe47f32dcdf4b3ee4c39f2a6de2dd3f,945,FALSE,2403,1458,
b06d4abdc64b6d85a94aaeaece707966,1286,TRUE,2113,827,Radiant
41d552f22ecd64b76da2e34db317f972,2086,TRUE,2213,127,
dfa62d6172ba8a2c5c3c699136984fb8,2200,FALSE,2386,186,
d89986ce86506cefd3c3d52ed182b4a1,2116,TRUE,2664,548,
e82a25d797d013e6a2d9cdd6e9f2a0a5,153,TRUE,1258,1105,Dire
f82b86110a0886550bd4198c7cd78cb9,942,FALSE,2083,1141,Dire
49b848d488b948412faee8ddf3f98d6c,489,FALSE,1342,853,
570d5494c122f2e7a0078a515811068e,2217,FALSE,2786,569,Radiant
2426225006afbc9b5c4dc7ca4df92c54,2675,FALSE,2928,253,Dire
14e716018cd46e64df0d922f6228699e,1377,FALSE,2405,1028,Dire
77429c2906e4076a7b4ce0aa3bc67fa2,1367,TRUE,3250,1883,Radiant
dce229af8a9d65c435fcc6afdbdc96e9,2289,TRUE,2666,377,Radiant
5d80e8473d81ec694bb0d770915d375d,688,TRUE,2208,1520,Dire
841bb5bb170b50209235ed87387ad384,1891,TRUE,2266,375,Radiant
059fe883f77e72f049e2c8a9fb0d296c,1077,TRUE,1448,371,
df9c664c78d708daf29986b220c06cbf,400,FALSE,1498,1098,
0111b0e376d8f8915c96ce2090ddb4d0,1311,FALSE,1964,653,
0479809b27037fb2b754e8b7a43e6a45,2635,TRUE,3120,485,
8ae5d8a94818b72f4e3957150c1f1813,1297,FALSE,2574,1277,Radiant
1f41ce5bd0674bb1ad5563fcf5868942,2997,FALSE,3715,718,Radiant
6864045263a322efdf27ea985f8da592,121,FALSE,2814,2693,
d28845f061c4ae0de15cc5f69df65f68,1173,FALSE,2489,1316,Dire
81006046b40c1fa47ab48f293fb34466,1071,TRUE,2075,1004,Radiant
dc909461da3dae1621b2e4da13399f0d,2342,FALSE,2416,74,
b8b0ef288baf21fe29a50ac3f2761553,2504,TRUE,2880,376,Radiant
fe5c7ed898ba311f2481b3fe1b5f9a3e,2154,FALSE,3627,1473,Radiant
da6757d4fbb4835c7de34e465382ef62,1278,TRUE,2106,828,Radiant
6d6943079f4c3a2b30c080d9d052285b,441,FALSE,2532,2091,Dire
c8015bb022a89064cecc7d0468091455,506,FALSE,1389,883,
7fae6f7db216fdfbeaee3823f74c90a5,997,TRUE,1823,826,Radiant
cf0cef467f227e823342c8acb60c616c,1570,FALSE,2209,639,
12675599fa937b69c57703d749fe27c6,2364,FALSE,2507,143,
ade8341f623981d4a64bf109691cf246,198,FALSE,977,779,
06c54c2f532259a53db206b07eb990ca,1615,TRUE,1784,169,
61b03cd4a221d68104255bcb5801619a,41,TRUE,2068,2027,Radiant
178e624a5430297049ffd7991d1f8380,1680,TRUE,2966,1286,Dire
d9b4dbefc01cf0f34b643fb7ba26f49f,2617,FALSE,2824,207,
c541ca510ba4e2bacb93982115475b15,918,FALSE,3088,2170,Radiant
72c06b765014245e5560625c0e5be2e1,620,TRUE,2412,1792,Radiant
9befd9230ec68c6466db8d5a588a00f3,1464,TRUE,2116,652,
67b8256541da7c772b996c7965af858f,606,FALSE,1233,627,
f90d73b7a278092eae6ffc8156bf9adc,1463,TRUE,2455,992,Radiant
a06a9b7a2e32f6d667283b2bd0d013f7,132,FALSE,1942,1810,
d25a6cae5d663c2cc21228cca8e0858a,2444,TRUE,2514,70,
4b036d77647f4ca190815d6e1dd96582,302,TRUE,1609,1307,
60a673e2a1e4804b68a91988c2893627,458,FALSE,2266,1808,Dire
8a1c00af072594f699ddaae66d5d29cd,858,TRUE,2156,1298,Radiant
fcbf8d54e02291f508e45e6311f89cf7,577,FALSE,2636,2059,Dire
3dd2e3348535f86d9ac0c653c14ba652,523,TRUE,2177,1654,Radiant
37352262d34c4bad1b5223dc12bd92f3,48,TRUE,1393,1345,Radiant
6cd0df688612795aae790f03de34e66f,2451,TRUE,2791,340,
1816caa5c81660192bcaacdbf1659249,1658,TRUE,1884,226,
0a664c9496cb372e7ddc81dc9c687b3e,1497,TRUE,2300,803,Radiant
9a0d9a4961f9ca4002b2581994fa9ed8,2401,FALSE,2909,508,Dire
1136a80116a6b3759c4bab6aaca78acf,1201,TRUE,2227,1026,Radiant
4a3c65785b3de70e83c04d08c2304213,501,FALSE,3080,2579,Radiant
8bec65b11dd2897102ca1fdedb3b240c,1505,TRUE,2208,703,Radiant
fb6a86dfac778054133a84aa8e92515d,727,TRUE,2599,1872,Radiant
10a9f755fe3d734365a7e98cba653cab,821,TRUE,2970,2149,Radiant
b3d92e299fe08b3a31fff010d0e18188,770,FALSE,2662,1892,Dire
059917c34d8df6eb761a4815db9a4a22,476,FALSE,2004,1528,Dire
9972132e9c1a622f2d274b30861497d5,1717,FALSE,2607,890,
03806e8113375888dfd611de6a6f7849,1232,FALSE,2352,1120,
e89ae8dd762bca6270f79f80645d28c4,1591,FALSE,2862,1271,Dire
857651987eb589ada4835a57d7de86a0,1435,TRUE,2422,987,
f60b81297b7023b464392a2a3d8964e6,1959,TRUE,2505,546,Dire
b9ba0887632861d6c5bf2a489c5bf9e6,412,TRUE,1441,1029,
21aa7284a40e6fd60f819c20f689ed52,1241,TRUE,2185,944,Radiant
220438bb86ec0a952d245c1caec93ecb,333,FALSE,2186,1853,Dire
576f3e7b288bf103f2f01446622cf46f,437,TRUE,2299,1862,Radiant
4a3da3a4a582716d781968b8ad3f5922,1283,FALSE,2502,1219,Dire
2edef25c1777bda9c22224cbb6c00962,78,FALSE,2011,1933,Dire
0517fe85b916dbdae6396d1a240762d8,996,TRUE,1722,726,Radiant
d0ddf0a9c0e452e64ed3e560abf06d8c,511,FALSE,2038,1527,
c3905eeaf96c922807a02d9e32508fa8,185,TRUE,2422,2237,
5230a18b58113e07de5cf1a03451ef53,83,TRUE,2309,2226,Radiant
f4c1fa697c1783f51c310788c34e67ea,283,TRUE,1714,1431,Radiant
f9efe45f00e50fe554e63e1844a115bc,796,FALSE,1636,840,Dire
7f73caf423c519488c4d4c94f69a7e7e,2031,FALSE,2250,219,
5db1379d5508afa7b14e424b3beba962,1707,TRUE,3181,1474,Radiant
2bc4631683c68b0935c04c60e252648c,941,FALSE,1574,633,Dire
eb04ff125ee82d1c8cb083235e381f71,236,TRUE,2230,1994,Radiant
c1b43376d0ac3037daf69a64f9e9c340,1551,TRUE,2663,1112,Dire
791aaf5a0e1789e2bfe04cb498aa7b09,2290,TRUE,2515,225,Radiant
c8289041e9d1a105a4b2c8fb8fce6d53,872,FALSE,2730,1858,Dire
2ceb59320168a0974c76d60b3c0f0062,2444,TRUE,3663,1219,Radiant
d76ebe333f20c7f10649889c17b6f653,365,TRUE,2535,2170,Radiant
9c1025f324b3fc236718cb92bddb463e,277,FALSE,1650,1373,Dire
23400659124c88bb81994e97c25a4729,2772,TRUE,3439,667,Radiant
98cccc76c5a71c43775da623c3592233,549,TRUE,2196,1647,Radiant
8d1af216bb74a3a86bab1ae160c60f62,266,FALSE,1983,1717,Dire
73559c763a97d44379bd50c2ae9cd160,878,TRUE,2202,1324,
f074cccbfc539185dec1ca6dbc41e092,357,TRUE,2277,1920,
5195ee0b0e473cc50c94f413f5209323,1724,TRUE,1922,198,
4dc6db9dca46bd4f9a0fdcf7d98b997e,2128,FALSE,2853,725,Dire
4c390a2e12360f0484d708e2a1816702,851,TRUE,1708,857,
59b74eec9f2bf9e732e50079bebd85bf,2113,TRUE,2481,368,
3f0e85e2df5c28877bb427471946fa3b,1448,TRUE,1849,401,
64cc990e6ebbb6f65663cadd010e7396,2464,TRUE,3034,570,Radiant
222dbe171764aeb53c44ddd2fdbd246e,1889,TRUE,3149,1260,Radiant
ffeb30c4cd9ce36b99b1e83ac790c89f,903,FALSE,2326,1423,Dire
36afa77a1398a3a50fa575064aa6d37b,892,TRUE,2497,1605,Dire
94f5ea4928f3fe55cb228510e4fb4532,1327,TRUE,2096,769,Radiant
1467f0f47964a13219c8c065ce55bd26,209,TRUE,2412,2203,Radiant
2229a510c373dce82f4a438e1f195842,1339,FALSE,2184,845,
616aaeb07e6b03797a6ace192d4ecb6b,1660,TRUE,1749,89,
c71e1e45f1e8617d97c2095beabb98f6,670,FALSE,1342,672,
ca0b4afb6ef19c5a74c4354e3e629203,1746,FALSE,2855,1109,
69bfee8ce96dd1b0ef18416547ac843a,152,TRUE,2838,2686,Dire
62f2ae1a1fa5766f746c207b31316730,671,FALSE,3321,2650,Radiant
6ea012592e1ec018a52559d86a9cb60e,2381,FALSE,2651,270,Dire
c9b81a5e1c47d42a25c9e1a858a75e48,261,FALSE,2185,1924,Dire
65ad783c9935ae5022d5d7e3626de499,951,TRUE,1432,481,Radiant
a6a608a3272572832cc67f5f938560f8,891,TRUE,1337,446,Dire
8c698688963ccfed1a4c0c634ca32cc8,2214,TRUE,2305,91,
80b20387ed01a8819c2abd783025dc19,3095,FALSE,4062,967,Dire
c36fc56f589c3e35bf345221f16fc1af,1625,TRUE,2074,449,
d240d0ab121251525f84995a015d40a2,539,FALSE,1442,903,Radiant
11fcd17b3d3c34b3f87438e88f9d534b,985,FALSE,1455,470,Dire
48224bd13efe7f21ebc098c3923a65b4,1307,FALSE,2501,1194,
9e459c02eaf1040829709d55e4a17b7a,895,FALSE,2207,1312,Dire
0169aed261ea7fdc117221882afc4537,898,TRUE,1747,849,Radiant
8d82c4437afd8676d16a8fa00a2a19e9,2128,FALSE,2283,155,
da4d36a57cffdd7701dea85f10beb16d,1834,TRUE,2201,367,Radiant
4c41e6f8aad462133f1e949c963822d8,204,TRUE,2501,2297,Radiant
b1c41a92b5fc11b11d2b65a302d48810,1699,FALSE,3379,1680,Dire
0f323b7fb4c806272a307d44acf122af,4206,TRUE,4464,258,
3ffff6c93f3cab7af29b9a7f0f515cdc,589,FALSE,2333,1744,Dire
a426a0ac8256845f62e3ed917bf7acc0,391,TRUE,2341,1950,Radiant
8bbe15fa46f7d5d3b6b9c2500fd63326,398,TRUE,2416,2018,Radiant
ea366b0626515ccc9a515cd928673365,2873,TRUE,3084,211,
add7e591b7803ac481903d431794a33b,343,TRUE,1857,1514,Dire
89bcb9d0b1810cf19513da7f3fe2e36d,397,TRUE,2253,1856,Radiant
1aa4d5e14fc41dca8af66a0e7c08510e,1265,FALSE,1402,137,
ce6e7e71d48b99c0112c74ca53aea65a,2048,FALSE,3301,1253,Dire
910abadf4518369f8bf5796a50fc7730,257,TRUE,2245,1988,Dire
e6a0bbf8231e566aa371f53118902175,1949,FALSE,2207,258,Dire
0f2f5740ec9349fd31d1d6f358156fd5,177,FALSE,2255,2078,Dire
d0c1075db1d6240b0795ca6ab01c4bc0,2058,TRUE,2482,424,Radiant
c899780408409afd5f033d4fb078bb1f,634,FALSE,1260,626,Dire
46bd29f0850e3499758d7a943bbb86fc,1603,TRUE,2809,1206,Dire
1ddb7b3514bb8157dbe43c6333dd0eae,841,FALSE,1374,533,
20dc99ae419976a1dacbffadd13ec381,582,TRUE,1476,894,Radiant
dc492eecdb24a32392132ffb9c33f70e,1039,TRUE,1836,797,Radiant
bef2fd27c4fc985448915075b3bbf3b3,1759,FALSE,3516,1757,Dire
e34797d4670297b3850f9f4754a4dbbd,731,TRUE,1963,1232,Radiant
c19c00b809e8581c9de3880e9c0d6d26,1630,FALSE,3341,1711,Dire
03eac33465086e1581af2d7747ed380a,1776,TRUE,2394,618,Radiant
d0ec12618647837dfc8933d8d8a3a537,520,TRUE,2677,2157,Radiant
9055620d61e0b3cd0217793a2749f76c,424,TRUE,2409,1985,Radiant
5086e0851fda88bd4ab0a4b5300f861a,2397,FALSE,2949,552,Dire
3e74fe3522c8f64dbba2cd6f1ae40042,1714,TRUE,2080,366,Radiant
c30cf2b64319f60ee7f47a3b40ff7b3c,982,TRUE,1333,351,
a7e158345031d2515553dee3db51696f,1099,FALSE,2244,1145,Dire
4e87122147903c5034c0faf9f159ca38,523,FALSE,1235,712,
823c042ce9ad63b98cd7e5302f12d119,68,FALSE,2246,2178,
22e9936eec348a6004ff7d4fda2b8bba,1768,TRUE,2260,492,Radiant
e5808b19e3645b718177177f12d40950,1660,FALSE,2213,553,Dire
01bfd78887292f169bdac076cbc02b6a,438,FALSE,2747,2309,Dire
e771e108dd6313804f5183c6e2746122,2104,FALSE,3654,1550,Radiant
2d22317899790364d65cf6840db12b75,153,TRUE,2087,1934,Radiant
ce3e5ab57f96efb44bce7c83f5215f62,942,FALSE,1610,668,Dire
cac456ce9f10a394efd9c4a58538669e,1589,TRUE,1789,200,
77d6bc56cfdc0506e3c25736e439d6bf,1603,TRUE,2203,600,
e264cbf5372e741c99e709b3ff1dbae0,17,FALSE,1556,1539,Dire
4794421d09f18028c7bef4826906ad2f,117,TRUE,2280,2163,Radiant
0f3ce143b1783d7f0b33d4ebf7cd5b03,1406,TRUE,3650,2244,Radiant
d3c6eba9a79cf3addc1594c432ec7b9c,765,TRUE,1748,983,
22365bd0fd24c511ce2c5ebed86728fc,890,FALSE,2235,1345,Dire
6ea002b7140e6a077f629b1ace8a0221,9,FALSE,2486,2477,
7c986509b2c57fc1624fa2d3b9be6176,2179,FALSE,4090,1911,Radiant
0561358a1a896d598c4009acaef6bbe2,1399,TRUE,2108,709,Radiant
7ad640a12eceecc4ad64f5edb3b5a7a7,710,TRUE,2491,1781,Radiant
b21c3a3ed06d624259527ffab3613f8b,400,TRUE,3048,2648,Dire
3e850aefeaf5646796181dee22251b75,1743,FALSE,2260,517,Dire
a261c3203723930541340b1f35fab35f,2115,TRUE,2632,517,Radiant
c5cffa32037e86517f44186b4db7e267,2329,TRUE,3356,1027,Radiant
66093eee1f1a03c53eee2e6270c11d35,1358,TRUE,2172,814,Dire
d8a6357f72e833b26fc847370e8e9726,1512,FALSE,2805,1293,Dire
a5cda6d6956a782fcf041e3e76bfede6,3106,TRUE,3458,352,
8201f57badf45a252963180d33f97a6a,1405,FALSE,2252,847,
c60645441f5bdaf4e8144a2bc8df0535,1128,FALSE,1225,97,
c886c9de1a1c5002e3cdf93f003c0f34,107,TRUE,1831,1724,
364c491eec448abd9e30bf4b4ad86937,622,TRUE,1907,1285,Radiant
32817c2ca6750e0ddb6f4cf7145be0a5,63,FALSE,2174,2111,Dire
9b9a3be5f84387011c4e565e81027ae4,2940,TRUE,3659,719,Radiant
d4a7c5841f18a3c4c4c118f283846766,675,TRUE,1961,1286,
43ed7e84380f2731fd17ea3cce5885e4,2283,FALSE,3145,862,Dire
89c133c9dcf19821a3db9bf7a5045fa3,1093,FALSE,3087,1994,Radiant
6d4558e63f434c5f8621e8241eaa8b28,616,TRUE,2146,1530,Radiant
767de085cea2eca14d0ab9781f73358b,1805,TRUE,2667,862,Dire
6c177d7ec2d56ddc7caf0ed3077d34e0,1120,TRUE,1412,292,
3195a230a151c2f4029df843c8d1358c,3315,TRUE,3825,510,Dire
7ce5fd264f4819689a875e86f1a29f13,2390,TRUE,2545,155,
2f770ba06fb0e95f4e0e4a704779d6ea,1072,TRUE,1665,593,Radiant
50a7f57b24a07e9b85acdb2c18f20758,803,TRUE,2079,1276,
1a9c28cbd633f0f4dacb4170e4fce8dd,1931,TRUE,2907,976,Dire
fc67b6ccddb714d08299d630cca98b19,244,TRUE,2801,2557,Radiant
cf709193941d6782473ad90cddfd29c0,300,TRUE,1875,1575,Radiant
c34b8c361e0321a11800090ad34b3e10,1591,TRUE,2216,625,Radiant
6b8a4537e199762d75e7d6106239b654,1153,TRUE,3366,2213,Dire
d75da5a587ba97b4b6cf5cf407e60f85,1739,TRUE,1963,224,
10048b7ad1ba088f8d2701cb6934cd34,179,FALSE,2890,2711,Dire
76c6d4103cfe5583209a4c871657a83e,11,TRUE,2258,2247,Radiant
19da236ed05709b8cb138cda91b682fe,1320,FALSE,2847,1527,Dire
6372e88eed01bd71c135489f4dc4adc2,355,FALSE,2488,2133,Radiant
5acaf4a8076f6c862f3286b1f23d1846,898,TRUE,2098,1200,Radiant
a43a6e9bd11c6b06819d676879a27a9b,2424,TRUE,3661,1237,Dire
a6b2b716464d42cff5aac0c44545a0c4,1804,TRUE,2044,240,Radiant
137050e6c3e04df768a23b8da991b464,3536,TRUE,3603,67,
ca1026cbf45e5752ef884907f5f1dcce,812,TRUE,1639,827,
665c7a47571c61d957eed04f1a1b1936,1238,TRUE,1718,480,
868cef93dac445cedbc53b2c73e48fab,880,FALSE,2076,1196,Radiant
55fead6f88656a77de47df0d3993ce54,403,TRUE,1784,1381,
d185b3f57bc3c16452975e6f0d8cca72,1137,TRUE,1495,358,
8fb1a1f569de794752f64407016e2d9d,1203,FALSE,3333,2130,Radiant
2401eeda5f5d1447ec7ec0c9a4226597,545,TRUE,1610,1065,
fec741a24b36e778373e885316740216,2101,TRUE,2346,245,
56c31a7d3ba7c6f99b9cbaf66384d57f,1054,FALSE,2409,1355,Dire
ef0e6a6ab19093417756c9d7a9974493,500,TRUE,1429,929,
61f513896f0fdd2019287233a23abb4c,770,TRUE,3052,2282,Dire
b547ced13d310f968874ac9858e49caa,1520,TRUE,1613,93,
cdcebeabf826657f3fa0d1e8252fb136,1616,TRUE,1954,338,Radiant
2bfe16b2f15310a7ac27541f3612f145,1317,TRUE,2759,1442,Radiant
848cc9eae542830b3a32aafa868b146e,821,FALSE,2265,1444,Dire
9c9653c49157def1762d83e2fc059bce,2943,FALSE,3579,636,Radiant
6afc0cd70c7f3231e470e19d9a537d9b,1325,FALSE,1997,672,Dire
3c0944b0ddd24967cd7188b24f874513,47,TRUE,1919,1872,Radiant
173e970c6862dd5383b71eb0334be88f,605,FALSE,2784,2179,
c722ce92e06e7aeda6a35f584f698246,109,FALSE,1258,1149,
cec0f9c455b0ac487d8915e380a56395,2256,TRUE,3703,1447,Radiant
58167ce43c789ab358c7b11369d0058e,203,FALSE,1504,1301,Dire
39d7b20380c94c21f7a4f0b16ac0a259,526,TRUE,1135,609,
7a83529986e8570b11d9256655999e61,734,TRUE,1886,1152,Radiant
8fa39f77f780e6bfeb7e99712d412db7,657,FALSE,1422,765,
400dbe43b0d49e97dfcb5930b2e7f214,1559,TRUE,3076,1517,
e69171ec82230346d0cbb30f832cb87a,886,TRUE,2036,1150,
5ce4e97fecc5936cca410888a74b4f07,1275,TRUE,2836,1561,Radiant
9ca9467414f5b3799210b99c68c55649,2035,FALSE,2530,495,Radiant
7b77ed91ae594ffb4c4db689580754af,1196,TRUE,2817,1621,Dire
008a17ca28ce53e76c340331dbd0768e,720,FALSE,3054,2334,Dire
679af613428382a58a801983acc68f69,1352,FALSE,1665,313,Dire
c1b04d53bc81764044e4b64a4a071ec3,960,TRUE,1427,467,Dire
c0de1746e76397dcb6efde287c412596,2319,TRUE,2496,177,
a0386d8e88fcb449f7d1b76731bcf2b9,1243,FALSE,1989,746,Dire
f8ca6333bba6e7aff6ca78f9039b1216,947,TRUE,3160,2213,Dire
ee664cdf4f03189c8ef06c6f00c9befc,1495,TRUE,1622,127,
3869763fc3c78c54a74e9bc8f18c1fe5,759,TRUE,1163,404,Radiant
0ab3e878b73dbb38c23332d6d630491e,828,TRUE,1704,876,
a6c27c9323faa85450c70ed8c33fda33,2430,FALSE,3229,799,Dire
17d956fd36ac8d1cb3268939e6f4ba9c,1359,TRUE,1729,370,Radiant
7410b521718ee65920cdae778c149418,1372,FALSE,1856,484,
94b8df7c57873251d1dcabfc68f203f4,280,FALSE,1066,786,Dire
9ae97143a0289b3f3c473125ca0214cb,1767,FALSE,2030,263,
f8695b36139f2b970da444b4038841f2,730,TRUE,2354,1624,Radiant
eae30643d83fe916a04d66431b14e4c3,1050,TRUE,3178,2128,Dire
c54b1bb4386464ec6f37fcea3e427d6c,1015,FALSE,2991,1976,Dire
88e3512f79e3f1a3bccc6d04f79145b9,709,FALSE,1068,359,
46318aa477acec3b6102f18f08e5f52a,3153,TRUE,3851,698,Dire
71a53367cb5d8c481e87badd6a07e451,248,FALSE,2150,1902,
a0398eda7d2c852df5e943a57f020934,2416,FALSE,3673,1257,Radiant
7d363012ef46f12cb8a1052fc5bf5156,1762,FALSE,2208,446,Dire
d41a1854ca029b4278a1b5a8802846ff,172,TRUE,2846,2674,Dire
2a5296d24a464f00406931ca6482b834,2803,TRUE,2963,160,Radiant
1258687b933c19030508c3644cfe8069,393,TRUE,2866,2473,Radiant
68e649c8bbfc853aa7a0adf42fc8c115,1086,TRUE,2073,987,Radiant
29a05252b1d066f8defacff358769be5,1623,TRUE,1675,52,
5fed3c9ddf9f1d4459012c0cd4d033e8,949,FALSE,2477,1528,Dire
cb19507f7ac0ed97890995a50e02e4fc,2713,TRUE,2854,141,
2361912c417d5f336fb7953e30808889,3083,TRUE,3676,593,Radiant
30374486221c315e30e9f4873a4ad241,1148,FALSE,1969,821,
8a372e400c9c79ba26d1dd717e62b689,756,TRUE,2273,1517,Radiant
78bfa8f1476a93058f9e609ea0afce0c,1806,TRUE,3037,1231,Radiant
60a0df0583fbe7a8e6810929a15e25dd,486,FALSE,2498,2012,Dire
3853cbef7b1b59f8b9505d18b883c252,993,FALSE,2254,1261,Dire
c7771b765b072821db1539c4ce8f621b,1236,TRUE,2513,1277,
5c9c6e869820f5eac0f58b3469d2358b,1131,TRUE,1741,610,Radiant
c187d46b980eab8765f48e2e086cc52d,1187,FALSE,1370,183,
bf9b8f5a348966aacd56cf2b98944e7e,514,TRUE,2608,2094,Radiant
22721a3ecb4b6bfc01daa88d46429ee3,1482,TRUE,2365,883,Radiant
a90fff9546c76a7c1ab3e0b39433694c,725,TRUE,2256,1531,Radiant
8e37e1f7cdfd48b6bac7bf93536c838f,1530,FALSE,2291,761,Dire
252b3e241cd7bb6a8309044fbb7f1060,1579,FALSE,1676,97,
28d4d77ac4dd8b06f5a7f44a46d4650f,1160,FALSE,2520,1360,Dire
ec0ac1fa1ad4b17e7e0afc68bd7ba0c7,46,TRUE,1928,1882,Radiant
230290143182779b410308ae57ecc307,994,TRUE,2354,1360,Radiant
310e4fe6d3c155143443c3abbb8045cb,1408,TRUE,2749,1341,Radiant
47098448e2e6561e3cd37952a66c41aa,715,TRUE,1679,964,Radiant
9b5dc7c2f4a3f7008d5a5f5c5fa2699b,339,FALSE,3166,2827,Dire
3becc29243c1330987a4438e10fed2ce,399,FALSE,2161,1762,
415109ff8975155c4812c737d53e5ea3,2725,FALSE,3414,689,Dire
698fd5e61563feff19c813a0a4d58b63,1402,TRUE,2458,1056,Radiant
8326a9e8a6f5e518497c8d0ebffee697,2612,TRUE,2706,94,
7eb71425b9f166f0e5dcf1affb146137,452,TRUE,1887,1435,Radiant
6048e7194d863f692d462ff891be17f2,468,FALSE,1429,961,
726cab1738507235d648b8af1b8b6424,1047,FALSE,1529,482,
b98612c79690b0c351e1aad5e3dc7ded,1412,TRUE,2572,1160,Dire
c56e6d8c220123909c3138c900798849,55,TRUE,3332,3277,Dire
dda213e9f83bb10384d931a264d8682e,1694,FALSE,1921,227,Dire
c7aa9d2215e007889698b564e88cfc12,1612,FALSE,1944,332,Dire
df8671f288cc5daa03d4e470d527adda,1653,TRUE,2161,508,Radiant
afa11f6059c84a75337d6d7a1ce92833,1304,FALSE,2152,848,Dire
c4a4da130609af606dcb5092d443d9b8,1353,FALSE,1607,254,
a4bb5340b40da58843949f381ea29014,2140,FALSE,2786,646,Radiant
cd842bdcbd806dc3ba4b50b231794726,635,TRUE,2599,1964,Radiant
610303669a164388479dfc9e9d01923d,982,FALSE,2954,1972,Dire
cae2060cf87f99cd6a01ffbef182bcf6,364,FALSE,2583,2219,
8867d9ffdbd9bab5a307688871b92d75,1872,FALSE,2448,576,Dire
5336e7372e8138adac05ebe28d38d241,1508,TRUE,2214,706,
bd5ede06255a993b8f945d70b94c6c58,1697,FALSE,2323,626,Radiant
87867afe6e676a04d2207db566a1b2bd,2007,FALSE,2493,486,Dire
8925d64ad5fe8be1067738f9aa0c8679,186,TRUE,2044,1858,
b5cbb5532d51af97a3842c2ab840a188,3640,FALSE,3808,168,
c83158ad0f8e2090ce22de3dd2faeb7a,1573,TRUE,1682,109,
ea76284f0e4140d189ad98b08f6bc8bf,923,FALSE,2289,1366,Radiant
26844cb0fb0aee44ce7a5f23460c4363,699,FALSE,3522,2823,Dire
4422b72e3b0a198afc100e0335a17487,1033,TRUE,1746,713,
ba55374bb2bc3c5f821da96e562cb44f,332,TRUE,956,624,
d4806e8152981b1e1ab1b92e67e82370,283,FALSE,3001,2718,Dire
3339056c6c867139b6f1ad1ee6a4e570,349,TRUE,2040,1691,Radiant
9507dda98cfa2501cadcaee9ae104c6c,1095,TRUE,1175,80,
e7cf1f589906bd9b188036518839ec2d,1842,TRUE,2491,649,
8dbbddf1c2a56dfa48a7303af1f98bbc,737,TRUE,2012,1275,
1ba5b394237143179570183b0a639e6c,56,FALSE,2059,2003,Dire
572ec6f44b603768c565d07ae612336c,1132,TRUE,2163,1031,Radiant
a7bf7df12f7d1e46bc83edf4bfb97877,2640,FALSE,3654,1014,Dire
f52cfa694a4e08c74f754c30835186e3,2218,TRUE,2941,723,Dire
38fc5e29b2df8f0f01040bd3566a2428,971,TRUE,2158,1187,
6d1187086100cb3b9a895201d77e730d,423,FALSE,2444,2021,Dire
2698185427ed16cffe16f38b44de66b1,2721,FALSE,2827,106,
dc5269242f9780cfe238f3c76313f303,426,FALSE,2197,1771,Dire
8d24957d81693ef55e465b3e483885a9,1578,TRUE,2246,668,Radiant
3f3a51c2c6b2f86e5dd10b167d458f47,2582,TRUE,3361,779,Dire
67dd2a9582c8444596143c5ecafe3493,84,FALSE,1595,1511,Radiant
470d5692c2da8d1f174cc605ea6117e9,622,FALSE,1192,570,Radiant
19188c79761d3a1364aed60414cc2676,344,TRUE,2242,1898,
6331b7b5ef2a667820b0ed7addbbf16c,1669,TRUE,3000,1331,Radiant
bef7eab124ed9be142c1832de47fd5f2,1411,TRUE,1918,507,Radiant
1bda0b08e1ce1417ea6083b3eb38c614,728,TRUE,3566,2838,Radiant
644daaa5085647e1735211238ae27872,1619,FALSE,2032,413,Dire
0053a917022de49e1c18852c19bd53dc,603,FALSE,2241,1638,Dire
fb33666685c4bdae68b9b64561d54ac4,83,FALSE,2494,2411,Dire
b8ec1f90b8f130409d839ecab02d4b42,939,FALSE,2196,1257,Dire
1f7ceeb8dce18d3e31deca0e3985bc79,1287,FALSE,3059,1772,Radiant
d217e37498034d0afdb93f687a97e67c,396,FALSE,1793,1397,Dire
5565a11ea54bffc220545002cada156b,428,TRUE,2458,2030,
e38b6f924e876f93a9e55783e79ff37c,474,TRUE,2374,1900,Radiant
be020ccf082de1a5b9214e4461ea5598,320,TRUE,1959,1639,Radiant
5dade726f962c1e3cd69b0359f5efb70,152,TRUE,2038,1886,Radiant
ce21375ca50a3b7125043bf5ba3d834f,399,TRUE,1726,1327,Radiant
023bea74fdff7d666ec7de3055c6a778,255,FALSE,1861,1606,
bff794109d3428bcbdfac6b7a70d464d,1796,TRUE,2888,1092,Dire
669c546ff64feaf6fe8e542a91c5c247,895,TRUE,1890,995,Radiant
68cde86408d0be31eb24f47610dc8048,935,FALSE,1813,878,
408100d708d8409442dbc0a36a05f118,1894,TRUE,2668,774,Radiant
36742600b012007d64ea2122c35493a4,1067,FALSE,2468,1401,Radiant
45427f127c0bb686d3f6aba39835f19d,336,FALSE,2225,1889,Dire
f957e924db6424cbd3ca8b9bff7f46ec,663,TRUE,1846,1183,Radiant
1c235c4a9f0e35013a14518ed641072f,1275,FALSE,1471,196,
1998aa0a7c3f2b8cbadacacb6eca6751,190,FALSE,2257,2067,Radiant
00fbf2b95f370ae7a9ed6832ed09f255,1725,FALSE,2343,618,Dire
644e632ef932d5d03fe60c30a1718b2c,491,TRUE,2152,1661,Dire
113506b9395da25be4dd61ad5f0b4779,444,FALSE,1918,1474,
6b635e26e5eed1d99c9416806823f8fe,118,FALSE,3078,2960,Radiant
684a5a3816d51cd6271336d977cbc7dc,176,TRUE,1925,1749,Radiant
a5ec638c3de062268e2c6b09e17b9191,996,TRUE,1812,816,Radiant
3bfa982068dc295f7b3878109713d3a0,947,FALSE,2032,1085,Dire
8e46077f5947fc973c2173e2d8b179ce,2253,TRUE,3108,855,Radiant
59b5e010020c35dd8330a15432464a6c,947,TRUE,1274,327,
f10cc945f2f19f248b8a647b936cdd1a,2590,FALSE,2810,220,
a5010a8ff5958a81ecae50ff4f338547,242,TRUE,1556,1314,
600dec9d3f6f126a35ee84461e379936,814,TRUE,2023,1209,Radiant
a23d5e97aedd34815da42755b6116c16,453,TRUE,1370,917,
0123b13477583d5bfe91c98ced2aab10,1573,FALSE,2195,622,Dire
f9a718d5d39f5b625c576b1eaaaa2e03,2306,TRUE,2343,37,
f4cb0392bb7d94960c3de293b697a355,2047,TRUE,2490,443,Dire
19e59f01c6915135573313c6dc821bb2,81,FALSE,910,829,Dire
09f893483d4526857602f33cce29e18d,2137,FALSE,2795,658,Dire
28e5fd8acfec44866bd10f2223e4d37f,1190,FALSE,3421,2231,Radiant
23632c4f00a96790a06b20fea1079398,1050,TRUE,1140,90,
bdc8315fb4a5f830e6eb12128640ba27,498,FALSE,2334,1836,
f4cef71c81ea0db5cd1c0a540d9dde10,1341,TRUE,3308,1967,Dire
9587640246910f0e1b033a6c8f6d8211,2092,TRUE,2344,252,
6ef1ab883e3db6add26f32574a61d288,2932,FALSE,3074,142,
1caead6217071a3ca6f06b124ac3fb58,267,FALSE,2427,2160,Dire
3f0e9f80782627b6e6cb71a03b6e8a79,1043,FALSE,1268,225,
843ecc5dccbdc9c98f79802b0c242124,2082,TRUE,2658,576,Radiant
bdfb1665beed347346fe492f81d0bdb4,1642,FALSE,2037,395,
441927e22a16867b217b0736cc9edfb6,904,TRUE,1888,984,
c324400ec8c9d90a7d71dd7911092acb,1116,TRUE,2348,1232,Radiant
3a31a3e21c314caaa219a898c30f64f2,503,TRUE,3362,2859,Dire
14068c3e86f36a68d7e7f4f17e326be8,968,TRUE,1276,308,Radiant
49827e3839e7200a9b932e8d1757ed7c,1329,TRUE,2362,1033,Radiant
77804488c3a8ba4a88418b2795ef1d85,2784,FALSE,3116,332,
d63c3a0e997ac78e6a9dde10b0b199ce,663,FALSE,3292,2629,Dire
43d2c50e605ebda9f23ec60d344101c1,208,TRUE,1788,1580,
763f800d580aaca23c771f3f1813e63d,2431,FALSE,3079,648,Dire
3872cea5198bb4a45a9022cfad65b513,1100,TRUE,1457,357,Dire
1f57b8025b937499d2fc4f0f29845f62,3446,TRUE,4591,1145,Radiant
6cafceb141068f937d7284f20397a08c,1983,TRUE,2159,176,
04213cec126b48246f1e618ee4039b29,2206,TRUE,2988,782,Dire
d46230494559a22f7522779f966dc447,1895,TRUE,2061,166,
60c05b47f57c9f3c16656d997397d0f3,870,FALSE,2370,1500,
a81cbb6bf607441a69180e1934d4ee9c,516,TRUE,2192,1676,Radiant
bac7a8e8859b2d0be6d1c638adbbe14a,476,TRUE,2845,2369,Dire
8e754382ef41cb0b87e0f513186a0040,1580,TRUE,3004,1424,Radiant
235150d9c1b6536c774c6a090e73c3f3,450,FALSE,3276,2826,Dire
6ed100a4eff7f4b2232ad0282b8035ea,653,FALSE,2079,1426,Dire
43b2bfddf2eb3e14794284789f29bb6b,254,TRUE,1807,1553,
fd38c749e50bee629c0f829a6138af78,1186,FALSE,2545,1359,Dire
99c6d2fb2e76cc3abdf3930774c8296b,790,TRUE,2571,1781,Radiant
8456ffb7f3c9bbfaac52a5b853e23f24,1980,TRUE,3404,1424,Dire
199adbc8f49d9c1cea1d480381547279,380,TRUE,1584,1204,
c4589789b81f022d53f21debbdbb95a3,2321,FALSE,2776,455,Dire
e50dbe15e3aa5acde48bc60540a2d286,2700,TRUE,2902,202,
a9c9656ce62a2dd0e87f25e591323bcc,2017,TRUE,2296,279,Radiant
a4d99cb986b17fe42a0b8bcdad65e9f1,874,FALSE,1539,665,
b4cade83f5f69c6c7db70fcb7ef509bf,1460,TRUE,1892,432,
65498161121b79a2068f41ee530020b7,1625,TRUE,2652,1027,Radiant
00fa7bd9a11757f599b75e64d810b320,472,TRUE,1652,1180,
e94c5ae461868da75f5f8467b98bacd0,517,FALSE,1596,1079,Dire
5ec069ed672c8befb2b96ebeca3e6aeb,1187,FALSE,1773,586,
56ce148bf502ccfb3f75c99dcc36e662,1118,TRUE,2333,1215,Radiant
baeb1d83b5634ea91bdd800ad0364a40,920,FALSE,1834,914,Dire
cfc929e89ea26f7b17c32769d8c4f684,360,FALSE,2717,2357,Dire
b3e09f375cd3218427bbbb17d6d2582d,1075,TRUE,2162,1087,Radiant
e95f745c586039642448f092ac09a982,1019,TRUE,2106,1087,Radiant
8dcb5aca3bf394f2e4d3544f07768671,1516,FALSE,2226,710,Dire
89f6c3cdb794004b4009acf77fc47438,737,TRUE,3030,2293,Radiant
41895be5bc04a2065faeb67289ec99af,2407,FALSE,3264,857,
410c5e0b039cd9d053df2c69446b18ba,283,TRUE,1373,1090,Radiant
d148d357d8d2711de70d5553e6ec4377,266,TRUE,999,733,
7e98a45de005c9dfffe6aed394d62c07,1988,FALSE,2597,609,Dire
4e7f8e4973b19e9b97d74adf71c5b237,785,FALSE,1822,1037,Radiant
64ea1b626b9502ff8f497601f5272fc9,1054,TRUE,1742,688,Radiant
278c28affa803e3fdf59f936c1e31dc6,1255,TRUE,1658,403,
ab7290c54d57c46553f8eecef2b20a3e,1049,FALSE,2436,1387,
1d5b8b8bb5895108198d2477d7ce8701,230,TRUE,1931,1701,Radiant
74db7af5625ff18735f4056cc49b186d,981,FALSE,1882,901,Dire
4120bc75fd006cba039f94174d18bf3b,829,TRUE,1689,860,
62dd5bb65913b8693056c9978f7bc666,774,FALSE,1875,1101,
7acc9647f12f8ffad4b2466f33855783,108,FALSE,1715,1607,
87aa6727689eff305a403b1996c4e817,518,FALSE,2374,1856,Dire
0bec0a580b4e0a22a02a27734cff76ce,1328,TRUE,2425,1097,Dire
f14924d2b7f0f76cea49ecbfb1839dd3,1426,TRUE,2143,717,Radiant
171de08db82632888d49b44952c32776,575,FALSE,2059,1484,Dire
e33fc37637f8c86b2a51a142667b7803,1487,TRUE,2438,951,Dire
8b53a7519a2c93c744df923cec9bdac0,187,FALSE,2315,2128,Radiant
dab78ce766ba90bd47ae30f559f78cfe,4022,TRUE,4791,769,Radiant
f34d79b62a784df254f4aa170fe2e5b6,1127,TRUE,1815,688,
c34d848a5a83c129f2512bb52e75918c,54,FALSE,4443,4389,Dire
dd862073c13514df1db8d7be2aa93960,1793,TRUE,2881,1088,Radiant
2811ce0729fa0fcb5b2cb3120ad016ba,2143,TRUE,2604,461,Radiant
47bfffea01eacb2c11a5a3660bb60a4b,137,TRUE,1890,1753,Radiant
f4250b3d70003c63fcad31993d48f82e,546,TRUE,1796,1250,Radiant
37c6bb4150fa292c564cf8cbb135e3bb,1673,FALSE,3246,1573,Radiant
811ed36c3a98b4765f5ba6da55e575ac,1194,TRUE,1664,470,
32f9ba436df954295ab6628dc64f3fd2,278,TRUE,1244,966,Radiant
341ae0f55252fde6215752878bb3601a,1058,FALSE,2853,1795,Dire
ad8e9b15abcef3bfb15c7e3d222a72d8,795,FALSE,1288,493,
306b8e394e75de83b94bd1addd0bd77e,615,TRUE,3414,2799,Dire
297067f553389a1959c6fb97278cd393,1361,TRUE,1634,273,Radiant
c05bcb7a47b82980527f53507f8d7f95,784,TRUE,1806,1022,Dire
c6407ae2f7d30b0f69becb81f08d9bc2,1810,FALSE,4286,2476,Dire
dbc93fdd7c32018652af0db05faf5a77,1053,FALSE,2807,1754,Radiant
d228ca57970d1ed14bb27c62b86db048,1432,FALSE,2513,1081,Dire
9bbfd196e9cbdb443d9ec274b4d964c2,98,FALSE,2985,2887,Dire
39ad4e0ae1b7462293ea532e0fb29ff6,1014,FALSE,2126,1112,
ba2a163792eda0b5c93bc0f1ccb125ad,475,FALSE,1633,1158,
f6291bf9d3c8f7d2b692f60c0cb90c01,1390,TRUE,1735,345,
dfd18cf579acfc0b9d094bdb159ccc5b,348,FALSE,1417,1069,Dire
35c1fba770aba8c73dc547a58be849fa,1257,FALSE,2496,1239,Dire
fb5d69ab10554e51da31946569a2cd60,1018,TRUE,1071,53,
cc321c93dc6deec50800dd0c2f839d7e,2272,TRUE,2632,360,Radiant
7160254827603dd935400e2936f677ed,866,FALSE,1656,790,Dire
33f70a4b4e602f57a148feb0ccd58a0e,1095,FALSE,1753,658,
7197d58a2ee96b78f7550730ff976e50,1193,TRUE,1276,83,
ec90d7f64541bea8567f68ab9ffde518,2041,FALSE,2333,292,
ba89b8508ccc3006fe6cf037a98f396d,119,TRUE,3528,3409,Radiant
10f025d247200a6d10dc2be519448d53,507,TRUE,3453,2946,Radiant
1178f11b56bbec4b487fa084ba99421d,323,FALSE,2360,2037,Dire
1e5b018637ffc081e445e3a257fe6d95,1343,FALSE,3719,2376,Dire
670ffb7b2914b3acd0f12a8fdcffdeb5,608,FALSE,1293,685,
3346b976d9ae74873c40355dd16ee3f2,749,FALSE,2562,1813,Dire
9066aa141b6b34673778530d63174aa6,2258,FALSE,2517,259,
d95740692594d51a0eb159d9005b61aa,1749,FALSE,3925,2176,Radiant
43024e94d023f9ecf0820ed212d4acb3,990,FALSE,2039,1049,Dire
5479bcbc8ee1ceb1de91b5b4039e8481,1112,TRUE,2323,1211,Radiant
6e0d66690f5bb1df9462e3504908f02c,771,FALSE,3874,3103,Radiant
f4444bef523d9866ad9df9c48bbe6959,1579,FALSE,2502,923,Radiant
cc8b00e2dfa8aef42aa622082e18e6d1,1588,FALSE,4143,2555,Dire
b8d6eaf58ef0ae42fd7c20592acd6fb7,927,FALSE,2635,1708,Dire
5b0a17bce7bc784d37d3d4af945dfab4,501,TRUE,1828,1327,
1acbc11bd2219d4358194cd8fc524316,2486,TRUE,2535,49,
586e756289a52a87f2a38d1ae921c729,767,FALSE,1127,360,
686127dc239bf9eb3acc8132e0ddad27,1657,TRUE,2045,388,Radiant
80cd9b6d1854279a8f419d8885cbc323,3423,TRUE,3547,124,
7738e54809e790703cef9e4ddb18ad3f,1826,FALSE,2522,696,Dire
9ee8c9aeca0c2f8f566f7c5a3e6bd7cc,2642,FALSE,3234,592,Radiant
9eab1cc80a6ea514a28c956d1d2ad2cb,1938,TRUE,2521,583,Radiant
b63e2017db9bc22ee8fa16325f7f4b02,1003,FALSE,2733,1730,Dire
5c7e9a9cb003a6ea64fde62fbb9c0858,465,FALSE,2176,1711,Dire
126ccc6bf4665338f36715177170659c,1762,FALSE,2265,503,
dc3c475ee59933d0f9c9c6a47e59e9a3,1063,TRUE,1870,807,Radiant
909966e95b6da89e000339a0c2a834a9,2061,FALSE,2486,425,Dire
84eae2e9beafd1decb151ccb02a8a5dc,1252,TRUE,1887,635,
da8aed185016b3335c1b174851257660,1899,FALSE,2128,229,
622225df8980fae9be161e4941c70799,1076,FALSE,2554,1478,Dire
2a4b534385e11de28361d2e48466baa3,1969,FALSE,2022,53,
3664b574aca5e9c0daa3e0cf641999f8,600,FALSE,1929,1329,Dire
3656fd7a6145848f52b3db8522417b60,2004,FALSE,2947,943,Radiant
b6d9dfa6ab3aabeede791bfa41a99314,1940,TRUE,2202,262,
8101fec5cd45b740a4f7b47714ae9b22,327,FALSE,1808,1481,
edefb2258267222162dae7d5058f937a,1361,TRUE,2339,978,Radiant
d2a491c4915023be29f1cc7170c294a1,350,TRUE,2409,2059,Radiant
d2881bc429a94996d5a0796124222946,47,FALSE,1674,1627,
a363534a6344f1b0be1d7ba2c4047d9a,871,TRUE,1607,736,
7fb4954e720949f20c643a2eee150438,1159,TRUE,2437,1278,Radiant
dd85cfd5fb0ea3f59006c11960f625ad,1197,TRUE,1569,372,
eab78801e929622a914aa3b6536ffe9f,33,FALSE,3304,3271,Radiant
11d26febbdd1470b49c1c47bf4284699,1528,TRUE,2186,658,Radiant
4ce8de34739198db171140ee3a7bc961,1978,FALSE,2400,422,Dire
64c1073802d3a7f245a8d4cf587caead,14,TRUE,2358,2344,Radiant
ad32b87a0485a5c9b050ce101eecb58c,1557,FALSE,1931,374,Dire
4adcfd95ef80aedf6dac3533448c914a,2357,FALSE,2446,89,
89a011193f5125551450118be446f75d,668,TRUE,1709,1041,
cbd77e3cbbf64df4d88e72e2444c2836,1242,TRUE,1897,655,
2b8431735d495d7dbd5ead1dddc9e790,1158,FALSE,2822,1664,Radiant
4f8610ac3f97c940414754ee3f01ce7e,843,TRUE,2244,1401,
251e4ec17c42964071ac569e39aa5f87,1640,FALSE,1760,120,
dfb14688fe7043fdeb885bf9656873ba,817,FALSE,1412,595,
a5310795e9f6695bb5641bb9639b0e46,662,FALSE,2185,1523,
e5f4d2f0c6ec2c08c080f680d718b82f,768,TRUE,1611,843,
8d675f538238f20788812db892c749ac,656,TRUE,1600,944,Radiant
9ba818470eb52c95e62b7ade7649102d,872,FALSE,3052,2180,Dire
db841ebd11f749143fd59c51a1cf2e8c,528,FALSE,2536,2008,Dire
b7d2c95dcf33dcc974e250cac1cf03dd,1633,FALSE,2205,572,Dire
7ffdc8fe45ca94601081818621aca223,766,TRUE,2502,1736,
72191263a9e7a23261573390d95a9086,678,TRUE,1123,445,Radiant
b17461eaff02a0263446ae89f2cf4ad4,218,TRUE,2120,1902,Radiant
20223767aa1e23cad5b47dba53b5ac87,1407,FALSE,2332,925,Dire
94f03da1d49d98b1edfbf12c1f706461,682,FALSE,3269,2587,Radiant
8c4948411b8c6f7173bb9963879a263a,609,TRUE,1828,1219,Radiant
7b23b5e3396a873c39a13f877031d9d5,1806,TRUE,1940,134,
918280b9bcec2e6ec28b4d485173a925,2348,TRUE,3099,751,Radiant
70d73b1323c58b5c35843f13bd1a1a9f,1340,TRUE,1710,370,Radiant
e510bf2a455bc2d3d84b161e38555774,262,TRUE,3766,3504,Radiant
271a0ff459dc53756aeb80afab96694f,986,FALSE,2029,1043,
8cad60a455036f946802851b171fe5bf,1263,FALSE,2347,1084,Radiant
b6718c71b77c2e78aed028102094c19d,500,TRUE,1330,830,
34882ea2ee5f6a4d3806bbcc88a7da84,1055,FALSE,3090,2035,Radiant
5a1b10aade6b99aa5caecd6d12922220,437,FALSE,983,546,
7efeda4d52d1aa2f67bcd8570a9ddac6,491,TRUE,2646,2155,Radiant
46d14a4c65c92e501427256e0492276d,17,FALSE,2150,2133,Dire
8bb988b7108f16ef8db61f039d331714,2385,FALSE,2993,608,Dire
cad5f70a87f6636d935402afb3a8fe2f,161,FALSE,1719,1558,Dire
918ff6068742d42a99b1e76fad151b0b,274,FALSE,3434,3160,Dire
9c617ca8aa31a174ba369b8b66cb6102,845,TRUE,1878,1033,Radiant
f7cf50af938f0e02ff9f715032208161,517,TRUE,2696,2179,Dire
076d13b8c3fdf5a1a5ea451aefa09682,456,TRUE,3117,2661,Radiant
9bc2720cef88cdf6fd1c3657f1747360,1202,FALSE,2371,1169,Dire
90aad308d3468bc44a6afd046a5348f4,1050,FALSE,2376,1326,
9a8980f86ca1d26348893b7575176ff6,682,TRUE,1176,494,
cf65f8927c009acaf9e4ac283fc35594,2609,FALSE,2856,247,
b23b797a41af2fdaabc74b59c0075c60,445,FALSE,3021,2576,Dire
f7318c7a0bf709005a5ddefde945af04,1751,TRUE,1837,86,
36c9acc364f76d3ed3d00ec43027b444,510,FALSE,2476,1966,Dire
1e60d596085d72b3c71a7f49a1b12908,2387,TRUE,2578,191,
1ebb87b418dee37415f78dca2795c3fb,240,TRUE,1821,1581,Radiant
f2d0bb4bb6c60235a009a0e8643c86d7,1323,FALSE,2325,1002,Radiant
c5ed57d1bc92a0f8179b470fd7695be4,590,TRUE,1064,474,Radiant
82e6d95fc0f7cc9b85e4f99c2f8ff49d,348,TRUE,2348,2000,Radiant
81d93038a507ce8d739d095530de42b2,2076,FALSE,3358,1282,Dire
117c7c752e0190da082cf7542c2ebadf,912,FALSE,2205,1293,Dire
a188116e6787ce07c5c4e22f948ebf93,400,FALSE,1364,964,Dire
00dc29c7898736b44f81dbbd3ee485bb,542,TRUE,1107,565,Radiant
c91146c61449c57f219e3565b24639b3,965,FALSE,1697,732,Dire
642270c1f711f3e9ea61f422434b4456,1251,TRUE,3900,2649,Radiant
a0e065091fa524e49de89b48ead52ea7,595,TRUE,2942,2347,Radiant
9a5ec043c515391e09934c67d2a991c0,2987,TRUE,3396,409,
c9717f021bede5b52b2159b927f73b8a,1398,FALSE,2934,1536,Radiant
3b90021bcd08082115f40855bda06666,1505,TRUE,2863,1358,Dire
47dcb8bebf8cedce7f2d1f2bea203d6a,329,FALSE,1525,1196,
e74459f027069892a5ef0fa0aebade64,1179,TRUE,2084,905,Radiant
1ffac0dd792327bba94a5323e40b5b8e,1304,FALSE,2429,1125,
ac164f27234476941633a0832468a215,1030,TRUE,1743,713,Radiant
6244231b456b785d3bfd944ca9933eed,1694,FALSE,1758,64,
09446d1743dfff72929fceb265880b40,1688,TRUE,2551,863,Radiant
2fe91ae5ce4fa7638a38fd0d6983d515,66,FALSE,2343,2277,Dire
1c5683e12ce5fe5f27b1fcdcc6670872,1035,FALSE,2673,1638,Dire
9b470366810f19533514bf3d87c686c9,2111,FALSE,2339,228,
83b3221ac6ec52c8ed450ee3ed22c36f,1228,FALSE,1310,82,
8906f24f88b2c5ef392ba6f1cd1cf158,408,TRUE,2480,2072,
dd563ed3d972cb6a883b753740d5077d,422,FALSE,1890,1468,Dire
bf4cf96c1d8b58c6a459829e6b484d11,1384,TRUE,3105,1721,Radiant
67b5abee18da8d08ba40291397c0ec88,2420,FALSE,2992,572,Dire
bc2f0ab8759ff0327f753d3e8e73ea58,461,FALSE,2810,2349,Dire
a46ca52da4440660aea8741418ee9265,735,FALSE,2058,1323,
8028dad7ade6fd4a792c16f5fcd7707e,1395,TRUE,3392,1997,Dire
af654c15bd94bf53d8ec9b22e7d4f1e0,959,FALSE,2363,1404,Radiant
0c7557d3db7b0b101850cceb5c1630bb,681,TRUE,1560,879,
e819d3dda84056ea377b6a210fd19c8d,454,TRUE,2176,1722,Radiant
f523820ba119c63fc5f91b84b3d1d238,1454,TRUE,2503,1049,Radiant
298d566dc195a8f242b1a076c546f27c,1439,TRUE,2132,693,Radiant
f1a35398b2c69e4b2db962aef46a8ec6,2038,TRUE,2384,346,
1a62badc2bae0fecd68292c55db8e3b6,1624,FALSE,3141,1517,Dire
420ffba90f177f7e245ae2b948d8b305,2297,FALSE,3140,843,Dire
070b87251beae2a288d14d003aab47f4,324,FALSE,2640,2316,Radiant
2137edc821ff19fe1aa0ae324fe7bdac,409,FALSE,1909,1500,Dire
9d99359f018e6878b306c8a864df6b0e,1355,TRUE,2443,1088,Dire
378de12351f592ef5a66250998b69feb,461,TRUE,2032,1571,
559b6bb855ffce6670cf3070f4b7fb23,2778,TRUE,3030,252,
8332a2a25d7ed02c43d32bd7dc9be35b,1235,TRUE,1599,364,
c86a61c2cd9bbceb0d206f70f9a180ff,1663,TRUE,2920,1257,Radiant
33df8173b6d26fff187491bbb367cc34,520,FALSE,2949,2429,Dire
0a19820b3018ce4c6b10e10d7bc9437e,1213,FALSE,1669,456,Dire
e32e899b250b43a3af90d1bc3f2bbcb4,1481,FALSE,1703,222,
9999be49b2c764db0be2cb12298434ec,2490,FALSE,3076,586,Dire
8813c4a45eba7438e9de9b81e60b5b15,1371,TRUE,1975,604,Radiant
2eb0baa4f11dae0be4e8740a33d1a86d,2957,TRUE,3537,580,Dire
071c01b6b4de161d7ac4d14adf7b9711,885,FALSE,2825,1940,Radiant
660a0256a4d2a68bf5960d1bb48ab03a,1741,TRUE,1882,141,
2005ccb2a30836d96fcc37a5f94323b9,1495,FALSE,1872,377,
b5872af34df09f08c05e31ca2f1b1363,1611,FALSE,1808,197,
6da8e5452d67e5de3f9ae4f1b4a932b8,1666,TRUE,2244,578,
fa942d5e464c453cd798a901d92ea6d6,1107,FALSE,3375,2268,Dire
7d5359084204fab25c99a2245770cfba,1554,FALSE,2522,968,Dire
23260de604da50b8f8e9895469542499,606,TRUE,2250,1644,
c36864e8b3984af2f89f6cbb71dc7f42,991,FALSE,1549,558,
8f8ae005327559f1a83e6afb71ef1f5a,843,TRUE,1861,1018,
05b34e94116fd3b8338b7c3d0c27430f,2796,FALSE,3719,923,
37960b42db22d80650099a9634d45b6b,908,FALSE,2499,1591,Dire
a671b5461353dfad8e95e357cdde66b0,894,FALSE,2126,1232,Dire
44e92d2600434aa6ebe0a969e223a6cc,1716,FALSE,3934,2218,Dire
c60ebdb708de280673061641143550f3,1253,FALSE,2181,928,Dire
a86635d8a56d48fbc25e6d60bad05c39,1586,FALSE,2263,677,
e5e5f5a3bf51470334f5802ac92b3ed2,2188,TRUE,2407,219,
2272a0a465aa8d31b3e4cdd1d43462cf,1420,TRUE,2687,1267,Radiant
665cfa4e65386c72898318a2d270c0da,1368,FALSE,2035,667,Dire
26c373aa7c40cdcae02d0196584f2bb4,8,TRUE,1791,1783,Radiant
3093b7afa92608935eb19a12c3e310d7,1696,FALSE,2250,554,Dire
54e1b90cdd69eda21006a92788105c4f,514,TRUE,1926,1412,Radiant
b48d4464841583045862f3cde3088577,853,FALSE,1702,849,
789b5bed541e974ece83ccc058ef3263,2539,TRUE,2973,434,Radiant
ba91627be6f246cc8b58bd062025aa6f,919,FALSE,2692,1773,Dire
a02156f00c51891dc75b4c0170a019e1,133,FALSE,1761,1628,
9142b16c5d256db3baab5d6bd19a59cc,565,FALSE,1969,1404,
be05943e5e40d9ff9fcc903a8e7fbf73,1345,TRUE,3346,2001,Radiant
6aa6bcd0e2856390cbe547a923304074,404,TRUE,1912,1508,Radiant
8fe23b7b651660e27be31faf8513cec8,390,FALSE,1443,1053,
d42077bf02669c43576b90e75c227a8b,1646,FALSE,1944,298,
efc1ba9691734e60ab77c107995710e6,150,FALSE,2735,2585,Radiant
2aec2feb37027715cf54c66c317cb81e,74,FALSE,2535,2461,Radiant
d0ac621cd5bad618b6b42d77b29886dd,215,FALSE,1595,1380,
ec8dbb12b1b4697161320fec24692647,2433,TRUE,3254,821,Dire
54346fb907d2be47226f7d2d685e3a77,3114,TRUE,3807,693,Radiant
89de2c7f9d124aa5be4b89c17e80bf8b,318,TRUE,2547,2229,Radiant
8788ad7309132cbb0b22374696d3fe37,425,FALSE,2964,2539,Dire
6288c9f24d61820f24e9afe854f9c478,162,TRUE,1573,1411,
801c3d1583d46d770ef00870d7b3efa7,1129,FALSE,2494,1365,Dire
a522cde63685a3b35c1239435af50829,1732,TRUE,2291,559,
8a092b29af0c1a24452f73993400aada,182,TRUE,2091,1909,Radiant
98511349ad02e0a01193319c1df85c30,120,TRUE,1924,1804,
563db21a93b524ac504b386a060941b5,2476,TRUE,3011,535,Radiant
b39761e01799074adba4d8711be12262,1303,TRUE,1923,620,Radiant
9a20809a92d2b205a9329597e7e59839,170,TRUE,1376,1206,Radiant
87413571e20b0216be331955f539c4e8,651,FALSE,2047,1396,Dire
062d69a7bdd5fc2c88f15a5edcbd6583,2113,FALSE,2259,146,
699ca6b5d6e1a7bfb8f3301795976539,388,TRUE,2659,2271,Radiant
85439a4d41949481f508a6095051193e,804,FALSE,2841,2037,Dire
9101adf011e0c5268665d4838c382eaf,1235,FALSE,1579,344,
6691b37137e22f323e472f1e072b8952,2889,TRUE,3166,277,
b4c1b287d8b19fb438d0d7136fe18688,611,FALSE,3501,2890,Dire
97b86365706c77b45b1bedc8b57df84b,673,FALSE,1630,957,
21a5cfb690a617a64c5fc3f5e42b1926,2198,FALSE,3060,862,Dire
e3a09d7f316e2361a1befde50318f920,782,TRUE,997,215,
d503a89bfba29665cecbefed2a583a41,206,FALSE,3671,3465,Dire
b542e9d81298bd106907c0c5c686f846,1778,FALSE,2047,269,Dire
ebf0e62c6923fe3c7c62e84dd2d374da,319,FALSE,2681,2362,
dbc78f72136948de4f6fd64a7a91063e,1426,FALSE,2329,903,Dire
130d0f8ba2faca62d52fddb46e36a6aa,524,TRUE,1491,967,
657687a16e6bcd039ab77aa663b13c5c,1084,FALSE,1462,378,Dire
6c4d295925875fc00278500b3456d450,2371,TRUE,2637,266,
be7a43e69359132bf4b4f7edac06ec69,2381,TRUE,3064,683,
c83ad2965e14fed41d833a6d9dbcd0da,183,FALSE,2875,2692,Dire
12d6abae4887de78c1a268f3360b8645,104,TRUE,2277,2173,
51559cbc0495e5afeebe326f0ab73b19,1305,TRUE,2901,1596,Radiant
346c20236392a40bf7f969cbe16f5ffc,693,TRUE,2548,1855,Radiant
421db68eb6da1e3c7c35db9e9315e4e7,1056,TRUE,2755,1699,Radiant
9ef346f495c7c53a7c8a5fc8de44424b,922,FALSE,2484,1562,Dire
f98c21af79562fa03acf166b95b10d1b,1163,FALSE,1899,736,
f87f43f6bf3ee15dd5f3db69d25b7522,1846,TRUE,2019,173,Radiant
665c34bd739dc87b208dbe14178a19a0,2055,TRUE,2397,342,Radiant
5f133ab6ce458a6fe6bc95251cbca1f6,656,TRUE,1501,845,Radiant
5d667e4053b0fc60f560fe31d285cc9a,2499,FALSE,3078,579,Dire
c174d45cbce6023f11cf86301230aff9,1118,FALSE,1944,826,Dire
d7d45cdc672a8d21ea87e4f3c2061b5e,1180,TRUE,1672,492,
2e3d983e708236331bafc50d289d1350,932,TRUE,1805,873,
70802578faf1b148d580ff7c0a8ddda8,1766,TRUE,1820,54,
0becfdee7896ea89dace508a8b20cd5e,2376,TRUE,3005,629,Radiant
76fbb711fbb0ea5bcd73cdab6a04a700,293,TRUE,1876,1583,Radiant
2649cef9936eead607de51a22d48f36f,60,TRUE,3485,3425,Radiant
eb2925a79b95bdd1b52a69c4ce288c2e,1014,FALSE,2006,992,
2af44ec8285eda0a3e55d28afe8cae05,1336,TRUE,2265,929,Radiant
7275bf530b516be18f4f450f7c32edc5,222,TRUE,938,716,Radiant
e874175a64de521c893e16dcdff906a4,980,TRUE,1907,927,
6cea2a8a0f6c00895415a233126c8e2b,1261,TRUE,2187,926,
67fae0c3e1f27811d5f04d5a15ce548f,1821,TRUE,1951,130,
db14ba30176c049bad6dfc3df33d7798,1103,TRUE,1777,674,
a4bce1ac1f6c585c61c9987ce0c7ca83,696,FALSE,1498,802,Dire
b626582477d231ceb22218fd2b19ddd5,1542,FALSE,2502,960,Dire
fec3d0adc5b20861b19a8568773bf79a,1485,TRUE,2796,1311,Dire
d2740aa96f5e8091deaf725b611e562b,34,TRUE,2192,2158,Radiant
743503b117887f759eca992c11e7cf76,123,FALSE,2452,2329,Dire
58c10394760066a4547c2703acc00b1d,1210,TRUE,1808,598,Radiant
1d5833dc513dc155695d3c1408863fd0,850,FALSE,2004,1154,
6f2cafefbd73b4b47a319d8654d577af,849,TRUE,2226,1377,Radiant
0324a612d7ac26c8ab1a93d6ad994a3d,388,TRUE,3781,3393,Dire
89d7739703e8fe0a33239d31ecef55d3,639,FALSE,2627,1988,Radiant
b50e70fed450f5dd4353fdf3746cdd6c,2212,TRUE,2546,334,
5b2885f6685f9fba13568fe11c57fcae,911,TRUE,1074,163,
ed3725375eb25220637286c8a89cd2d4,448,TRUE,2351,1903,Radiant
445d98ec0e536d91361ab0cab16bce10,997,FALSE,1979,982,Dire
c656481bedf3c16ab08dde3172e14bb3,1763,TRUE,2762,999,Radiant
42eec2fb2b810502f7c0ba48395600e1,0,FALSE,2190,2190,Dire
cda915f5df21f6806d74904fc5545471,1356,TRUE,1590,234,
ab5d90725e57e9eb308a742aa8f7c01d,1208,TRUE,3203,1995,Dire
0046323db5cde76606f61f934b6f2ebe,786,TRUE,1336,550,
bd006e6c786216309f51ca417f66ac9b,32,TRUE,2089,2057,Radiant
5d4e10af988dd926aac226f4ac49afc7,1857,FALSE,2534,677,
a2233298fd9ecd54eb4f446232114b7e,561,FALSE,1410,849,
27b1519d16e2abb2e02aa68c9af4faca,2756,FALSE,3288,532,Radiant
5287825f2f75247e0bc64d6798824caf,552,FALSE,1545,993,
8b071be597622c8bdcc239d33521ff0d,2068,FALSE,2626,558,
b7b7c8f4278a38e58f8fedf72a58e9a4,371,TRUE,2811,2440,Dire
84dd7e5e86690bcf38aabfb647ff543e,301,TRUE,3027,2726,Radiant
5ebf0c05c8f5cfe24b29cad878ed2f88,696,TRUE,2624,1928,Radiant
a7af28dbc5eb291bb64ddf9810a4c09c,1733,TRUE,3076,1343,Dire
a6edc420e1ccbf59cac6496baab76729,777,FALSE,1713,936,
80feb82abbd75a35eadc133be9f3ed11,157,FALSE,1342,1185,
e75a521dc5ccba5a4f87ee32c7d2b833,1089,FALSE,3054,1965,Radiant
dd531ef363b6f35645e3cb125b42ce06,1225,FALSE,1874,649,
4a461876c6c40cc49bf040eba08882d4,1032,TRUE,2050,1018,Radiant
5b641f0d6d0ef7e13d70f363698e4604,2524,TRUE,2582,58,
b45d01774156edd75fb4f9d95d8bf7f0,667,FALSE,2842,2175,Radiant
c90288610665d7baea2e11150b7b1451,597,TRUE,1646,1049,
6ac80bd0fef6d11a33adaab3b1026ca0,500,FALSE,2483,1983,Dire
93e7b356e7ef1732219906b5971be921,92,TRUE,3070,2978,Radiant
552564ffb6d1d4c63819c34879951e4e,1169,TRUE,2227,1058,Radiant
0783481cc310e6eb73283556035ae01b,1992,TRUE,2115,123,
ebc7d27bf41400fcee08739210b8c901,1141,TRUE,2485,1344,Dire
3ab0c2a830fe2ce51a321a5152ccac92,2047,FALSE,2172,125,
c446c139c3da785e052406890bb5a0dd,217,TRUE,1776,1559,Radiant
45caeb96653cff79159940344d4a69bd,921,TRUE,2515,1594,Radiant
3ff2838809e1ea1b1d76ebca4eb034ed,242,TRUE,2109,1867,
19020a80c5100c1a4337b1d681edf4d2,1021,TRUE,2058,1037,Radiant
5552e330ad97a78c9977304543ec45d9,1821,FALSE,2104,283,
3db823a6556d7f2a0a0e368a66b9f03c,1487,FALSE,2848,1361,Radiant
7fedb3988f16a71ca54b590b1ef69693,1045,FALSE,2848,1803,Dire
8ee763c3cc845aef00813934466f64bf,1029,TRUE,1264,235,
fdce9450dff3137b3e8d64fa7c090b19,2190,TRUE,2408,218,Radiant
e124c21880c9bbaadc42efee82d27256,587,TRUE,1601,1014,Radiant
b166370ed99f7747abfc2b821f2aebf1,963,TRUE,1540,577,
4b235f63ca5fd8b4c814359abcb31676,202,TRUE,2434,2232,
81a1d4240f7e1ec8ae151985e71661b8,1267,FALSE,2488,1221,Dire
464dcb653a79bec1e1fa549a84ab66e2,2410,TRUE,2490,80,
aa54d56e51c02f6e8fcebf398aef6a1d,145,TRUE,1268,1123,
2b8a9cbb1c52fa5cf38ded6cf3f0b364,450,TRUE,2128,1678,Radiant
3a8e1ba2529d3cf652697d3deba8f37b,1607,TRUE,2461,854,
b52bb4dfe62b3b1b5cac843711174a95,830,FALSE,1556,726,
0b6fee8001b212ab4e45a2e58fa201fe,996,TRUE,2493,1497,Radiant
d75b3eba13e478c672b30044c40545bc,1602,TRUE,1696,94,
820e87ff31e8f4d54244b7d6a16c5d2b,1774,FALSE,3046,1272,Dire
515fef02d7391caf598e9d8f4b4d1b13,1195,TRUE,2847,1652,Dire
3c08bf7471cbee4c3a8944c792d3c928,1339,TRUE,2969,1630,Radiant
111229870b9fe4b9b4a26dbd4244a1cc,792,TRUE,1890,1098,
9d35912f0afb2ea03cd87738ccd9c950,1535,FALSE,1580,45,
3f1a6a63414caef01a0cb050412a74ff,841,FALSE,1492,651,Dire
8e5b32c90ed195081957cf30c5e24d67,678,TRUE,1746,1068,Radiant
30288b2d4bd835b038db2920ce98ea05,605,TRUE,1555,950,Radiant
fced174a788fd19f602d1a7b6d01e44c,491,FALSE,3192,2701,Dire
e2aaccb9f6cc7d7847e580c42ca960a1,2046,TRUE,2536,490,
82da4213a2ef7f67effb146ebd864709,179,FALSE,2739,2560,Dire
5b3222b2bdb1e420812846d19f5e6613,1441,FALSE,2875,1434,Dire
f8104270a51e402dbc4d1f070171f8ab,537,FALSE,2863,2326,
ccc67bf6dde36608ef20b138d5aefdb0,550,FALSE,3251,2701,Dire
d5c3153975fe5af47e71d8852720acdf,968,FALSE,1840,872,Radiant
e1a28ea982df4c89ec880bc570deee3c,1300,TRUE,2748,1448,Dire
ca01d97708196a162615bfebe9e2a9b8,1937,TRUE,2869,932,Dire
96ab4356ec05c695db35c984788755cd,972,TRUE,2958,1986,Radiant
1b0df3f519b03e1c739a7f9cdecae740,1857,TRUE,2911,1054,Dire
08a31746dd8b99fc6f959de6405e4cc3,2107,FALSE,2368,261,Dire
bd348259a538f9d79720deb5c92f5d71,15,TRUE,2521,2506,Radiant
2c58f7905486789b37c48c6627747490,54,TRUE,1838,1784,Dire
ae7a9f672d9fea15be9440c724021cf8,430,TRUE,1290,860,
1436a405a00b8bcf5b3d0f6992e045a8,1400,TRUE,2075,675,
10612245053b2f861866bdc21f3dd52d,367,FALSE,2924,2557,Radiant
1f406fdb3c5b114ea2bd693d2b659253,1610,TRUE,2968,1358,Dire
af8ffef6cdede38e73669dea756b6c4e,234,FALSE,2837,2603,Dire
17b2d4f480aa54c14182f67374b1ba60,189,TRUE,2754,2565,Radiant
fb309a7b77dc3095cec25fa58291384e,729,FALSE,2855,2126,Dire
ad0bcd7ede36b6d6328d3d66abf8ed98,570,FALSE,1446,876,
3519d480478a0dac3f6578a00af7ebf5,685,TRUE,1439,754,
f61ea0db076a88e10088609686bfc5fb,85,FALSE,1643,1558,Dire
212a8e01949647f55a400e85d3da92b0,740,FALSE,2008,1268,Dire
0526ef2ff0f2a685fa0d7f4562901c69,3269,FALSE,3607,338,
6c9296a37b7b5a1f784df79373932c84,1028,TRUE,1306,278,Radiant
ae8e9f0cb8886e1b2cd88f08f3adba50,788,FALSE,2830,2042,Radiant
c9122ffcae6544f8109420f8f820aa53,1952,TRUE,3013,1061,Radiant
1c49927ee8dc93986733c806f6fe84bd,2677,TRUE,2820,143,Radiant
e727af1186542368455f8a9f14c2b1b3,460,FALSE,2498,2038,Radiant
cb30e9067c3d9facd3d3485550406f2b,2225,TRUE,2788,563,Radiant
b4844d9b16cb991014ebb22b5cee1ca3,163,TRUE,1407,1244,
acc98b57406fe9e631511cbb97115b36,1235,TRUE,1544,309,
eae29482cf374330ad0c6f72fdded130,655,FALSE,1167,512,Dire
b69905a3925382aef99f19040337e725,432,FALSE,1968,1536,Radiant
526c09eaeacd3292efeb7d3289366038,1150,FALSE,2810,1660,Dire
4983f6ce1a64500bf8e766105040c071,1523,FALSE,1721,198,Dire
45f76fa07fe6facfe9f7f9a2369b138c,2478,TRUE,3393,915,Dire
ab5b56b6e1e7e610135bee7ee33c9134,324,TRUE,1002,678,Radiant
ba428c116c5e7af2d4b54cba0d245f8d,1433,FALSE,1670,237,Dire
d07fce5696342cbcbdf39b686270c618,906,TRUE,3249,2343,Dire
d13e3470b5a000443d57bc628d6961bf,2271,FALSE,2447,176,
86eb2ecd5b64a0e8265f0eac6af89a7c,928,TRUE,3182,2254,Radiant
272ee6ff4d7de8f6c9b61f3f3d39ae7d,585,FALSE,2679,2094,Dire
1a8502932dd4f2953036cde416b369eb,1350,FALSE,2375,1025,Dire
e026939300344a9d416a1f22cdf92d42,2903,FALSE,3515,612,Dire
19e2459f77b81d5dbce7e5b65e5b4f16,1667,TRUE,2052,385,
668b5e1cfaa9ebd4d414a1ecc73a83c8,1452,TRUE,2749,1297,Dire
ccddb42cc622fbab604c265233a3b6d7,84,FALSE,1962,1878,Dire
e8ad7502d68d9c296596e3ffddb1fc57,240,FALSE,1698,1458,Dire
cc40a7cb084dd718077b07da9c209019,445,FALSE,2207,1762,Dire
85c6178c70b08b9ec65d5cf2a53bdb33,3243,FALSE,3603,360,
3012b0c5aaf14b98e82452c00aeef098,1160,FALSE,2192,1032,Radiant
ee535756fee844a9c2841a1047225e5f,513,FALSE,2167,1654,
ff0b4c83919833b8c71ca22169ef5c2b,1589,TRUE,1882,293,
dcc11500802b7744d60da5f0f64e9960,813,TRUE,2975,2162,
b21b88766db12d9fbda69a82f74d25f3,435,FALSE,2584,2149,Radiant
e7e76e5c3fb478ef21e0e6608bc703a8,454,TRUE,1732,1278,
37e49014abfa82a803e75282e2084c3d,2126,FALSE,2460,334,
1a67648f08e3e612721168ac8b49101b,1951,FALSE,2428,477,Dire
9290fc993a8185d5225f070892ef7c16,509,FALSE,1713,1204,Dire
47b0a2ca765f78fe8890e05053fd73e4,2383,FALSE,2521,138,
515a165e96e694d96f946f469b451209,168,TRUE,1690,1522,Radiant
d33892ac3044e67039ae5c88af18d1d9,262,TRUE,1462,1200,Radiant
cfee6c5ee7bcb451beceec8e032f7e60,1682,TRUE,1895,213,
b2a0edb77bfb656bc7d470b0fcc3b7d4,1008,FALSE,3401,2393,Dire
3e1315ca00df1d436f3588671071f2de,870,TRUE,1718,848,
a8304c39b2b1dacdca2406cc4bf25995,26,FALSE,2144,2118,Dire
0bb3b47c899511d2cf38856b26bb8368,1416,TRUE,2225,809,Radiant
48a88c73f1f80f357dbeba48ded49cf3,1690,TRUE,2655,965,Radiant
1d2b6f328a5abd68e694742a0d07939a,557,TRUE,2212,1655,Dire
7a1a70c7b03d28505e31ea386e476037,1005,FALSE,2617,1612,Radiant
908ac02fe2f0843055948813b69157a7,1581,TRUE,1929,348,Radiant
e2b4f92d2b7328d965871266b079580b,1491,TRUE,3077,1586,Dire
45e9c8215f77f8e8f0496d3a2fe6fc01,360,TRUE,1292,932,
d71995a154a36c5c65c1c2f7c6e1fa65,1508,TRUE,3094,1586,Dire
7de47913cedec50354e1415a63f5bba2,2317,FALSE,2630,313,
be9d13fcf3b6ca97755a9afc7270b285,1714,TRUE,2768,1054,Radiant
acb94088908221fea5e9888eb2a96101,641,FALSE,1714,1073,Dire
810c61b4c8e92f0b7ee30a1d101df2f3,291,FALSE,2033,1742,Dire
908f1938117d36e932ff7406725e47d4,62,FALSE,2388,2326,Dire
9b520235a85669203eb829270a4845de,203,FALSE,2322,2119,Dire
14de17a2d49d6b1d2b6671409640d412,932,TRUE,2274,1342,Dire
9b310a860b5cc062a63a35bd0b11ac15,762,TRUE,2337,1575,Radiant
dcb9dbfd517a65a29b460d7740514c6c,411,TRUE,1092,681,
9a96798b4e7843041096db5620aa9fbc,2021,TRUE,2180,159,
0a9dd473efeca7b779ca8e272b35c32f,2100,FALSE,3155,1055,
fd5f973da4ac09106fe68892cae3b01b,371,FALSE,2604,2233,Radiant
d59688bcbf5b41e3ef6d62f2549399d3,739,FALSE,2227,1488,Dire
62d873a1e1605facafddb85304d1d3b2,672,TRUE,2068,1396,
6f00cd88dd7abd2da8012e81da0be194,755,FALSE,1540,785,
b1e1a9f207a3acf30d4746c96cf9fa7f,383,FALSE,1636,1253,
f3a08fcf3da88721ab11cfc2aacf3400,863,TRUE,3703,2840,Dire
ed720ad754f75b1ed40eb66d6a5d6e91,1740,TRUE,2362,622,Radiant
ea85960aa5631762a4724c6547fd0fcc,841,FALSE,1357,516,Dire
763897d9002d3d928af26a60efd2ccad,1975,FALSE,2471,496,
03ab003a30c0aab81c7713d4dddb447f,1072,FALSE,2061,989,
e2327be1f7b6e3274eefba8672a4e5db,1860,FALSE,2839,979,Radiant
a379b3224af1754d5da0b4e325fc37f8,1451,FALSE,2200,749,Radiant
d74cb477303a68c18ddcbdb3b6d34233,951,TRUE,1348,397,Radiant
a0273b38c8b9615337072f9b5b9cbf8b,384,FALSE,1497,1113,
c63d561d32282ed81df4aa938f756d33,841,FALSE,3458,2617,Radiant
ef715d163903400be730f41242657e22,2865,TRUE,3079,214,
dfba4debd39db77ef8a1146b442d3a54,939,TRUE,1410,471,
15bbc721518b84788f2da0a0acc0f529,2646,TRUE,2950,304,Radiant
69f8991d4f45acbb118edf41a877567d,1263,FALSE,2821,1558,Radiant
3795cd13605e63b2c42f63a81834ae83,756,TRUE,2617,1861,Dire
ac5690a8433a56d6e02ca2b1ffc80b48,2335,FALSE,2403,68,
8a752da60ba906b56fd2ca0fd0109748,404,TRUE,1885,1481,Radiant
c1f55e7895a7b00261af32079cebee02,87,TRUE,4675,4588,Radiant
fe0f414005e6f3efa3259cab04f8a3d5,64,TRUE,1712,1648,Radiant
abd5cf5ad3300811540e7d8b82b6d01a,1896,TRUE,2161,265,
411a9966f790dd7e6605fa1dccbe797d,157,TRUE,3299,3142,Radiant
5f4e0aa781d780cda095b7c988f25b98,298,TRUE,2235,1937,Radiant
c9eaaa3033e838f3184068250fce4192,683,TRUE,1738,1055,
c97d05ee62b90369c1c16e9a0137a026,1478,FALSE,1654,176,
d49eaa6754c03fa978e792ee7ea9f61b,1103,TRUE,1350,247,
5919b89b414157c0ad30609d8d7cb496,25,FALSE,2249,2224,Dire
be358112bb306b2d597bac01399ee0a5,1415,FALSE,2081,666,Dire
7020509cef0b3652449a9739a1579b6c,2088,FALSE,2764,676,Dire
bf0cf374f95dcf5f90dcbf2131a00e6a,1086,FALSE,3210,2124,Radiant
df1ac811361d831cffef060580697a97,1031,FALSE,2561,1530,Radiant
d388a99c9e84f075a061c07963ec9212,7,TRUE,2227,2220,Radiant
83901795ba89afccf47558f7ebb903ec,3,FALSE,1983,1980,
d08c3198a48b6712dca696ca75c4add1,1259,TRUE,4386,3127,Radiant
7214b60891a5c35a8ad0b9b8e988a5b8,1523,FALSE,2165,642,
6b5ef5e0e9f5436e0a144d58080881c3,344,TRUE,1646,1302,
67045c46fdca9dafb02b81df93cdc559,1814,TRUE,1854,40,
94f596b9c30c4b92af923759b762827a,1807,TRUE,2083,276,
ae7217ab4125593a16dceaf01d3eaf01,1079,TRUE,1955,876,
fdef8c84392d4f53ca7feb7a6ac20994,2252,FALSE,2506,254,
1199b08f0dc5d910b29eda159ecffd80,1409,FALSE,2290,881,
89758f6d1725561a69039ab79a932d53,601,FALSE,3845,3244,Radiant
b8cad16df29d5bcb552a20118283dd6f,1423,TRUE,2328,905,Radiant
a1a9789941068ecb8b6fd51a6187c30f,1039,FALSE,3071,2032,Dire
2ce2640d1e6341a4b6313619420cef71,692,TRUE,3547,2855,Dire
48f95a360df06329de42b3d2deabb596,1618,TRUE,2771,1153,
0b4ea410d2b07a97a7f3b962568038d7,2038,FALSE,2479,441,
aaebfe1523de15c6cf8f9c5e9de9af5d,1264,FALSE,1298,34,
65acfe7ce761f8ef49b06653cc2368b2,1251,FALSE,1347,96,
2ee29a5bfcad71beddd4f1de9d56fa74,956,FALSE,2318,1362,Dire
a137bdff4cab76064bde64f72e958be7,1219,TRUE,1926,707,Radiant
a28c182bd5bfc13402b7126999f82b83,64,TRUE,2135,2071,
491fd37076362ca7ceab99181c8b1fe4,862,FALSE,3472,2610,Radiant
8ac91d77391763b189891816dd39712d,2148,TRUE,3065,917,Radiant
a9f359924a2bbc30e030421e84db9083,683,FALSE,1704,1021,
350458e1d0a48bbe450d2a94e99c3190,158,FALSE,2460,2302,Dire
b95c5cd8e094d9b8d1d989f8960646b7,3,TRUE,2453,2450,Radiant
9e6d6780fda406290c73c3de4d9b8c1e,2054,TRUE,2451,397,
112d27b64e13b42e9771f7ccd7b02c6d,870,FALSE,1304,434,
409122d865c9de4fcd90081af11b8cd7,1820,FALSE,2399,579,Dire
3a7438f0dae7ef35ccf65cd4ce942390,1857,FALSE,2117,260,Dire
f643416e3e0fb5a1ac327e90749c6046,1326,TRUE,1728,402,
8b8cb9a6ce4c724bfcdd6d3b4e33cd65,573,TRUE,2467,1894,Radiant
6ee8500264226c308c2b82acb9cbcde7,2428,FALSE,2689,261,
b2d9db81cf7e72e27d1cd66f53696d16,969,FALSE,2107,1138,Dire
7836f210049fd73e6c415bcd23c3bd7b,609,TRUE,1972,1363,Radiant
a5c3fd67b5f881b84b0c4570505db6cc,209,FALSE,1330,1121,
2f2dda4db3e93ed95ad4f2672c088132,449,FALSE,926,477,
45319972f90f792de8194922e27521d3,2577,FALSE,2764,187,
42283faaf0fe1ab261815fbdc52b37aa,2462,TRUE,3207,745,Radiant
2f5e0999d2b0b270e8ea35def1835f67,99,TRUE,2340,2241,Radiant
e552ee9b0feb3c29c85558df2d014328,2224,FALSE,2439,215,Dire
9df6f106d2bcc6b3a858d5c80b568d68,1769,TRUE,2306,537,Radiant
d9dfce63f9a23dc5c2e63b54f3263ee4,618,TRUE,2340,1722,Radiant
0d11ce89b76005730ce33ed7c8eec20e,463,TRUE,1537,1074,Radiant
d4f978f6739cad09f61a7c3a62a52c18,1161,TRUE,1771,610,
85bb8535a3e55b5fc573bc52efbd6f27,1073,FALSE,2511,1438,
8d3b26cec8475cc16f83251f7a7bf173,209,FALSE,2347,2138,
981403bc7d41824d8a702860a7d72fbb,3391,FALSE,3854,463,
8483883acaebd8feacacaf2329857007,529,FALSE,2432,1903,
f31e129f7f941b04ae40654e9bb3e7a7,470,FALSE,2064,1594,Dire
6732924248374bed56b05a5fc6b2580a,436,FALSE,2517,2081,Radiant
6b3ecbac4f2bf4eeabb7026f79faae6f,40,TRUE,1920,1880,Radiant
7478c2a5ca7315eab602ae6f2011f8e4,900,FALSE,2232,1332,Dire
2965aa9ebece0bc8fdeba1c67c31564f,1334,TRUE,2085,751,Radiant
bb8b311110c6b5868a70a0320f5f9afd,1267,FALSE,2027,760,Dire
1112b3e36eeabcc6376c182bc6b5b85b,1435,FALSE,2802,1367,Radiant
390e6825ea19024b0efabd2e76890241,12,FALSE,3093,3081,Dire
477fac37cdba54743dfa2d7e2b94d147,340,TRUE,2530,2190,Dire
a6f761266b8bfa978037a1f6c43778c2,204,FALSE,1040,836,
7c5ad33e9f5a759f795e724a9540224a,1024,FALSE,2786,1762,Radiant
13dc5ed48f463492563b7dda9115e9e2,1161,FALSE,1307,146,
6ccd43693011dd900a54a729047d6a02,3082,FALSE,3364,282,
b4da65dd26940ee1b606fb6d485ed464,2482,FALSE,2585,103,
33a1d7f3ea60447a557db06bdf272934,417,FALSE,2575,2158,Dire
cc4f1268cb551cddc824b6606a6e96a3,873,FALSE,2055,1182,
2fc10730268cc9d0ef5beeb794af92f5,821,FALSE,2654,1833,
0e60ace89981960f707c529205aa0f51,1003,TRUE,2960,1957,Radiant
b80215643d8b7447f2e9dc6c4a6ccd33,2781,TRUE,3397,616,Dire
5a9b32552ac58c062fc8e175d190d73a,998,FALSE,2609,1611,Dire
324124c573444fe2648221193a8bc9c9,2427,FALSE,2721,294,
28ec5775c4e97c67529219f9574fc2ae,1052,TRUE,2014,962,
1530a3a29aca6194cb29839a5673af4c,2407,TRUE,2609,202,
896d12f7161e5f344596e906550e5ee7,862,FALSE,1732,870,Dire
82f99aa84b4752a688a890201a2551fa,585,FALSE,2085,1500,Dire
49adf82c135658a5517f847a42403174,105,TRUE,1882,1777,Radiant
686fe37e853f0ba5d763778c4175d3c7,1543,FALSE,3023,1480,Dire
814b6f1165934274b910b330a1113390,1594,FALSE,1668,74,
7587b1c8c8550301e7fb1675a9b5b129,1873,FALSE,3217,1344,Radiant
cf443396d66871f9f5bcef51d9e845f2,3037,TRUE,3454,417,
6882be11a9074bb78c4ee509db04af92,711,TRUE,2009,1298,Radiant
2c9e6aa279e5fd9f5089e7961485d9a7,98,TRUE,1896,1798,Radiant
33af45e507b02084b3698f6d314db52c,1610,TRUE,2655,1045,Radiant
09675133e394bd5804dd0f62b69dc03f,1278,FALSE,2803,1525,Dire
a3040680973a44bf258388e4c841af4b,344,FALSE,914,570,
11d1cb98873fdf40763856e24bcd421b,918,TRUE,3525,2607,Dire
298ee8d789fd4e06ca4b5301a173828f,599,FALSE,2398,1799,Dire
0dde9be7c701ba8b634dc59dcb7d5bcc,1451,TRUE,1862,411,
b2d4f8010c6ddb184b2512e4cf52045c,1779,TRUE,1910,131,Radiant
4dfe5bc608e91a6a0d0cad4be65be65d,1839,TRUE,2501,662,
6d91122e86b029ce1a00a202e2b9e0dd,1425,TRUE,1907,482,
19cd7d84f7cf9d605c8172e12f3f8311,2991,FALSE,3407,416,Dire
b14887e640de377bf1033528df75f6b9,1019,TRUE,2173,1154,Radiant
84403a3d99844978ccc09c89ebe29b42,1718,TRUE,2425,707,Radiant
30e05076c412640583b0f21b1f72c38c,581,FALSE,2342,1761,Dire
3794d999cbe4697edaa8e8daa4c20fcd,99,TRUE,1615,1516,Radiant
16e4d90dd6b056cb8dc24972271cef78,642,TRUE,2704,2062,Dire
638775b02788f31380ac1fb142414642,116,FALSE,2122,2006,Radiant
fc203035e19e8e7d22fc1008c142ddce,139,TRUE,1857,1718,
04fbcd21cf164ca9c1a5551e45ef07b6,901,TRUE,1177,276,Radiant
e6948b035ad528a2bcd94090b4ec3709,655,FALSE,1773,1118,Dire
7232f852621ac6e51c0c3eb1d18e2e17,163,TRUE,1674,1511,
20c9ad7fb996778dca5ecb54c9e1f7f4,2574,TRUE,2668,94,
61689d7253076b88465c327d26e74cf5,798,FALSE,1606,808,Dire
f35c0bcde0195f5197492ee40e721183,584,TRUE,1666,1082,Radiant
337767013b8cec3fc98af33447706245,882,TRUE,2376,1494,Radiant
a81d10dadb8bd4afc5271db4a661a839,1453,FALSE,1919,466,
c8574467838c90fe8e24d0bddc527555,1613,TRUE,2184,571,
a8f0c6e32537082d72d756501c5cf4ed,2049,FALSE,2983,934,Dire
86503a5973ff7c7c9edf9c3184a12b14,2492,FALSE,2777,285,
f70ab9f8d540bf12d1c45f48e68557de,176,TRUE,1871,1695,Radiant
d3c37c327744072263c1369ee9e5abb0,2,FALSE,1463,1461,Radiant
1b6e37329fd99f1ad189d3ad8c14951b,976,TRUE,2021,1045,Dire
6b5b1d033cabdb8b6dcee2a03176bd16,614,TRUE,1971,1357,Radiant
7bd92fa2919bd89cbd55137f0a70d9a3,1251,TRUE,2706,1455,Radiant
3065cdad8d94ab21892e9e4532f9701b,67,FALSE,2468,2401,Dire
a9ee8034281145265630bb67e0aa27d3,693,TRUE,2213,1520,Radiant
20c43c9484bb5ab2fa0a8e038b0ff613,1267,TRUE,1622,355,Dire
bd55c2902f49bb16bf6451378ba36d12,563,FALSE,1685,1122,
88561342860a377b4a48d19392e73115,1075,FALSE,2930,1855,Dire
dd768240e6c845123ac20ffdfa12f355,1256,FALSE,3059,1803,Dire
1b8119bc334f2e32983b448e6e8947c5,362,FALSE,2756,2394,Radiant
5aa9a80044e16a12f9297a87f3d99086,354,FALSE,2003,1649,
a9bc87318313619f423fc1e392215c27,393,TRUE,2626,2233,Radiant
4406fb833f21dce6564f3c2b246a1a90,1972,TRUE,3781,1809,Radiant
2c755197323d4187332cb39398059b37,1308,FALSE,1893,585,Dire
3975d18ed0411db3c4ff87f35d8e386d,1023,FALSE,1664,641,Dire
625c222d6e12c58dc5bdf8a018abaa1c,1784,TRUE,2487,703,Dire
2a603078c96c5615debfae275dc374ff,1428,TRUE,1983,555,
924be70f27312923c1d9cb8343b4fbbd,11,TRUE,1981,1970,Radiant
5fa2f33cf76f335d0086cbb82c72a655,1630,TRUE,2030,400,Radiant
1fa1461127299e108eccfebfc0ef4749,594,TRUE,1679,1085,
f458deeaa08710aaa98e6691568f818d,461,FALSE,2486,2025,Radiant
314498ca86b495e6fa3b91e228b1830f,2149,TRUE,2766,617,
7e3cbb7e8b9381c0fecd8b0cd951ff16,2136,FALSE,2992,856,Radiant
b44237e1bafa9da2b0584dea78df4527,805,TRUE,1439,634,
a519feb190101cc24835e7cc784e0358,1143,FALSE,2983,1840,Dire
76025094c9096d5ac54a6c91d61d2dcb,1341,TRUE,2368,1027,Dire
bf9c643c76975b080142096a77fb58fe,562,FALSE,1474,912,
a84c37d50c21ab7523f6340d89cdda31,1843,TRUE,3565,1722,Dire
8b7aeb216abda586c90f223f2d1586ee,229,FALSE,1707,1478,Dire
0770c5c37cbda6a718f46ab64d7a70a4,2120,TRUE,2151,31,
75e243f1aae4338c9dced74c64de5973,84,TRUE,3410,3326,Dire
af473cf15432655a3261bfbcebb49f05,909,TRUE,1591,682,
10cc1db46e3d8204cb497544568a5740,2868,TRUE,3394,526,
a6a86dd042a9a40f4e4406152b655605,81,TRUE,1400,1319,
9b146c8c2d72bb24e0e849344e04d1b9,2104,TRUE,2715,611,
95586a3fd60f0e5a8716221375f7f789,944,FALSE,1945,1001,Dire
f8b3cf1a4d5ea92891e6fb2ff832ab8a,1564,FALSE,3651,2087,Dire
f7c04fa48a666949d8f82226a87ec719,226,TRUE,1998,1772,
6ad84dfe27c62596eaf2364c01da1c35,1478,TRUE,1765,287,
f5a91ef2e96c6bd5d529cab05637229d,811,TRUE,1024,213,
1bf5a7eef527be8a53f5d93dfb749919,172,FALSE,3120,2948,Dire
1459929c2855343ac36b302281f0c9b4,1974,FALSE,3452,1478,Radiant
bcfb77c55660fb05feb649ffc1d803e5,1005,FALSE,3435,2430,Dire
88fa859d32fc7375da7f128f3a49c30f,587,TRUE,903,316,
602ac84b8922ca2c1ce5733b60ef4f70,511,FALSE,1767,1256,Dire
75509a10121b8f8be247a1ce0c1d6115,767,TRUE,1999,1232,Radiant
9fab27b54a7ee63983e3602833839460,1035,FALSE,2155,1120,Dire
fbc180303bfed3424a861d9dae8efa26,1534,TRUE,3534,2000,Dire
899763529c94946b03025d9ada35a2a4,221,TRUE,2289,2068,Radiant
a0b2d99fe52e2ef5d75104da40b90d45,1871,TRUE,2261,390,Radiant
72cfa9c6b1a61b60844345ff750dc76c,150,TRUE,1772,1622,Dire
6fdc0c7aa1dd7eaf3f63a1e979b9d555,1254,FALSE,3414,2160,Dire
8f603a23757b4d75fa0c52080fb0e8a1,708,TRUE,1515,807,
1cf84afb4d619d4f02009e5d6390d7ae,1697,FALSE,2549,852,Dire
97a3123e1d4b5c981a9d47e4e447a2b4,1406,FALSE,1522,116,
4b193794ffd2b720e209bd0e4cebef38,108,FALSE,2441,2333,Radiant
a5cb65cc722b22c2296c886ee2759be4,700,TRUE,1362,662,
db6c160e94d341fb4c5455c48a0031f4,1206,FALSE,2459,1253,Dire
e3c0562beb8ff29d31e718229e13b27d,1175,FALSE,2187,1012,Radiant
331a94cb0767470728582078b518a2a3,1166,FALSE,2698,1532,Dire
77099a89828d152a56eee5f0f207ad83,1054,FALSE,2909,1855,
061250fa758cb5d26a5a6cbae57a9a21,1602,TRUE,2818,1216,Radiant
fd550495caf80ff339b8d41e46612714,361,FALSE,1909,1548,
fecc7dd425bed832f92c104f438bd17b,497,TRUE,2238,1741,Radiant
5a6bc242fc6fa6c898d993952c1c581b,2439,FALSE,2962,523,Radiant
242dcb129c9d85fc86d3c8ecaf9f0081,126,TRUE,1268,1142,
1011d4c0cc65966b3832f05aa08cc701,235,FALSE,2039,1804,Radiant
0cb47d0cad362b1ae531e277fe261151,472,TRUE,1290,818,
dbf7cb523a6126c058b7ebf96e74b406,697,TRUE,2335,1638,Radiant
b2ad05f5a0ffe84111e5c12508009201,1521,FALSE,1588,67,
96f47d6b2bbd0e997d0c15092fb3aa7d,1586,TRUE,2634,1048,Radiant
116083fa0ffcd4496f3d6eba4242e837,1573,TRUE,2007,434,Dire
b3f4ce3e63973c1bfe40b788ed5645ab,510,FALSE,1907,1397,Dire
ca4a848c99a55ce8e8b208213637be2b,3,TRUE,3090,3087,Radiant
9f1ce6735f8f421be4183cf3f553f522,1066,TRUE,1656,590,
443545671739a25286bc7b85772f66ae,841,FALSE,3377,2536,Dire
c7cf53407f547e47ebf14e96490747f4,278,FALSE,1584,1306,Dire
abdb0afa7919876dd2d4e5bc7200cb99,4574,TRUE,4795,221,
6955804fa2a0920d287f9ddfd895c750,735,TRUE,1439,704,Radiant
e3bc7e1139fcb93a0da613ca05056937,754,FALSE,2150,1396,Dire
982d0c16fdf8483441a29b1f154012cf,165,FALSE,1286,1121,
9ef21f755441459777c6785b0e5e0e49,1375,TRUE,3894,2519,Dire
e46e01a405175d0bec8f74160166a10b,891,FALSE,1189,298,
8346e7ac6b5bcc1cd81aa86009621392,529,TRUE,1358,829,Radiant
fc73c346da41ccd5b0a8b75a9f6aa2a4,24,FALSE,2107,2083,Dire
e73b7c4fdd708ec2fb089d792f4e789d,1888,TRUE,2806,918,Dire
a13700125dcfbba722b57bc4ffc3bf43,530,FALSE,1538,1008,
a028787336af78e6e7141daf7c11510e,593,FALSE,2151,1558,Dire
11be8e6abd1ecd46cb69d3d7d4dec120,1078,TRUE,1617,539,Radiant
23b5a6c20393c4119e028ccc67857cce,1458,TRUE,2113,655,Radiant
225786af01274e798940f3136c037b7b,1252,TRUE,2407,1155,Radiant
a2b134b16f3b1b1b04e5661fa0fa793e,668,TRUE,2570,1902,Dire
52b41f7b83755b4a822a1f4cb0d7e3a1,1109,FALSE,2248,1139,
f49b06f1b59db7fa162d59190df254dc,82,TRUE,1732,1650,
b94b8b5b0de88432dd35808e1ec54bb8,574,TRUE,1239,665,Radiant
46c07b2de75fc2b0ef6894034179faee,142,FALSE,2660,2518,Dire
96b14f3eeaa3e2a7110ecfffb33ef949,830,FALSE,2649,1819,Radiant
0b9ae00dfd366081fb54aee2be684b4d,2101,TRUE,3398,1297,Dire
71a82ea2d24a679a7d3607cb61ba9d1e,1128,TRUE,2592,1464,Radiant
bdca7778ffe863659c96f0dcb523ab83,1095,FALSE,2450,1355,Dire
1e3f63f4b3fceac2b49967b318f6bd87,1276,FALSE,1880,604,
da2213d765e15b136e0bd369ab66039b,1050,TRUE,2742,1692,Dire
edf5f1835c04854f5a8d45bf5218e247,1887,TRUE,2339,452,Radiant
95355b62f459a9c8490492b14bdd108f,1417,FALSE,2637,1220,Dire
26e9113522abd1ba7cc2746ff071da8a,942,TRUE,2221,1279,Radiant
42ec7635b52cd39f17035176a1b64027,114,FALSE,1551,1437,
3b024e0e802c0ff85d8a6610d5790c36,2009,TRUE,2605,596,Radiant
cd7b30713349cff71240f5e23e23d540,1701,TRUE,2212,511,
80191e4e586629a1dc9709e0fed43174,8,TRUE,4586,4578,Radiant
e7fc4ad079ef4521d55cf11439a8a913,1838,TRUE,3246,1408,Radiant
aece379f0824fc95edd79eb41bdd2e8d,898,FALSE,1674,776,Dire
3769af729f03199a2c91bba0f98bba1d,1612,TRUE,1693,81,Radiant
1dde2caafd431bab7a27b9004b3d54a4,446,FALSE,1841,1395,Dire
3cff87ef2265fd5bbc1bdc524924f077,1880,TRUE,3465,1585,Radiant
5a2646482b61f903db62704c9b369cd7,2202,TRUE,2733,531,Radiant
82909418e2befcb7e050a930dcfd4822,783,TRUE,2062,1279,Radiant
d5afafb3a4caa9102d2dc555747d299d,465,TRUE,2716,2251,
2311fe722d73bac7a35a5f9d3fc0c735,991,FALSE,2307,1316,Dire
81b4f95b5cc7a9257ecc48ee9389420b,1387,FALSE,2851,1464,Dire
956039d77307ffe5dc6ea366fd6d2653,689,FALSE,1607,918,Dire
743a48f4714939ca477803c1ce8fbe3c,340,TRUE,1816,1476,
cde092779df513618225bb892f2e6b28,1134,FALSE,2427,1293,Dire
bdcab69c4a18a88e26c317e239e058ac,1624,TRUE,3288,1664,Dire
a904fde7e422b5d8beebe68d2b058cef,1363,FALSE,2459,1096,Dire
ada38c8cb9b655d24d83fdfd156cfa9b,1235,TRUE,1779,544,
1525df91f00b76c2f2ce15e06e873442,554,TRUE,2556,2002,Dire
076fee04dc6098a3e9631783eb198882,297,FALSE,1896,1599,
c12ab4846ba029f020fc5e706c4a1068,1061,FALSE,2780,1719,Radiant
db0ee7a04b719bcc9c8494a9919b190f,26,TRUE,3394,3368,Radiant
b582dc1a9b9260834575822f04e410ce,537,TRUE,3560,3023,Dire
4bf7cc81c627d73f9c8637679d27ac5a,357,TRUE,1889,1532,Radiant
e2d2b0f07dcd1ac3fdfbcc34e0ea0466,1199,FALSE,2315,1116,Radiant
706003fdb58b00a2192104838b05a098,1949,FALSE,4257,2308,Radiant
6537ecd855f07308451ff0c4233fe578,425,FALSE,2220,1795,Dire
8151c1ec3d48b1f5e3a65eae8ad3bf72,1727,FALSE,2265,538,
2b32e19ad2968ac3a53f674e8da3f6a2,929,FALSE,3019,2090,Dire
5b3d02387054f0648f7349e230d56d48,2381,TRUE,2632,251,Radiant
6286942474327ea6d87abc258607c243,1678,TRUE,2039,361,
6796ad6545b0e3cfd8920648b5d933d2,801,TRUE,2047,1246,Radiant
5fe2728e37384c0966ec54a117a0c339,1131,TRUE,1870,739,Radiant
55a30526a6ffc6b66333cdc3a8dd4aa8,518,TRUE,2319,1801,Radiant
d28c88f19223156eac5fb9a914d62bbc,52,TRUE,2068,2016,Radiant
5c0df40342c466343f2990d8ec5737b7,1063,TRUE,1387,324,
126bc5a8d17c5edec9756dc0973cd87b,339,TRUE,1221,882,Radiant
7f5fd64df5d6702b32e7acec88992ebe,2059,FALSE,2864,805,
047fa130ddbc4abd779bf43984f15a91,726,FALSE,2662,1936,
cad517965d0d10bab0a247a98e3b4094,190,FALSE,2027,1837,Dire
57eb0762af0102c598f25b4d6c2cb1fc,1544,TRUE,2309,765,
56ce96c2b9427c946d6d0e692f3e5f44,890,FALSE,2833,1943,Dire
8ba876d5137f1988af10f847c7799626,423,TRUE,1862,1439,Radiant
a5f9b83a4b2b1c3b302c59f4e03e38a0,1350,TRUE,2110,760,
ba5a18a1d2bf82b4ffccd7b01fe39646,2500,TRUE,2542,42,
01acb95833e43c4b215e88a306533e92,1898,TRUE,2324,426,
211b7b44d4d501f375c644e2e7f3f7c7,145,TRUE,1228,1083,
198c2f882dadc854e3ef163dea2b8e1e,126,TRUE,1953,1827,Radiant
f3d679b5483ea54a8097475908a85b58,641,TRUE,1773,1132,
d4b0df7f7c22369471c58c5cc0921c02,1354,TRUE,2000,646,
2b73c42695f5e40fb871d5a52e26ea0a,889,FALSE,1957,1068,Dire
fd5de6a2f6494dccfa8bac1debb9b58e,9,FALSE,2692,2683,Radiant
d201d1bd1903deba250aba50b8d4737c,1497,FALSE,2516,1019,Dire
fab6a4653003fa7d9040bc9e61b91642,746,TRUE,2826,2080,Radiant
8f3d4391ec330d808ecc2e7f6ebb9412,196,TRUE,1625,1429,Radiant
957625b3923aa158619cfa5a35187513,457,TRUE,1466,1009,
79e2f16e31811ba57770a56d30504d9b,753,TRUE,1155,402,Radiant
7d0bafd913f844fcb77b394e67d442f3,99,FALSE,1675,1576,Dire
f5da1736819f450a7a60b506c6ef19b8,1433,FALSE,1534,101,
ed5171e4c8471f07bf9cf269d325dccf,1424,TRUE,1817,393,Radiant
988baf7ffd617636cc5d140a846b6f63,821,TRUE,1187,366,
1920d16799bc03c3c4553dd4f9a58914,1825,FALSE,1919,94,
ec176c2910473138731e97ee48165472,2607,TRUE,3558,951,Radiant
95eba8ba92e273729eb4ca581d694634,1699,TRUE,3203,1504,Dire
c95699ef089ffc67a75dab934280ff69,528,FALSE,1880,1352,Dire
6f9015d3a34072a13fd0699a5349b51a,901,FALSE,1126,225,
f7a6fbb2a24d37680a408f39fdea8b04,1876,FALSE,3100,1224,Dire
bc287d18d9fd57db39e644ebea60d975,396,FALSE,2204,1808,Dire
fdbc89b7d99d901a429a3f3c0f9d22af,2209,TRUE,2541,332,
96fa19e420d2a6cef4d8a1ba7bf8add3,1756,TRUE,1803,47,
d6018b3f27bd3521050c24e0c4b68a85,555,TRUE,3046,2491,
d8fc13e3a276282e825e2067fe7ced6b,542,TRUE,1958,1416,
7b6e88ff072196b207979741e4f7426c,2513,TRUE,3047,534,
b3a45a54fe75ff47e4e2b68e36574c99,2693,TRUE,3228,535,Radiant
a18ba121916dbe98e2c51b501ae0a812,1351,TRUE,2561,1210,Dire
4f351762f91bfce6dd72bd874715fde4,582,TRUE,1593,1011,
15de13fdfc8f0c97213f051674080da5,1115,FALSE,1966,851,
f9d5307962bd0bbb4d77ffe519945862,124,TRUE,1980,1856,
cbc28b5abb6a2e4804e85af0cd916935,649,FALSE,2178,1529,Dire
87d19dd2b0c8e659e77f420ef3a8b0dc,1214,FALSE,2594,1380,Radiant
d9bf77510dc927b502e84967ea8f14cd,2605,TRUE,2735,130,
5d1dd6200b321ccfd7921c1333585875,1415,TRUE,1887,472,
2413c78ed4c54b30ca5f75b047d8ecde,1569,TRUE,2469,900,Radiant
9bfd54645a67387c6e7bb4a48f1047e3,354,FALSE,1336,982,
b8521176a1e7fe22c14ea3e2613a1ba2,1765,FALSE,2200,435,
78fbfb3f7a13caba7ef7e76f6c8968d1,72,TRUE,2014,1942,Radiant
c0368a8860477fc86487114486be0c28,318,TRUE,3338,3020,Radiant
fafa9cc8f3df6a60735e039716c3a3d4,2567,FALSE,3104,537,Radiant
905f9b31a58d0eebe8a09b488381d8f4,740,TRUE,2778,2038,Radiant
124da6fa30d5c09e29ffc7fba2694a1c,1552,TRUE,2755,1203,Dire
ac44fa86ae0b6ede686baceb296e40a6,1885,FALSE,2018,133,
a1871c656187f299cef28aed702c1f3e,2353,FALSE,3166,813,Dire
f9c9a35180b436346c781696d8250fdd,2056,FALSE,2214,158,Dire
c40c27d665237325878a499bde36f778,1704,FALSE,3200,1496,Dire
05d62484f605865559ff0778cf9fe00d,1010,TRUE,2588,1578,Radiant
326a867d748f64bdff5b5d74e42834db,1643,FALSE,2132,489,Dire
b5ca4e6b9db7cec580e47bfa7347749c,1363,TRUE,1999,636,
ca5598bb3d9ac6b436e316bdfcbde0cd,1968,FALSE,2474,506,
18e66246f75c2cd8d65eaf795f6e74c8,2716,TRUE,3338,622,Radiant
68dcb38dff89355865db485e3e3160e9,257,FALSE,1737,1480,
77a1f8ed8c85c0447bd232688b6f05a0,932,FALSE,3120,2188,Radiant
8347118cc24b13dbeaa6ec8169e8144e,873,TRUE,1706,833,Radiant
f89b51daccd4991edf178d45e808651e,1589,FALSE,2803,1214,Radiant
7db19bd791eb8fe5c22be1232e3e8468,1442,FALSE,2673,1231,Dire
304ab9881e34574dc53e2baa2508734b,812,TRUE,2432,1620,Radiant
25bfe51f6c6f572f191b0419d99d5313,1835,TRUE,1910,75,
5be826b8f274d7f556f1653d27ac4f2f,910,TRUE,2285,1375,
0fbcd839c815a067c16dc33e301c945e,360,FALSE,1556,1196,
0181db113cf36a95c4c63e9c23ee7c45,1500,FALSE,2151,651,Dire
f5d552b231ac0e41ae5178be26194dc7,513,TRUE,1873,1360,Radiant
4e8567053119e297e8515e8d77378a7b,1919,FALSE,3492,1573,Dire
6abababf2815f906e24ecf34c962c209,74,TRUE,1990,1916,Radiant
9b35acfff900534c301f7461fb0b995d,888,TRUE,3344,2456,Dire
e4741d463e5c61d0618912d266978919,2600,TRUE,2642,42,
a730626c127e2e1feeda571908324601,132,FALSE,1693,1561,
0c1ad48c37d1f218f03e22d85447afd4,2686,TRUE,2720,34,
f0598f1be25c539199229f780469df05,1265,TRUE,2445,1180,Radiant
183132dd35e6982324d6f0663423aa03,71,TRUE,2844,2773,Radiant
628e11b264b157dddd9ac9a64c441df0,2290,FALSE,2558,268,
a014734d965b0348b41af9a1c1da29ef,431,TRUE,2246,1815,
372c9cae383fd8449dac4e461d4be8b3,297,TRUE,1706,1409,
93f942005874bccf5f494c997af20098,548,FALSE,1853,1305,Dire
001f558f9710427883dbd060f6ed1039,1968,TRUE,2365,397,
0c8d1b9a911fa1977d9d5309370244bd,1621,FALSE,2142,521,Dire
3398782bb8125483250740c785644af3,2195,TRUE,2386,191,Radiant
3ee535935b5afae7f2ef0509e53f04c1,862,FALSE,3109,2247,Radiant
c59aa2d7efb53bf8149b788ccada7a12,1723,FALSE,2149,426,
09d4d5d79b657ccefba5363856eef9f0,2004,TRUE,2076,72,
eb28092cac4877656b7a651e22909a5f,382,TRUE,1766,1384,Radiant
6a9ae49d6217fb21c8626aad40a73ffd,663,TRUE,2467,1804,Radiant
7d2cfbcddc05350f670d333be7c7533d,1218,FALSE,3061,1843,Radiant
05e13fcbf626926c4c0ad46de3b2e6a3,1097,TRUE,2630,1533,Radiant
2e30e91e5c673bf3917e9401e9ffa2c9,834,TRUE,2854,2020,Dire
106bf6e1c0474b68b27c42c8dc7b3681,323,FALSE,1021,698,
3878f1ba3fb86b5fcca11802ab5a4a0f,566,FALSE,1987,1421,Dire
caa82a5f6f476aaf98079a4c5bb3627c,120,TRUE,1996,1876,Radiant
89c01ac4e33dd8a1acd3f9b261a5a124,982,TRUE,2456,1474,Radiant
12a02adb055d06148009538ff5fcb727,1174,FALSE,1941,767,Dire
e344199656eeb62067f1b1d6b1ca0b0c,1939,TRUE,3099,1160,Dire
6caf5b1532ff21f0df384329d051dbb8,2438,TRUE,3041,603,Radiant
402d96c7bf94edb2ef2847fd4da873d3,198,TRUE,1854,1656,
23afcf95b98843dad1cb3e241c063837,497,FALSE,2853,2356,Radiant
b7d7944cca083bc8315399041927e0b3,1504,TRUE,2279,775,
74935b1ea5095f2646d74d0bffd65a58,2278,FALSE,2449,171,Dire
cfcdaf273625e97d62aa19ec7ecdcc5b,1099,TRUE,1421,322,
12e8b1a85ed1858c2f08461245b70ccb,1521,TRUE,1560,39,
64edc23d783745afe2793e7bbb04620c,80,TRUE,1670,1590,Radiant
3cc04520ae2bc70040439061ae09759e,120,FALSE,2532,2412,Radiant
d87b31554dfb5b16d7701798c8690d73,1981,TRUE,2838,857,Radiant
bea2b991be4d468987bf362b2d1a0ed8,1113,FALSE,2525,1412,Dire
581ec3212b29d386e0b95f89e18ae850,229,FALSE,1900,1671,Dire
284dc448c0b6dea5a1b5794cb9693e99,330,FALSE,2229,1899,Dire
fb0a0a5daa355880a3eaa659b8f8ac5e,349,TRUE,2705,2356,Radiant
f66122babfdad50be864d519fa20e154,2359,TRUE,2823,464,Radiant
964357b2bffe4a9917311dab99908c49,1408,TRUE,1486,78,
b8ff39e201f94bbfb98e0ff5e021793f,1465,TRUE,2420,955,Radiant
070225d5273a6adbeaab34e2d3304755,1793,TRUE,1855,62,
1fd409bda8d548f95ae9a7444f8bcd65,321,TRUE,1764,1443,
a1952ee6fe86a792ec04b4dbdc04f0bd,881,TRUE,1925,1044,
899b09134cc6ec601f923e3c5ecd64b4,1246,TRUE,1566,320,
70b0ecddddda8bc3f9a4c6a4f500081a,590,FALSE,1157,567,
51d959e7de94647dbf57a05046705687,435,TRUE,1385,950,Dire
cc02d4999af3ebcf0ce5b71254560ff0,2356,TRUE,2469,113,
b408c2705df8f3130465a9ab67fc571b,1106,TRUE,1967,861,
a2416b746d822fea52c5512c9d94cf55,1146,FALSE,1920,774,
5f8076d2bf63d757029ea57baac1a4b9,2409,FALSE,2730,321,
1ec68ffb50152623b91b87c33d42e12f,726,TRUE,2855,2129,Radiant
483197f653671b29d4f48ac53029f4f8,2216,TRUE,2650,434,Radiant
636232554868f3f8e77a527d9fdb74dd,566,FALSE,2379,1813,Dire
a6b83ec26d18d44e4110397f013db039,560,FALSE,3023,2463,Dire
c35a9d6d1780bf37723bf32833b69d1a,75,TRUE,1566,1491,Dire
7317603878e88bd5fdee71a644bab046,1945,FALSE,2576,631,
f52eec0c9db27690e096ee727304dbc6,996,FALSE,2354,1358,Dire
ebf24f499cf71c17df71233b57efe9d4,1763,TRUE,3220,1457,Radiant
b24c98a3106501b7da89df9710117aef,3,TRUE,2012,2009,
a745501aca60445204652986e1e2f9af,3448,FALSE,3865,417,Dire
157419c21f7622ccbbd58ed3de98e6ab,1443,TRUE,3260,1817,Radiant
8aebd68cc2a0a2b2a0437f39c0780b46,369,TRUE,1213,844,
f1b1ad1f3ca0342e0e2d3b38394550ec,887,FALSE,2928,2041,Dire
21e0218e0295242b396527e98a2a3490,837,TRUE,1316,479,Radiant
bbbbd5118eefaf022a3bfde10e43ccba,1724,FALSE,2075,351,
8aa9cbceb509257e163b8f1608ebd9f4,1053,TRUE,1922,869,
1187e41d87333bd00c3a7123edbe6cd8,2075,FALSE,2746,671,
a84b36c3ed5240a4540c9c37be0ca423,1934,TRUE,3133,1199,
c3680e45b76a88103cfdd68d027155c6,571,TRUE,1825,1254,Radiant
f2c56e5050b9085be821a279442e2db2,1990,TRUE,3124,1134,
509cea00f600ed4f8c69e0f7de0ba168,496,TRUE,1968,1472,Radiant
d2535e1cf231a0609a868cda20e65645,35,FALSE,2269,2234,Dire
0b2f5a9660fac8da36af76ccd94f000d,80,TRUE,1348,1268,
72b3ed89092085648a7e945bd31dd517,1339,TRUE,3026,1687,Radiant
e8d8618f316719468fd7429e6536d983,1442,TRUE,1942,500,
d64380aa181cded6eaaefe003bf4ea4d,985,TRUE,1274,289,
7b1f196ee6d5837f77e43cd19a453056,2412,TRUE,3533,1121,Dire
1f29b81e72b76564b551cb96a68a7bff,382,FALSE,2543,2161,Dire
ce05ab91da42196d448b09293ac4a60f,1376,FALSE,2765,1389,Dire
b600f6a1e27a0707e9864c0b446609e6,53,TRUE,2958,2905,Dire
e4e556116f4026c6ecc7c53e6dc3bb5b,1168,FALSE,2265,1097,Radiant
932286e7ba76b1aa4deb8d1b190b099f,1679,TRUE,2192,513,
7d252abf34b4b1dde171819b60a5ebc7,816,FALSE,2320,1504,Dire
3ae0cada34082907a0dd607209720631,1518,TRUE,1651,133,
a40311b3585f0e453520dcec1ffb19c1,1099,FALSE,2492,1393,Dire
01796fd8c763fed6ca70673bd7e2b88e,1184,FALSE,1359,175,
cc98f747cb84a7803d9153a872a6a509,1377,TRUE,2634,1257,Dire
ee10df229b745c6a362d0ba5a53fe143,1639,TRUE,2247,608,Radiant
6dc72a255872697031633d39286b8117,1557,FALSE,2560,1003,
2156419e45ef2d55682c7dae51c04209,1032,TRUE,2629,1597,Dire
4e447787a8632b1b4486961a92ab6623,154,TRUE,2342,2188,Radiant
96f8078ad6e09e1fc979abdce8240e19,315,TRUE,1491,1176,
4ed3c1c3de3589a7f9d254a2ff468ee5,972,TRUE,2566,1594,Dire
3d53cfa26fa7118e57ac5cb7a209966f,1403,FALSE,1989,586,
91152648fc0cac20d1cf3ce5f84b80de,1680,FALSE,2738,1058,Radiant
8f9c0fd9345a4344a2a98f1c3dfdfe56,1750,TRUE,2217,467,Radiant
d6fe83c1e733d94aee3f91ea1d7ebe45,3304,FALSE,3466,162,
299f5f5551ea7bd3db79709488eef149,1183,TRUE,2390,1207,Dire
1e988066b28755e7fab7418d34899840,689,FALSE,3509,2820,Dire
547bdc0dbae5f8efae44828fdbabef5f,2762,TRUE,2909,147,
e8e2b2936afaaf06c20d7d7a59dcbdba,1458,FALSE,1693,235,
51e55cd5779b7ef49f33e2f47473d070,453,FALSE,2507,2054,Dire
8d067e4f61d30218e0d59cb614553ac9,2705,FALSE,3161,456,Dire
e06727c34c30c4ee6df3482dc2aedb87,485,FALSE,2294,1809,Dire
39023743073b7814ffc25e6825e1f97f,521,FALSE,1115,594,
0227204ce79704386bfebfccf6526b13,729,FALSE,3653,2924,Dire
eacd9ff14231114eccb5e86aac9e3b71,552,FALSE,1252,700,
6b37c499fddf336b9e280d00047f7f28,2007,TRUE,2679,672,
5bbed53bddbbbbf521852c92b14f782b,934,FALSE,1724,790,Dire
dd9fd2187d90c9dbffbe0e09cd02f2cb,651,TRUE,2149,1498,
b9e85bc56fa013c88fa730f8c71ad18e,368,FALSE,1938,1570,Dire
fb437d43d6e2ccdc7687e05b86bec018,643,TRUE,2697,2054,Dire
2bfc9d911c5ea1999fb8116a1c8754be,2361,FALSE,2518,157,
1e6d790b3ee1eaf14790046448008805,711,TRUE,1688,977,
e373e2b18ac49473d913445e9e10e25c,583,FALSE,2097,1514,
a84c662a6bdfa888b88cdff49db28652,36,FALSE,2931,2895,Radiant
029eec3a734e71c7c3bf95186aee7625,1314,TRUE,1636,322,
b413cf4544102fe70bfc075db0ec99e5,2624,FALSE,2810,186,Dire
a9623f71bbc55a65204ed1848f251d6e,581,TRUE,2314,1733,Radiant
f8288203531d1102d94d1dea1071551e,598,FALSE,1277,679,
963564258d78ac50306744c7df06c767,203,FALSE,1345,1142,
3766dd41f8cb109885d9444af3ecb358,1280,FALSE,1794,514,
61a44001432fee242a695977bdb45869,1803,FALSE,2097,294,Dire
c88c068edf6f6c62056a261bdad88978,1439,TRUE,2387,948,Radiant
bf09737a73ffb0ec5b53715ae274ad9d,1694,TRUE,1795,101,
05c3d45088e291cfb7db6b49d438ad70,471,TRUE,1785,1314,
bfdb96ef32bdacaf7bc9c5cbf4aa44f5,738,FALSE,1881,1143,Dire
87723df6f4a3386b678100639872600d,46,TRUE,2746,2700,Dire
c19851868a29d2d1d8376f0c42bf78a7,2009,TRUE,2567,558,Radiant
194d1a0be4706071023af603d12d14b9,152,TRUE,1720,1568,Radiant
ad36fd85beecf1281ccedb4a1f91bcf0,1559,FALSE,2895,1336,Radiant
7e73bbbdbbf2cf68a242f0e87aa68ae7,1642,FALSE,2301,659,Dire
859ae64564693b51066dfeb19fb64ec3,819,TRUE,2970,2151,Radiant
20ee4530656b939b49312b37a514f781,583,TRUE,1917,1334,Radiant
318bea5f26fc8dcffd62271033ca4ea5,1362,TRUE,1952,590,
890ba152050efab08f0ce073da4b8643,619,TRUE,2513,1894,Dire
b19579fdc9e8f6440008ea05320aebb9,39,FALSE,1679,1640,Dire
3287d600e8ddfb2158270baf5ff6ac6c,1289,TRUE,1904,615,Radiant
5d63108b7ddeb0477ac2e5d4c2924ca5,220,TRUE,2980,2760,
6655fbdf3e1046327b1933180e667d6c,414,TRUE,2192,1778,
b8139e3dff813e5fa0be16894e62bca1,708,TRUE,1483,775,
fac461126f7b2c4a0492dd3862a04ff8,478,TRUE,1607,1129,
a6dbc0e524fef31ca36d13e8ad4b70ce,243,TRUE,2519,2276,Radiant
a6212b10c154305c82efc1a676f68a3e,881,TRUE,1881,1000,Radiant
3875a87897dc73b181b6668a98e3dd3d,2942,FALSE,3684,742,Dire
1e4b2cf14ac8ef83adb2ecff5b8117fc,326,TRUE,2348,2022,Radiant
ff97d145c9e13395e029c666a489416b,251,FALSE,1890,1639,Dire
7062294041ce5f1d94d97b7d3d857730,2038,TRUE,2818,780,Radiant
c74223a7c90ef87c08144adf6c177d9e,1341,TRUE,2571,1230,Dire
f8696a580a253ec616f02f4482473459,1460,FALSE,2323,863,Dire
3e9ee19c34ae98c85b986903c485a8a7,462,TRUE,2025,1563,Radiant
efaf73eb41b12dd067b2aff3863d448e,714,TRUE,2917,2203,Radiant
18bc635a25747e35d464b6c346d2cfcd,1398,FALSE,3099,1701,Dire
4915ff640d5db60adb2c3bb9a024c0a7,184,FALSE,3200,3016,Radiant
368f9d8403a18d5cca679735e8ca0034,1860,TRUE,2277,417,Radiant
ea9ea4ab9352ad1aa529a40503f0aade,267,FALSE,2648,2381,Dire
727d0f8566064c5282d15844ed05a733,812,TRUE,3154,2342,Radiant
114807f32762a81e0744e8fbf4ee9d54,816,TRUE,1672,856,
f496c1df80dff518d4e20d1fcf142ac9,1078,FALSE,2114,1036,Dire
ee596155d49f2abbf237fd3633e0e5bb,656,TRUE,1760,1104,Radiant
14ec1cd5b18d9d7ab0ef0c65b2454cd8,1134,TRUE,2975,1841,Dire
516469f61f2a206c920e3a93a3e0c415,499,FALSE,2791,2292,Dire
a6128d067d18ee413d0b62bb6df9a6fa,705,TRUE,1261,556,Radiant
5ea96efb751e9172d744849c2ad91f24,901,TRUE,2812,1911,Radiant
c2ee26286eea642f50f249ea5eea5448,758,TRUE,1611,853,
985e6c49ca8819584b89b19abe76105f,643,TRUE,1694,1051,Radiant
1aef5fd2713b4970611eb731f7ba3159,1078,FALSE,1900,822,
d2b7fd76d2ffcfe5dd8604f8f5ded510,1191,TRUE,2866,1675,Dire
7b631644cf1d63121133524d851ac789,1939,TRUE,2093,154,
013e4559b68d5061b3f2346a8ab62640,1631,FALSE,4499,2868,Dire
65466d8d41b751452cbe08376da27548,1182,TRUE,1933,751,Radiant
59741931a5acd0769c036d5af79b28e8,1071,FALSE,2180,1109,Dire
ceffeb9c0e14478eb6779d9a1ca6877b,1194,FALSE,2866,1672,Dire
860b1ee708bdaf4b5311ee086c225e89,1763,FALSE,2032,269,
d2847cdf50e352794e41e53b2fffb681,17,TRUE,2782,2765,Radiant
05c0be739176983f604c3873cc322209,56,TRUE,2514,2458,Dire
8ffe8838efda68900c9b89c78a1370b1,2412,TRUE,2472,60,
91985fbd4b2734642c9049e1ae94508f,2067,FALSE,2156,89,
fafc88af5ab1bcedc1bf58bb7c06b518,773,FALSE,2674,1901,Dire
799e3823ddfe7f05c8a296ecf5d6701c,1762,TRUE,2281,519,Radiant
88d19dedea82eb1db2edc1b0dbcd243b,1353,FALSE,3069,1716,Dire
bd03c39d1d3d6cf1f613e5f273794722,2809,TRUE,3296,487,Dire
60016d2f89f394c8d978a849a0e7b244,1920,FALSE,3251,1331,Dire
998dd58183a4b81783f37647458c37dc,623,FALSE,2690,2067,Dire
589cf5ee0d1c1242babab8b665c3e69a,1853,TRUE,3000,1147,Radiant
2f57a7ca1c1fdcbc39c8c094d5766052,1214,TRUE,2674,1460,Radiant
51d4f97af118376db53423b8e1d7d2bf,1162,FALSE,1750,588,Dire
bceb47e2d7ec90a8f61967d9e1e2b2e2,1202,FALSE,2504,1302,Dire
eb452c8cd2b5af879fa8645b5f9e49d6,118,FALSE,1483,1365,Radiant
46a3b58ac4e1e25c32e645e46324c487,1754,TRUE,1801,47,
a9f7631d6e1f3d20f6c0b3e55bbc64f6,1255,TRUE,2427,1172,Dire
463e35b13b0e514a4e96111a87083e24,1587,FALSE,2638,1051,Dire
aaa53242a4d387316c3a09518ad1f834,1961,FALSE,2567,606,Dire
e11f086f7cbd239f99e07c4359054574,1748,FALSE,2399,651,Radiant
7ae78efa67e2bc0abe020b885fa82555,1455,FALSE,2494,1039,Radiant
aea7e5d6120d94b430487b149c6448a0,1458,TRUE,1694,236,
3b57d041a2d5b617417c1cb74211b697,695,TRUE,3103,2408,Dire
987a7cff90edb899a102a9608bf15eda,177,TRUE,1728,1551,
b210e66e0aa9daf6286137041ca8a9fd,2276,TRUE,4331,2055,Radiant
abbc1cf9c3792ef1aa98cdd65dc18943,750,FALSE,2911,2161,Dire
3f5fb366329c02b33b999a3c8e39f3e7,413,TRUE,1673,1260,Radiant
bdd23b15568a44b1d5fc99cf7e5e736e,2816,TRUE,3105,289,
6a32d7806c68f56372a996c0fd6a1251,1193,TRUE,2064,871,
04f27b37dd373a19c9c6a8c324ad43db,1245,FALSE,3353,2108,Radiant
b21e768adea97f8174c09bad2724c64c,601,FALSE,3425,2824,Radiant
14987c1558a11ae18eddbf3d08f932bc,580,FALSE,1671,1091,
8f813255680cd2564ffd8e2d94292a92,943,FALSE,1736,793,Dire
1a3cd4f8ff084db27e54b40498ba5fe9,2115,FALSE,3137,1022,Dire
ae72a8354d436c00328f199acd162667,2683,FALSE,2775,92,
08498c768ffd47cecd85d509e5d86722,1664,TRUE,3069,1405,Radiant
f2b4cd72707e44d235c3caefdba75bfc,1714,FALSE,1919,205,Dire
8510e4a3798cf075a66d50aaec70efd3,1423,TRUE,2928,1505,
b4e21c4ed9d5c2ae655b9d654f24baf7,512,FALSE,2514,2002,Dire
830055477dac7c2a30563e34d552039e,1110,TRUE,2309,1199,Radiant
d07caeefc27e7207a6bc51e713695154,651,FALSE,1485,834,Dire
b0ed9c987fba2d18163d7fa52ba9abd8,460,TRUE,2460,2000,Radiant
21432cee022a275a24f03404190b245e,389,TRUE,2130,1741,Radiant
ef61ebe362d2ce9b5d7cc3eba1eb08b3,1184,TRUE,2208,1024,Radiant
c4b72bb4cf64bfe0979abfbcb1b5bb04,550,FALSE,1980,1430,Dire
c796dff8861ec0b0992f6d287639cda0,184,FALSE,4286,4102,Dire
c6b2ed126b97454c6ee8649937df6fbc,571,TRUE,2921,2350,Dire
255017d3e783473f214e0e62aeed9fad,533,FALSE,1727,1194,
0061adca0e8f7c19750d1b5b53131d93,956,TRUE,1779,823,Radiant
17c269aeeaf63d4d4b8888e6179b65f1,1393,FALSE,1517,124,
5b31c627ed72325dae3742ed8ab40c5a,169,TRUE,1616,1447,Radiant
0deed55413108cfd735b66b58dfb7d04,614,FALSE,929,315,
400e00ed1d46949649806eaf15d710ed,1757,TRUE,1990,233,
7464c6be1e812663217831004294059e,589,TRUE,1948,1359,Radiant
4248094aa30bd6d0b3d4b6b124ac025c,1225,FALSE,2035,810,Dire
204e9974e913d94159e0e61b21eb64c5,1128,TRUE,2239,1111,Radiant
7cbd413691e0034366a051944ce0b3b1,129,TRUE,2532,2403,Dire
e6e05091ce84bd7277b3f440a5256592,1070,FALSE,1897,827,Dire
58aab1c66e6c1341509f1305bb812ccf,1237,FALSE,2570,1333,Dire
5ccf38bd3dd2d6ead9ba1e6e1e201a9c,1391,FALSE,2015,624,Dire
ce34a34ba11edad39fff9c12d3e0ca79,296,FALSE,2088,1792,Dire
a9a2693cdfc0b2aa4b4c94abb4079c4f,1479,FALSE,2419,940,Dire
98e379827522c2e2e31166a39f80aec6,1635,TRUE,1809,174,
547df4e535fd3cc93279676496680ffc,534,FALSE,2548,2014,Dire
977fcb7c68fd22f4914802b71b601893,1111,TRUE,1384,273,
760ae0f8e100370ded09114efb36c553,1908,FALSE,3473,1565,Dire
7f1328dcd0265f585821c3f760b81d56,237,FALSE,3120,2883,Radiant
64f90db58989cf389d635d5015700994,1492,FALSE,1671,179,
f5c8150458f78abf8c9922ead6fac586,1600,FALSE,2555,955,Radiant
fd638b76cd28fdb396ef40ec8a24eb77,791,FALSE,1350,559,
ead66120fd415550d6e8729ead078964,490,TRUE,2572,2082,Radiant
0a6b10c26e1c6b9a5276dfda268114c5,953,FALSE,1108,155,
790775e1360b96930b67af288ae98b4b,1275,TRUE,3118,1843,Radiant
5c6e90ae64feae24cae15914dc9f4c4c,16,TRUE,1663,1647,Radiant
e252bcbdb5d3663051c7fb581e106311,524,FALSE,2664,2140,Radiant
a31c173899cc981a415f687d2fddeef4,509,TRUE,2379,1870,Dire
ee66d99420e7943046104158d5cca4b1,1848,FALSE,3087,1239,Radiant
e7bac5a36a0e16a3ccd5d31995f37018,1609,FALSE,2449,840,Dire
b13c172c62f7413f99732258486fe882,2531,TRUE,2931,400,Radiant
9c85f76ee4d8408a95e0769600201efa,488,TRUE,2312,1824,Radiant
35bf3d9ca99185424cc7c5ee09074bb4,782,FALSE,1843,1061,
d8f6c46861e2e18f1eddf75efbb0e822,1741,TRUE,2224,483,Radiant
31f86e6e75dea36945be234f6be9068f,1838,FALSE,1875,37,
d0f81683288440006cea7365fbe85b11,2751,FALSE,3006,255,
d8c24cea5d206a57ffb3b4c3863df309,1614,TRUE,3154,1540,Radiant
85ed0f1e9adf08f9493506923fe8e8e3,653,TRUE,1769,1116,
406d5e06a5f63ba8d6d4024302899a72,1570,FALSE,2573,1003,Radiant
7fdc5e092873475d2e9b5ce392265638,1356,FALSE,2342,986,
d2f0f54e9497de2b080c141dbdee2264,2072,TRUE,2352,280,
ee4d31c6fc8447c1428d746bbacffde2,2623,TRUE,2775,152,
4b4b7345fdc4264f0fbbd4b7892ab61a,1504,TRUE,1662,158,
bce182e582dfc38ed2c280928258586d,736,FALSE,1110,374,
4c6be78fc827c7982ce424b5136d0667,322,FALSE,1863,1541,
b15c399e1cf0067d624f28e5b8dddd4b,2172,FALSE,3215,1043,Dire
ab49b1f1ce9ecfbe78da27b662c0367d,2918,TRUE,3156,238,
85da0ff4f22f41e2fd481efa14f33d5d,805,FALSE,2318,1513,Dire
eb838120c95d4b055bb7cb89ad5b331f,693,FALSE,1039,346,
b4d389821e15c802713f895ddafd92d1,1370,TRUE,2691,1321,Dire
d4c5f64a8cb16fc7282999d8cb7135a3,89,TRUE,2717,2628,Dire
8f55c8de5298d91a3effe96b05092124,317,TRUE,1340,1023,Radiant
0ee544d90bd4637190cd13e29cf31695,1339,FALSE,2802,1463,Dire
befbf24055124a17c5e4c7d08dc2b403,213,TRUE,1030,817,
dab133b919e760919e1778cdf58a7ab2,1662,TRUE,2061,399,Radiant
445a6e0d94049fd1e7a0ed5ef63595c5,1141,TRUE,2035,894,Radiant
9afdd91bbc987630f6ade4eafa35a130,623,FALSE,1616,993,
658f952c540b8967861751268b8a3945,649,FALSE,2102,1453,Radiant
47ecc5618bbf7cd42dc2f79ec0732dbc,122,FALSE,2400,2278,Radiant
fdb8aba35d73652dfde555467e4cec38,356,FALSE,2127,1771,
b758753517b481d8fe24c22617d5ef06,73,FALSE,3108,3035,Radiant
a257752a779731f06bdbe3d5175f5b0a,137,TRUE,1828,1691,
2ed5ed8e7331acfd1beef5499123f8df,1854,TRUE,2555,701,Radiant
4a9d3dfb4e3c0c39bbbf43f37fb3a010,612,TRUE,1888,1276,Radiant
f7549a97f113c97c0b4f62a4e661268b,142,TRUE,2649,2507,Radiant
422503432b50a7211b21da78460a8408,3412,FALSE,4128,716,Radiant
0f8d9c585d984232d98e5046fbaea320,230,TRUE,3087,2857,Dire
1cbe59479da5c33a8c3c4ceff28149fa,504,FALSE,2968,2464,Dire
37b88731e2ad0781c4e55d4ddc66cdae,1194,FALSE,1431,237,
24f6497a46c96a1426a9c4c34e8dde2a,981,TRUE,2020,1039,Dire
3a5554b7172757c14066c0ce044006d0,634,FALSE,1989,1355,Dire
6ba888660f26bb2c22aea002fff2d332,1408,FALSE,2499,1091,Dire
4bf3c30a969a5f81f9d740749afe59ba,829,FALSE,4184,3355,Dire
fa4c7508c90b389e37531a628e4fe70a,2160,FALSE,2193,33,
36cd6ed02012475051aaae270c32f21a,1761,TRUE,2655,894,Radiant
87466a53be10e085d6bd6c56ad779ce3,1113,FALSE,2889,1776,Radiant
9427cb8ba77e0060a3f95beb7f409d49,231,TRUE,2065,1834,Radiant
4bad1732414f915d506438a9d477b5ea,1140,TRUE,1321,181,
005d6bc14e9f08290650abc778ff8c08,1017,TRUE,3308,2291,Radiant
c9081f1d5996b8fcc94c8684df6f3725,600,FALSE,1545,945,
0e88547597cf25667ce59f66da334222,74,TRUE,2724,2650,Radiant
942d51fb102916f986bb398e8a1530d1,599,TRUE,1617,1018,Radiant
7a2f32b5623192fd05150da7165ac9b0,1733,FALSE,2168,435,Dire
c7617fdbfe4cc9e7a295b73eae5efddb,1421,TRUE,2522,1101,Radiant
0c1fd7b955e91ab5df56e5c569cd4bd0,2213,FALSE,2699,486,Dire
d39dc2459798659ebc1cb4e062b39152,204,FALSE,3786,3582,Radiant
b1678bddc7cecdd1d4ca690693ad93ba,1336,TRUE,2043,707,
eba2267a2816c16923a4ba2ee5d67ed8,1267,FALSE,3112,1845,Radiant
659b5d305a80375986e03e2beae1567c,800,FALSE,1260,460,Radiant
8673d4e792b5c9559a1bccbbec2b640c,2190,TRUE,2767,577,Radiant
ff20f8ed35b0c0f5813f8eb8afdd9101,785,TRUE,2203,1418,Radiant
4e95cf82c4f47427314f1ab1bde035a5,2740,FALSE,2797,57,
c39d4f1af41bb98fc13203f36eea2769,267,FALSE,3171,2904,Radiant
5d758211a99941f490541bc1dedf2e5f,370,FALSE,1129,759,Dire
f7a5ecc92cbb587be5f19b834775afd4,1117,FALSE,2623,1506,Dire
fd95ecfea93d91234733da633c522dca,1562,TRUE,2479,917,Radiant
f1ad7fc1a349f2fd629bbc633b595735,317,TRUE,1507,1190,
50cf0b90f1f5907f24cb3e32c0477042,107,FALSE,1622,1515,Dire
f9f6a29b20286d3478d5897f11708375,824,FALSE,1257,433,Dire
d314042eb320917816af38dd8f2b65a1,3,TRUE,1596,1593,
fd4921b77a7ac1204db602faf211fd2d,11,FALSE,1656,1645,Dire
4db2e7fa0df610ba1e5a2f85c9138de7,2131,TRUE,2648,517,Radiant
f2e68adc91f4f6feda91520fabd07658,968,FALSE,2147,1179,Dire
b314aa84747e9b2ea526b0aba76288f4,1098,FALSE,2205,1107,
f4c33bd5a12912d60ef756dd9c217383,1860,FALSE,2565,705,Dire
960f617228ff584e7fa6e61425fb6d28,81,FALSE,2026,1945,
f6ddb09672a2cf681f8e43a8bf151a83,1422,FALSE,2465,1043,Dire
0d9991a9ea42fc22bc3072bc849a1cc6,636,FALSE,1231,595,Dire
e594c2c31b5c4164d4a65a74f9f34e9e,1646,TRUE,2382,736,Radiant
7b4b65aa0954c63d289499cbebff2912,1033,FALSE,2980,1947,Dire
fb11005b752e5961242d5af08c4e5f24,230,TRUE,1044,814,Radiant
b61b7f389de1a5889f74814f521c7590,895,TRUE,2020,1125,Radiant
d57c08bea77d9c069d59bd883c3c9f17,11,TRUE,2693,2682,Radiant
5337fb399fd624d15ed1d470708ca04e,307,TRUE,1600,1293,
e91d8261faf807cda536616d22967148,3104,TRUE,3294,190,
77266be1911ea4b7b5bc2d76f0d37547,671,TRUE,932,261,
2336abae7b9a64b615fbfc69e05fe34a,1163,FALSE,3178,2015,
27d383b2c0d87f34015f47bd04fb64fa,1926,FALSE,3150,1224,Dire
0d299a5554139c3cd8ab5f542424f1ca,717,TRUE,2007,1290,Dire
8c57f780f4e5a6e5d6f7991aee116c99,524,FALSE,1890,1366,Dire
c5098e46ce5e16204c2983ed17af8eac,2196,FALSE,3237,1041,Dire
782a1fcc360770f6bed859f984316d86,309,FALSE,2566,2257,Dire
da2fdc30bd0b03bf96c7399d6446d324,1683,TRUE,1942,259,Radiant
3d9ace55fc07f9a37940a6514ff2fb1d,1089,TRUE,1961,872,Radiant
d11e8141c9f6e2f9b57916bbf3f74b66,1702,TRUE,2569,867,Radiant
5d1346cd7dc2a675b3c9523e1a6e0cfa,1302,FALSE,2176,874,Dire
bc820940daff6fd7b1ef8126c29863a1,289,TRUE,1925,1636,
39543673532b73153c4de0c3680c73a7,1806,FALSE,2443,637,Radiant
f947a36f7f8d2830d6dbdc8f053f1064,1958,FALSE,2950,992,Radiant
4823c2efb952692ab4ce4d5595f00ac8,3080,FALSE,3469,389,
1741779bb4e997020bc20b156404ee9c,1884,FALSE,2825,941,Dire
2be7300628301ae3a5133191da25eaec,1738,TRUE,3276,1538,Radiant
9cfae502996765007ecf0ab9afdc3478,583,FALSE,2628,2045,Radiant
4d117fa72ad7a3044c4b513d153c5dc6,1401,TRUE,1832,431,
d3e53f0a9f42b71da721bb489aeb4869,598,FALSE,2772,2174,Dire
dd1c65d694febd3a78b1250b1d3ce50d,856,FALSE,3370,2514,Dire
81a3c4cccf7372fbbaa85da351f68579,278,FALSE,2016,1738,Dire
7edc27c68638eaf8d53a90974aadf7d9,517,FALSE,1631,1114,Dire
0129d5f149d89dedf528f3129809dd44,1130,TRUE,1699,569,Radiant
6709a054f751e24f679687829f11183f,643,FALSE,2885,2242,Dire
c6f2f91334c35580274362f752fefb23,1249,FALSE,1940,691,
5c20ffadf71aa94378c7997f3b551bf7,1269,FALSE,2843,1574,Dire
b5730fe27c3cc229b1e893e62805cedf,436,TRUE,1853,1417,Dire
87b29a3be66b8a0d97a1d7f362d2da03,121,TRUE,1602,1481,Dire
c876c2b9c6458ca0264fbc11cfa8ed62,2723,FALSE,3334,611,
f9faf0626d6c20e99967102f16e39003,610,FALSE,2548,1938,Radiant
485169ab7fe81d7ac6c41cb22fdefed7,858,TRUE,1717,859,Radiant
4ca8aeeed3701c6ee3f9da9b1b5d9a93,2392,FALSE,3296,904,Dire
028413054649da3d49a1e7bb7cc744df,1571,FALSE,2146,575,Dire
124c26259bbc083a44b5878cc0db5067,2371,FALSE,2761,390,
a9ec9e6fe420f1355b1a5f2035a0c434,1478,FALSE,3075,1597,Dire
d608e1e64a75bcc77e926f1c80d27e79,1314,FALSE,2217,903,Dire
115f24fd68965240c76f11769b2ccaba,1681,TRUE,2311,630,Radiant
b431b7bcdeeaaf9edc762a768c99b7d8,1628,FALSE,2129,501,Dire
3e4620361232802f974d8a57092a8f5c,1277,FALSE,4221,2944,Radiant
4856355881962571dc7f33588468ff1d,397,FALSE,2381,1984,Dire
efc28e3d1625231d64ac8270fd2507a6,1401,TRUE,2656,1255,Dire
10a324623ca1db2500bd137810cd4ebf,423,TRUE,1710,1287,Radiant
402f294d683e408c744fe374046ac856,195,TRUE,1396,1201,Radiant
39b1793e4ada960796d3c3bba91980a7,200,FALSE,2600,2400,Dire
9f8046da0b6a28d9124db1fb1a017905,113,FALSE,2392,2279,Dire
668e6d36fef4b9c01911eeed5e5dbfb0,909,TRUE,2328,1419,Dire
f7526a510d49014c68af3a68fac38c04,1404,TRUE,2400,996,Radiant
907f6a5aebb441c13c127e5ba9f87add,2198,TRUE,2977,779,Radiant
db4358c8015a05570062111d652d148a,401,TRUE,2692,2291,Radiant
d12226e8daa55b8f376aee52e4cb2e90,1112,FALSE,2973,1861,Dire
317e5619b9f4af096a4ea5c28caeb77f,61,TRUE,2827,2766,Dire
e067848174f4d1bc9ab07e925e3c40a5,1145,TRUE,2974,1829,Radiant
29d0bc4f76927925c07b37b557e734ad,1658,TRUE,2516,858,Radiant
6f8cf915ed117808aace069f7e0b81b2,357,FALSE,2158,1801,Dire
f2263486bc8dd374b4d0bfb95a1e2555,534,FALSE,1986,1452,Dire
257424d0f4b92e529ad895f9fbffbfb6,205,TRUE,2741,2536,Radiant
ec731dd9603c181e14fac4eaa473b760,409,TRUE,2140,1731,
a9010a8ef561af56f1b2fb24daa867d7,385,TRUE,1482,1097,
98f305a6ad96db81bfe9f9dde2d0411b,1327,FALSE,2940,1613,Dire
8ba5989d9a3234893730101cb7a99de9,1320,FALSE,1905,585,
087783c09100bd152e723797a7c37d81,954,TRUE,2050,1096,
9427ba3b32996308b55deeb312cce171,318,FALSE,2085,1767,Dire
d03bdf4f4c28f7070c713f5b7b4a1ac1,2436,FALSE,3997,1561,Dire
19657f4899a77410ab074bc9b6565668,1264,FALSE,1947,683,
d8f75e587fde610478fa9740ae38ca65,1208,TRUE,2246,1038,Dire
8106a285fdaa8aea259a70d263f812f9,893,FALSE,1663,770,Dire
37c8f76780fb2f9eb706e805aba89de0,106,TRUE,2009,1903,Radiant
86da07ebae0c3dc53b1a0803c01328dc,1416,FALSE,2071,655,Dire
1c0bb74faa8b718840923ca90e1a6a48,155,TRUE,2399,2244,Dire
0b7f63feed75c6413af3dc86be8a617a,28,FALSE,1991,1963,
02ca2eb71382b1505146fde29f5ed305,1413,TRUE,2818,1405,Dire
74790d75e80f12f7776ebe3476098376,1589,FALSE,2316,727,
22a443e5a4d08765784ef0e848dd35ab,355,TRUE,2864,2509,Dire
84bc33989da06fcdc19d23f171131bc3,2451,FALSE,3335,884,Radiant
f1be28e6dfbb58c278125425a679784e,1076,FALSE,1648,572,Dire
e7500a9749b3fba23ca3c6585a647a7e,1823,FALSE,3120,1297,Radiant
1d42a089c1360bdd1a08646e6f5b707f,163,TRUE,1723,1560,
2bd3933fb05b52a2b937bf8347d47cd6,1210,TRUE,1992,782,Radiant
dbce46ac883265c6d230a15ee81dc6b6,974,TRUE,1187,213,Radiant
a19698ad5f7600a29aaa524b4a68c61c,1669,TRUE,2305,636,Radiant
fb03c4c89c5cd164ef91021dbce3772e,1467,FALSE,1990,523,
662dcdf9784a7aa59932c6b07a68e98f,1610,FALSE,1785,175,
d59593cebca23f06c6daaf63c73903fb,884,TRUE,2311,1427,Radiant
288e58942420327c958b30c0cd87a668,610,FALSE,2611,2001,Dire
07fca82d6b29b3559a9658a1cac122c3,1038,FALSE,1998,960,Dire
ce18a47ad5c64aed9daba9a79f4549f9,409,TRUE,2460,2051,Radiant
9cf18df5ce99fda177b241f66c3dc6b3,355,FALSE,1388,1033,
7d007ad7bc41ae6a4c0a3af1c007dd87,280,FALSE,1694,1414,Radiant
6570b228a1fdc8c12dd7433320fe7df0,1218,TRUE,1734,516,
cbeeadd0f4c2f5ceaf459af921f8d61a,133,FALSE,2321,2188,Dire
6af230e59bb6311337774209328ff979,670,TRUE,2077,1407,
a70106e4f4994ee338f5d5cc9741f412,1915,FALSE,2894,979,Radiant
5c21bb27b5b3acf2246e4c9d9544199c,1212,FALSE,3693,2481,Radiant
ed1ef4f7607cc23a73fa5b01c64ad934,576,TRUE,2447,1871,Radiant
4dce359387c891d475f9eb7f17991282,1813,FALSE,2176,363,
b356a28ba61c7d6ee5cbb325839c4329,1731,TRUE,1985,254,
b8150de55018f40f895374c4d203a09b,51,FALSE,2759,2708,Radiant
2d69300e1616bec564fa5741990e28f4,157,FALSE,2211,2054,Dire
6c370d964d0af1dde980d8475b4f1354,109,FALSE,2440,2331,Radiant
bfd8c09ee11750b3041eea05a4563755,1291,TRUE,2980,1689,Dire
2134c81bbf26abc0aaf5162fb47d7660,2575,FALSE,2671,96,
276a4de5dbf71d328f9ff8459fc077be,368,FALSE,1752,1384,Dire
d1170bdefab76bb8ef2a8e90c8e4b9ee,994,TRUE,1823,829,
77783651fc075aafa7cb842173f78af0,1061,TRUE,2039,978,
d2d71cf87bddec2fa54b8e766a1b353c,749,TRUE,1504,755,Radiant
6af076234e5a57e125191dd0203264ac,191,TRUE,2167,1976,Dire
4368533512e8da919cb8ab17cfe39ffe,891,FALSE,2627,1736,Dire
47d535bff366a6399058447746d6eb8f,1408,FALSE,1501,93,
9ebf566b8d9accc7d88721bf8285f04e,1945,FALSE,3034,1089,Radiant
9fdd9aed6de23f57059e7327c4772e82,304,TRUE,1912,1608,
72f0a6e0bf46d6c01321980e9c3d2906,179,FALSE,1073,894,Dire
84aaf228a0f109f34fdea8913acef952,1560,TRUE,1706,146,
5708f302a396e22d9154099a9176c95a,1196,FALSE,1607,411,Dire
b441790f45051ca28c9447b89284af06,184,FALSE,1238,1054,
0c162c57a4333b65c362b7aec3695c29,347,TRUE,1948,1601,
9ef2f287b1343045c1ad5cced63b4b29,2345,TRUE,3003,658,
e61ec502f6e8cf8b14ffdedd9be7b86a,549,FALSE,1910,1361,Dire
07f1732152919fec035b2f03d1ed0a9a,1006,FALSE,2234,1228,Dire
5533597d1738aca741495bcafb46935f,2454,TRUE,2943,489,Radiant
195958f531ea4c348cec79b3047c03bc,1435,TRUE,1886,451,Radiant
377115bfe297b319ed75dc0b26b58dba,514,FALSE,2813,2299,Dire
fd25ca053002e376bf899f5928fece3c,232,FALSE,3196,2964,Dire
2159837dc52ab6a7cc0030d6a3c4f780,80,TRUE,1268,1188,
d7362e54a67344d7bd72f8c30e0503a9,1031,TRUE,3049,2018,
23fd5e5408bffeaae606fe31da1ea8d2,181,TRUE,946,765,
3575b837d3f024d173735a107308a8a1,1855,FALSE,3081,1226,Radiant
eaf03a28edac86bda12c143fb96b3032,1245,TRUE,2208,963,Radiant
336ac96aa25443bbc825bcf6568055d6,1128,TRUE,2881,1753,Radiant
326dc1e05406929f2020e602d85e655f,794,TRUE,2495,1701,Radiant
25d2ae536f042de7c01c0827e2572d2e,1229,TRUE,3103,1874,Dire
654b66846b09b19f4ec09e4c63385d77,613,TRUE,1635,1022,
4010b4b0b492758320d68ae3c428006a,1668,TRUE,2676,1008,
5e5eb49e011c7f3a17f8f2207c72d74f,3181,FALSE,3416,235,Dire
5c123ebd4e75ab55f3216d586e365a3f,1928,TRUE,2040,112,
cb6cae015b6a101d0cd62c07385a077c,2396,FALSE,2509,113,
4abbf444d449a84583fadd8fb9c5f722,1239,TRUE,1291,52,
47019b6d053e4f2edbde3cba788aa650,707,FALSE,1867,1160,
91a6b08fd64d2e3cc38d0d7e1eceadae,439,TRUE,2102,1663,Radiant
7a6ef34ba0e1dc9163dadbd97b21207e,909,TRUE,1412,503,
29181c213a41cb1e0a726398179fe961,1564,TRUE,2098,534,Radiant
326f5d2b6d46a7695ce4a340b6da0e41,58,TRUE,1907,1849,Radiant
85309de64560c0d61b46475cbdb3e160,523,FALSE,1163,640,
058c4c9ca98ea00ce08ae468f9659957,760,TRUE,1215,455,
33f4a69885c64a43741870bf20bcd4f2,379,TRUE,2176,1797,Radiant
db0211951d14537df415a61d991a041b,1878,FALSE,2576,698,Dire
63734bc98ad58317074832a5e0e2c172,1720,TRUE,2265,545,
a8d12dd956bed460cf8f1ef9534d8988,293,TRUE,2299,2006,
e19713eab7a542a696784155585e09a5,1901,TRUE,2447,546,
c0985ac83d9372efd8a0cc56b0e30fc8,2179,TRUE,2344,165,
a63dabeb4834b3ebce1f537c8b769567,479,TRUE,1727,1248,Dire
4e9c58f2b1308d46fa50c15f5d6c3ca9,167,TRUE,1544,1377,Radiant
4bae11b5511e04a5bb79fc69e9b0f47a,1162,TRUE,2857,1695,Dire
3bb7c57ca6ed0b62ef58a47a7dbfc858,339,FALSE,3052,2713,Dire
8c026bf2dfb772683dedccda80514cef,1705,TRUE,2679,974,Radiant
999ae4ab4d97dc5cef1bd2d619167b2b,799,TRUE,1130,331,
3bf84e6dad2ba4d293f30a0d7bbc5d9f,1570,FALSE,2542,972,Radiant
feaff3efa84f9193763a5d2704281a70,1695,TRUE,2862,1167,Radiant
3de5f96ea3fc0bc380480f6c0b2ed75d,1419,FALSE,2652,1233,Radiant
c1dfff20059fbd56dbd183e398a36c71,40,TRUE,2315,2275,Radiant
43f30997cef452a4901c8862f78461e9,511,TRUE,1580,1069,Radiant
2023f1cfa7ce9a1a6ddca32622d21370,416,TRUE,1500,1084,Radiant
b4b1a15bfae86466fffb0d07b072ea94,1020,TRUE,1306,286,
6db388ce8e45985fd5c766269317ca3b,671,TRUE,1662,991,
b6e596ac33b137db4a672e9c967dc795,163,FALSE,1853,1690,Dire
3fc84a8ad31c11352843554a12055ce0,77,TRUE,1462,1385,
1ddef35729f9f953c785177647d9a41f,2295,TRUE,3091,796,Radiant
b6e0cee8bfd1bf98b56ecdec0424153e,1225,TRUE,2069,844,Radiant
7e611e94fb7ca1c6232120198c8e24f5,387,TRUE,2184,1797,
e9d6ad7019e545c292c4da62a61dc1ea,226,FALSE,2218,1992,
382066fc2f49bbc4f142d6388d15dfb0,245,TRUE,2465,2220,Radiant
1a7bc58444f539d2b4e6549c65951fe4,1747,TRUE,3041,1294,Radiant
7e60137a4b85035dc7ffb59c1bae10f6,174,FALSE,2752,2578,
a52421390a3f133ad9203b1d7e18a66e,1863,TRUE,2045,182,
6bbe839369aa5ecc11190e7d4a15ebbf,2112,TRUE,2638,526,Dire
74fd1fff77184092acf49f3ee0b9bb37,300,FALSE,2343,2043,Radiant
d24e8fe3dff40a2b9ffec13ab001eda3,2512,FALSE,2728,216,
ade24f567d40808f381650d7d8fd2367,1993,TRUE,2529,536,Radiant
a7b3a7b8ed45966e8b7c8999b836e2fe,683,FALSE,4109,3426,Dire
eac2904a83a168d0ed380bacd3dcda28,236,TRUE,3296,3060,Dire
7813f4436dcc8277ef526a2a6ad3e3da,122,TRUE,1388,1266,
551838708320b3e7049f4ec2c8493c5a,1052,TRUE,1920,868,
5a441df3be2af03384e760496c2ab603,1149,FALSE,2230,1081,Dire
39dc36ff66cc95d68ba23cd5aec4edf0,2978,FALSE,3549,571,Radiant
86105a1daeeb784b57f6d5aed09d1716,1604,FALSE,2337,733,Dire
3180d7e4940f9bd62b85bfd5019618c4,1,FALSE,2311,2310,Dire
dca8ebaf9cf9a4e537f947c8b19760e1,1842,FALSE,2208,366,
38e3a753705803d1b6f7b020fbb688a2,949,FALSE,1163,214,
cbfde1501e93acb5a67f2c043c9cba4c,1261,TRUE,1943,682,
4408677681ddcb8aa337be4ff465ff80,352,TRUE,1845,1493,
742691950fe90a1a3aaaa303641aaa8f,316,FALSE,2730,2414,Dire
d3df53a736979f0a86333e6e08c7f18f,177,TRUE,1364,1187,Radiant
5fc422e6b1ee0f2caaa1d21d65db9573,1155,FALSE,2514,1359,Dire
bda8c24e44ec7dd8dc0a29661888ffe3,912,FALSE,2975,2063,Dire
ef0a48b3f4d11951cc3d47f6e1c8b2d3,1322,TRUE,2157,835,Radiant
234c9e808e90d005b8532fc66752adf7,2768,FALSE,3170,402,
7c31e3887a68efaa41856fa8ff64e5f8,47,TRUE,2347,2300,Dire
1b1e1da722df7002bbddbdcf50f2d8e5,2851,FALSE,3035,184,
4d16d0cedc5be2c1706ac2c1539c3da2,1589,TRUE,2188,599,Radiant
f5c406c9b69629e83186072142123fa4,832,TRUE,1345,513,
18dc603b889a8fd8a2f6ff5d5d929161,705,FALSE,2974,2269,Dire
f2d592e183d2a7a854900bb77a7a1887,1958,TRUE,3097,1139,Radiant
c9b548cbb640d6931018d551340c6f93,424,TRUE,1816,1392,
38ed4333bf5a2dad41c3edb5458f256b,460,TRUE,1634,1174,
57cc623e2d9a1ae2667c281bfaa2ebcf,93,TRUE,2801,2708,Radiant
c190a628e296de85d136f54eb261e769,710,TRUE,1791,1081,Radiant
ab367bf8841285aac2d51c4c2d44ff72,2771,FALSE,3303,532,Dire
1bb5350db3189f848a358be5c7c6ed53,1166,FALSE,2982,1816,Radiant
892b24e6d92d86deb9189c0b41857f2e,263,TRUE,3247,2984,Dire
72152b8b49764ea51c99a1bbe31c9d00,318,FALSE,2002,1684,Dire
785a13be1c5ef2c5686baf94deacc1a9,1602,TRUE,2533,931,Radiant
de5c888e361c6c4d5bc1876031988fbc,158,TRUE,1476,1318,
f59669e95e4f09066e481a8a5e91cb91,497,TRUE,2015,1518,Radiant
754f2c1c0925fa28415ad0ca0fe080af,571,FALSE,1303,732,
5e79d73a10b80471bc5ac99dbabee16d,1035,FALSE,1827,792,
076f1cd9352449dcfdb5b459b9bb4059,2211,TRUE,3398,1187,Radiant
07c8d2463b520ad97ee92d91ba91c2ad,1818,FALSE,2528,710,
97ab7206d166ef03ecb85b07488e43ee,531,FALSE,4056,3525,Dire
54bf76081da9e4289b9acc3aef12eff6,1457,FALSE,1736,279,
4c84e54252c6d837d908d9e7c2090f30,2565,FALSE,3856,1291,Dire
d4d272018558943c87e51601b7f9693a,1452,FALSE,3634,2182,Radiant
cec9f6d753d6f0ecff643cdb826ff460,265,FALSE,1375,1110,
6212ab249da45133c7c45290ad1e9b09,95,FALSE,2337,2242,
fdd33c95503a15a263bab7a90192e76b,1493,FALSE,1733,240,
2ed21ce1c499090c893c9f2715888a49,2480,TRUE,2950,470,Dire
256f33733ea6ed235886b28aca7a9e36,39,FALSE,1462,1423,Dire
e4720d24d2a54c6d68d55fb215ab8bfd,1543,TRUE,1876,333,
1759b17887e7b33cc0ebde89b8ab0ebc,391,FALSE,2373,1982,Dire
36159309ef68c3a4fc8ddbc2340654b4,2389,TRUE,2442,53,
2d39c1189ba20541d131ba137d51c79b,3591,FALSE,3814,223,
b27054e98f8ed174fcb8cc8ab6d5c871,604,FALSE,1781,1177,Dire
1b7ffcc2577297297bd331fa18cb3a40,920,FALSE,2978,2058,Radiant
46f5ecff65881e27701edf240cbddeb7,257,TRUE,2652,2395,Dire
03694750975803562daef84ccbf6d9cd,675,FALSE,1606,931,
3954f14ce2bcc98a6c8e088e9e4fb751,564,TRUE,1003,439,
578730b56dc91f56cfc16987fcc71e13,1726,FALSE,2530,804,
a8cd01fb44b437562551a9508f857e32,578,TRUE,2492,1914,Radiant
7629dec2a50866cbd11ee2744daa6e13,1971,TRUE,2069,98,
e30f39569e942947c3a629835013d495,1738,TRUE,2794,1056,Radiant
2d6b4a3b893c8545c676129895af116d,3291,TRUE,4483,1192,Dire
2b95bd85534f7809f5e7c3c321d7bf64,1217,TRUE,2704,1487,Radiant
5795f9f8f02fdb78c31b95691ba406d8,789,FALSE,2848,2059,Radiant
7ba037b30facffc76b605d46198b8f8f,1282,TRUE,2309,1027,Radiant
eb6bb1bd08b3336c78421ba9400d902d,1195,FALSE,2074,879,
ec495ba4b3004a020a1c015445d68251,400,TRUE,2537,2137,
bf1077452bba256c3a8215a78acdf777,3209,TRUE,3724,515,
051e6d2f9ba6c7545e8f13c55433bc13,387,FALSE,2666,2279,Radiant
564311c3e9f942c01ae23e2ee986b216,2667,TRUE,3721,1054,Dire
03272deeca5240a02078938b6c75e6cb,1365,TRUE,1628,263,
86c821808fb5b7722b4eea13adc5b256,3022,FALSE,3074,52,
3017f5ebab7d24ff982765e4beb58b9b,268,TRUE,3223,2955,Dire
cadcf882d7020d2142521faa06cb0981,2713,TRUE,3664,951,Radiant
f891ec3ffa18449eecf9489cf16d3930,2001,FALSE,2386,385,
bb4c4d240ee2be3af058a6e1cc8e9106,1621,TRUE,2307,686,Radiant
093b098ee1ca9bb82d1c237dae819e33,186,FALSE,1951,1765,Dire
74244d50ef6241900f74947acdf7aefb,1197,TRUE,2814,1617,Radiant
fe8078c5bb9163db40e2691a6e9506b0,1983,FALSE,3439,1456,Radiant
c10d120a5a078321d48c02ff58a0ace9,380,TRUE,2946,2566,Dire
354531d084ff5730cb48b2feb84eba91,2349,TRUE,2572,223,
ed86622e68ae49850175cff5e8da7b03,477,TRUE,1139,662,
68c7602d00d3805e48dc39a2fff03c2f,108,FALSE,3563,3455,Dire
bfc4ca2d66798245d2f8c684db00c2e0,1947,TRUE,2737,790,Radiant
b4bb9454b1d4f7d6ad513b7d1576c433,1180,FALSE,1347,167,
04a2e67395b422f3c1ee619c26548fd6,817,TRUE,1964,1147,
6b70405ed855ffc524b026b63f0c6b9b,2753,TRUE,2992,239,Radiant
0073eaa0a66ec205f8a22c0550454085,4,TRUE,2638,2634,Radiant
f76db401c2a73514dac9dd50493bc383,1951,FALSE,4907,2956,Dire
5c25b3fdb7bdc78d348c429b6d85182d,3,TRUE,2171,2168,
95c26d569b3c5cdfe1f9d4f8323c37d9,2322,TRUE,3495,1173,Radiant
60519300a8076c656b50a5ce9f532866,1473,TRUE,1531,58,
b74f74e844678beb72d64d30b4afc7aa,188,FALSE,2238,2050,Dire
df9a930bc4dfef4e8b623830f6ca9da4,1195,FALSE,1746,551,
c94d9e0d49b25b1c04668b3befd82156,375,TRUE,2361,1986,Radiant
ea5e08c4526b821feb84bb076dc16783,166,FALSE,2319,2153,Dire
20e53fc664452cbbe15791d9ca1114ac,38,TRUE,1367,1329,
306e8b03e495dc8deaa235c9d9b8a6ab,1607,FALSE,2362,755,Radiant
a1425e9d288d1117aa17b6df21c68519,2326,TRUE,2446,120,
43b920b41dbe198ff9dd78995c8d1991,1610,FALSE,1968,358,
b19ba391280ba3da2d22f4dbd06dc743,258,FALSE,1247,989,Dire
fd2016bd1b582049e1aeae1579f3c656,1767,TRUE,2223,456,
8421c6f4e1246d8232e134af42c201f0,1005,TRUE,1612,607,Dire
f91aef1f4d733148bc1de61d87f22c54,1015,FALSE,1846,831,Dire
59a7407cf1888225fa2b8fd98ece7e23,328,TRUE,1534,1206,Dire
a68a0adc5eace78e9234630c1e6e2e78,1104,TRUE,1449,345,Radiant
27eca56732a0c433b04d3e937b6974af,954,TRUE,2180,1226,Radiant
9755defb8402283dcad07ff1f695c7fe,1345,FALSE,1947,602,Radiant
e037b6479b309aa4f251a89de0a793c7,895,FALSE,2353,1458,
fcbde1d7c01d461d39f88b7fb1392477,555,TRUE,2317,1762,Radiant
016c4ae3628539f49a897e74a189cfc8,1125,FALSE,2608,1483,Dire
32e9bc09bbac606c04b7fea4cf8338fb,1538,TRUE,1747,209,
a7cadebe2fe52c0a817d5706a09dab87,2208,TRUE,2497,289,Radiant
5915edb5c194fc5c553421e341bfcf2b,1026,TRUE,1272,246,
7f7b65867da1b24aa533eadd2fd8033a,1119,FALSE,2086,967,Dire
a5aa76bb955c71935e0c42a2519bfab3,126,TRUE,1998,1872,Dire
1ae97bbb8cf41de3f7bf378c0d5bd02f,1240,FALSE,1701,461,
384dd228aa3434abb64e3bf413340df9,1304,TRUE,2368,1064,
707d55d0bd98fe13dcb4dd3ff266f4cc,225,FALSE,2256,2031,Dire
31f1469eed51c28b884e549753a60f66,1989,FALSE,3382,1393,Dire
11899e18f96ccd99ffff7de3e23a70c9,1379,TRUE,1658,279,Radiant
898c54d9bc50cd3f81551fef60171fa7,969,TRUE,2303,1334,Radiant
07bb5eeb02286a016def978aba456284,412,TRUE,2088,1676,Radiant
128bd3f408015e91658c75f97849e3f8,1216,TRUE,1919,703,Radiant
63dc3aec3bf3dd2781c209f7a4a4f9fc,1625,TRUE,2153,528,
15824f2c1142f19d55f17f875f3c2684,2011,TRUE,2362,351,Radiant
94b365a04bd7db59990d43ef73b0de23,1556,TRUE,3998,2442,Radiant
41553e64a97b52fb07aea0ab8563e661,1322,FALSE,1671,349,
402da01ef52840a3832550b384ed6cfe,1021,FALSE,2059,1038,
f27099270ce23fef28d5364517dff6c4,1139,TRUE,2170,1031,Radiant
5531f8a4f47e0f601e66bca14b32408c,878,TRUE,2399,1521,Radiant
d759853b464062bcfa408c54a7fbdb40,2310,FALSE,2911,601,Dire
e06b214fefa4706da2e6276607014499,2801,FALSE,3449,648,Radiant
0a8fc5a1eab555a33a9756516af4fc3a,2409,FALSE,2458,49,
aa8adc7b8674b02a181c705461255d69,1775,TRUE,2233,458,
013f8b6b84e7f44d8b3fdf5d19661f59,1037,FALSE,2466,1429,Dire
4560123d937d82437fc5099d74a0f3da,28,TRUE,1597,1569,
c5ca1b71c7775a7395bbc62a1fa056ff,247,TRUE,1979,1732,Radiant
32df5577cdbabd6b39053275d044ca8d,1043,FALSE,1852,809,Dire
bbde22c00ca59867ab950c04e0ddf276,897,TRUE,2056,1159,Radiant
6c01c8ec02ab6e8a861d5604252584ed,2212,TRUE,2647,435,
cc3e66760096a73b75cbfe9200f528c7,1491,TRUE,2781,1290,Radiant
7729a1b5bab2387b85e95174ee4402d5,40,FALSE,1803,1763,Dire
3fe2de5b95e5743444f6a6aab9802394,209,TRUE,3182,2973,Dire
57c06980c6bf42b1ea814bb46e741db2,1176,FALSE,2860,1684,Radiant
d57c1f8a93fcfe16e605e8a464588f1c,4,TRUE,2234,2230,Radiant
708e9b6d608a828d41f43316af67ace7,314,FALSE,2803,2489,Dire
282998b6278999fc00badddfa57fd69a,2883,FALSE,3083,200,Dire
54d837d78ebca374dfcaa4f8b694e202,1100,TRUE,2381,1281,Radiant
5ca76f27d237e5f492c2c152a82ff539,1202,FALSE,1929,727,Dire
867e8489f80d343c98a4b35c0e6344ff,2088,FALSE,2917,829,Dire
da17dd14c3f1eb5a9b7354913439a1a2,1926,FALSE,2586,660,Dire
59255a281593f61af037fa026856f59b,1147,TRUE,1487,340,
4311e37ace0695a5c2e4830d6c504907,171,TRUE,2411,2240,Dire
7c377384c7e63b9e71f20784e8840374,2246,FALSE,2329,83,
04d841f2ab4b28641e5f9d574447d80b,1021,TRUE,1859,838,Radiant
3b004c8eac358b506d592756ba301f5e,1576,FALSE,2174,598,Dire
72df49d181c99d12eb40f9790366efa8,787,TRUE,2619,1832,Dire
190e2773ca402f7dbbd9ec85fe5161cd,206,FALSE,1615,1409,
4bcfebee49d2df0f713a83e7fd4ebc7c,2339,TRUE,3461,1122,Dire
5142a49fe6942925b4d4251bbd705c95,807,FALSE,2066,1259,Dire
dab6b4871f1af65c65c031e4b5222c9c,2276,FALSE,3097,821,Dire
f56f93a150df4510cdab734bbd2134e9,1966,FALSE,2184,218,Dire
8142ec25ebda47c868f47f7d4ed8b9d3,1910,TRUE,2616,706,
b8946c8ff3b98a52e53d0ea91c14ecaf,339,FALSE,1426,1087,
0cbdd6c35047fd33b6321d61b735a4d1,554,TRUE,2319,1765,Radiant
2d16f4913c715edcb2cfb3755c38e84e,1799,TRUE,2504,705,Radiant
b6a93d5e5c4e7d80738a7282208f170c,1987,FALSE,2027,40,
3d7cf4b809b3c3e89d1741b36b711f23,2730,FALSE,3020,290,
fbe35e712050ed91f0b179ee51877f46,2426,TRUE,2493,67,
c0a4a56e976f4be0e0124411a3135c77,720,FALSE,1728,1008,Dire
4ec48e1c2081f0f9aa7fa82305899def,1189,FALSE,1574,385,
c93403b1f9015b5ec081577c01777617,1270,FALSE,2179,909,Dire
d59a217b35b0d861eef1d7468c8f7d07,1270,TRUE,1708,438,
386136f2d9b8be3bc5e2a6fa76d1d1bf,303,FALSE,1889,1586,
c77760c3222bc8c051bd2142e8c484cf,417,FALSE,1956,1539,Dire
6d4f566381a73af50cefc74bbb22b195,1768,TRUE,2730,962,Dire
fe30933e1a059c8fbf1a76c5fc6238b9,688,FALSE,2350,1662,Dire
c668f9e4d2d4214bfd0d680c7ede69b6,265,FALSE,3344,3079,Dire
f210cb030301a24493df7e8604fd6eef,716,FALSE,2178,1462,Radiant
9e520f7b5684daf5c1fce27e6e10ac72,1608,TRUE,2382,774,Radiant
bea2e477ee840cd87c92928529badcdb,491,TRUE,2186,1695,Dire
637415ec8feae895fa2eb34c039706a3,141,TRUE,1457,1316,Radiant
b5a6da5a9dbc74893b48220bf2b81928,1331,FALSE,2335,1004,Radiant
ca05a68e1ecce2e7c338d59a6d517def,3410,FALSE,3813,403,Radiant
3ca7e1c9ebb008dc98e9632df967505f,706,TRUE,2879,2173,Dire
8034fdb6f687e9c253d9b59d516f2f3d,1316,TRUE,2229,913,Radiant
810ea675499ef9a01bf535fbb6255112,1194,FALSE,1432,238,
3b8c98c2189330860e832ea14ab8737f,1935,TRUE,2364,429,Radiant
f9e774279cb810e0b59577f74e946e9f,577,FALSE,1746,1169,Dire
47e2ff9ad4e3768703b1192daa2eea53,2768,TRUE,4020,1252,Dire
c225e2b9a167cb3600f02dffa5f701e0,2147,FALSE,2213,66,
3cdd6e5c7a6e5228ebf43ca6bfa2e980,1177,FALSE,1967,790,Dire
1ad3dc64180ad40f7ee895b1d772e1af,1016,TRUE,1766,750,
b957dec50c2f64691b1760c42802da53,249,FALSE,2316,2067,Radiant
8ecefbecfed3ecc7e8f620f91bb3fe5c,2681,FALSE,4208,1527,Dire
9d4b0a036a4a1eca27c2d5bcc22cd5f7,1989,TRUE,2482,493,
756f30cf9b93209dcdcd7ac06342df24,2338,FALSE,3087,749,Radiant
0000cbef31e13f297dbbe47d84a08169,1056,TRUE,2137,1081,Radiant
d839688e4a02918a0b6ca7cb1007850b,1656,FALSE,2294,638,Dire
c0a738269a50de5c5db9b24ba0ce2f70,532,TRUE,2334,1802,Radiant
7dfb05f6c99ed2ea722957b68ca0f7f6,239,FALSE,2323,2084,Dire
cd254f840c149b88840293c02c0b3639,1372,FALSE,2437,1065,
beb5ccd1914623e436a2d3886e1cf24f,46,FALSE,1777,1731,Dire
4a627a2d49ccfad75b819e8c6fe1ff19,27,FALSE,2234,2207,
75f1851a71ac4bd18fdb9914a7b5c323,1768,TRUE,2495,727,Dire
bdc6c3e64014fb3daae421445ef48e1b,688,TRUE,2591,1903,
779563b8c50fb987d7920712db9f02ea,838,TRUE,1039,201,
44919823518d2d08065222c2872f36c4,797,TRUE,1799,1002,Dire
7b9cbf6e6be53ee493e0bf172f16104a,473,TRUE,1603,1130,
6f9b7d49865ab5a95b86ef272e67fd61,1139,FALSE,2025,886,Dire
1076151891db2962b9e86ec7a94edb15,157,TRUE,2497,2340,Radiant
1d3815c8cf53d9b9448d727c4f59e50e,1173,FALSE,2143,970,
5a32835bc6a180c2ce02e3b336e03e61,30,TRUE,2714,2684,
7fcf885d139705f4cce36e31c981dc79,785,FALSE,2043,1258,
f00ca96285c64aae3549fb7cb7afcd07,3144,TRUE,4516,1372,Dire
82838db322240c75d02b03794d258d6d,1052,TRUE,2574,1522,Radiant
9d8a1d2677e20e6ee567edc7163eb620,2271,FALSE,2477,206,
c52a1d8a02b3cfbc342c047953805884,105,TRUE,2841,2736,Radiant
cc5f25d4e5b403958bfded3678732430,372,TRUE,1500,1128,Radiant
7b503afa57b3951fc82b3aacccccde65,345,FALSE,2896,2551,Dire
557b9e06d86cf5e6a553c6153efd51cf,1083,TRUE,1866,783,
799b9bcbce5e21e9c6ac2ae1237946d3,628,FALSE,2786,2158,
d31b52db8406f6c18091e40451b8485b,963,TRUE,2191,1228,
9c2d63ba3f7b72b31292a4237691b755,1290,FALSE,2160,870,
985a584b0a4c55d5f39e420a0361067a,112,FALSE,2333,2221,Radiant
467fcf75b594e62f4a83f8313a8a7199,502,TRUE,1920,1418,Dire
6ce062879f4eee9d8c89abecd998b3fd,2078,FALSE,2134,56,
ebaf1df6435123fb14560984a820912f,1529,FALSE,2579,1050,Dire
0729f42b519c2ce23262c636ce21a062,959,FALSE,2422,1463,Radiant
275f1460642095e9602ff05a369082b4,293,FALSE,1769,1476,Dire
db0e12247e63057a8f634b98383e2731,92,TRUE,1639,1547,Radiant
67ea451590983d024ee982613df49d78,1252,FALSE,2183,931,
102d0969e91467a9319d830d2ea2d96b,2214,TRUE,2301,87,
ec0b53d40216057029b893efef7a0077,97,FALSE,3309,3212,Dire
1dd0e391fe2438644aaf9c0041c52ab7,2341,FALSE,2895,554,
32c7ce9950e2b78b426ef24dc87000ac,1665,TRUE,1846,181,
47ed7f22152a6b38cd12a5115cdac80a,1261,TRUE,2420,1159,Radiant
7167d300e746626c89cdf8ef885da494,405,FALSE,2874,2469,Radiant
41bf71f4455afbb3cf58fc1c9e5915be,781,TRUE,1878,1097,Radiant
4ba9ae65cfa54efd63817c1a4217364b,559,FALSE,2014,1455,Dire
a78d2621764a2184776da06409f3fca9,37,FALSE,1881,1844,Radiant
00bf511011701848266f9486c6302b37,250,FALSE,2217,1967,Dire
0b79f89cf703da6586440f15753a073c,900,FALSE,2158,1258,Dire
5f393edefc7d4b1f72b3477db39fb631,1028,FALSE,1597,569,
03f814ff6f96cb6c0a0f416b6e341cb2,183,FALSE,1709,1526,
066c94bd163ad5d0928599c4707d6f19,1588,FALSE,3171,1583,Radiant
696d9cf6218a56406b7b3ff4c8691a22,668,FALSE,2909,2241,Dire
3857257f8a6ee7f6cabc1e10dd23358f,698,FALSE,1409,711,Dire
476d0f177b89d766f8599a4f1cd19b01,1123,FALSE,2630,1507,Dire
0ed36af7d5774823190b0a1439f3ff69,467,FALSE,1121,654,
a8dcf7c30751dccd37654d6c2637efa1,1024,FALSE,2614,1590,Radiant
866eeff8ad620a8b2030aa91dabc82eb,226,TRUE,2415,2189,
9a22537654aafe29a02d208170646aba,1104,TRUE,1657,553,Radiant
1f895b798459aa98516d87bedeea3781,462,TRUE,1383,921,
4ad3eb7fa0be7e2524eb3f95129c9532,1201,FALSE,1378,177,Dire
fda8018b6a280968a26e22c55c53503e,760,TRUE,3375,2615,Dire
19a7a67fc6ce93cb7a932ed9002f7cce,176,TRUE,2348,2172,Radiant
33e2aa01c34db73339f92e88f43e9b3f,1400,FALSE,1712,312,
c42c061e0b0238be1afdc32ec54954a6,47,FALSE,1964,1917,Dire
2432355229615356052eec79475f7210,2598,FALSE,2944,346,
f2dc18533cd0ef0b9d2b4795920f1e79,1571,TRUE,2729,1158,Radiant
14aa6626a7311ba15a4373c72cd58288,134,TRUE,1643,1509,Radiant
205ec1275139171a978f9ac427bb8c87,1956,TRUE,2568,612,Radiant
279694334bc04895e669388d59495102,2716,FALSE,2781,65,
9367560165d2c50dff7c582596a5b07b,762,TRUE,1842,1080,
51d3d11d291c76f548b2c5b92d564fc3,1519,FALSE,2622,1103,Dire
042fc4004c6d466b0c7b97d0d529f31f,935,FALSE,1756,821,
5766d67927586937f1ada0ff8e33f025,1340,TRUE,4151,2811,Dire
5c0f559f7761c4db5623929aff4ab52c,869,FALSE,1460,591,Dire
58c5457d5fb9c52065301a21455f350d,2954,TRUE,3054,100,
ea39f19c01bbdb13a37fb175203406e8,2614,FALSE,2947,333,Dire
a599f798b5d972596248274a75556432,957,FALSE,2463,1506,Dire
c65897cc0aa4a0a76e2cdaeecd145781,848,TRUE,2239,1391,
564e9ef5e348a3d52da046c003e6d53c,1170,FALSE,2367,1197,Dire
f0c920885e9e964785e3e6dd48e414ce,1414,TRUE,2417,1003,Radiant
d03280ff88e7fafe27ba096c0d596a04,1023,FALSE,1807,784,
829600fc2bb4e983489d40dd3d1957da,541,TRUE,1151,610,
8c5b4a89b503c4e19aa52e00a766370b,2687,FALSE,2874,187,Dire
bacce2b5a31f7dcfc094c0f4c6ce91fc,1562,TRUE,2025,463,
9af809ac1249234c49c6a5607298b937,1496,TRUE,1618,122,
eff48e9d57ac70364b8f0e5cf179e38e,90,TRUE,2590,2500,Radiant
08ad584c86f96d9261f3f477036224e7,2072,TRUE,2808,736,Radiant
f8bb98de2b71627f6b3e201c08b2f99c,1218,FALSE,2073,855,
b1da6f2fe03a7217129b6a6c11036bb3,551,FALSE,1652,1101,
e7b05226cf7b53762d491b0b0662ef6b,1257,TRUE,2912,1655,Radiant
68009c6dbcea9bcd639ab78f282ec158,363,TRUE,1218,855,
3bf3209526917076af7dea20220a326a,3524,TRUE,4429,905,Dire
8d38f94b77688d0f37ea605c1cf41b4b,1525,TRUE,2862,1337,
749a95f305187f42adc422e7c3943736,2089,FALSE,3499,1410,Radiant
08accca681bf58692488c602c838bb3a,805,TRUE,1255,450,
08fec2eed2a147f1d85d66e3fa49abaf,2785,TRUE,3646,861,
d8e0e2769f124726b9f9705bd275867d,774,TRUE,2231,1457,
0c6413f143d2c9f54ef5b11e9de4a4f6,1252,FALSE,1774,522,
750b1611dc82fd0b3035ede789eea7f3,2678,FALSE,2926,248,Radiant
bdb808ebe2751355a6849ff9803035aa,502,TRUE,2675,2173,Radiant
8a27d28bea0d11e31cd7868593d9b377,510,FALSE,2061,1551,Dire
28add548da1307d65c8de4187d6c9535,1027,TRUE,1596,569,Radiant
b0b1c9bc44ba10dcf6fa2dc92258ee36,1763,TRUE,2715,952,Radiant
1225a4a55a1cb415d6612c10e0b3dc0a,954,FALSE,1025,71,
6fd08a9bb8db8dce9de9967239c66677,1297,FALSE,2069,772,Dire
937ec12f44d13351a0fb534acc43c01e,2760,FALSE,3622,862,Radiant
3748f5b17a2c7fa8ebf77d7f51012a49,2110,TRUE,3140,1030,Radiant
cefd256122503b678e2eb64e788c364a,3669,TRUE,4200,531,
9b63e51d3d2af6bd56416b6a59d32937,725,FALSE,1964,1239,
31cd354719d9a92b98c960173e10e274,1014,FALSE,1917,903,Dire
b45491c15f70e31d7d8868ac09ae38a6,113,FALSE,1612,1499,Dire
bcd6e1bf46c22689610fb23b3bdb30bc,105,TRUE,2778,2673,Dire
3b26c92ed1b63f9de9c8b5567c4f2adc,125,FALSE,996,871,Dire
038893b4ecd7dd9da0ec8f52a72e65ad,1345,TRUE,2432,1087,Radiant
07987db802ce1a8115d553ee83be6cf5,1093,TRUE,2094,1001,Radiant
1ba86b2d5fc8cb319d713f21c014cf79,1148,FALSE,2545,1397,
3a55c907eea52c0ad78303cd17d66e3c,1540,FALSE,3137,1597,Radiant
ec3e58ee25fe539731219e59e59e7503,310,TRUE,2065,1755,
ce0cb2eeaca53aad80f22a89a3f1c393,1145,FALSE,1806,661,Dire
6c5b225171848f1ebb092ca20e5baf10,1929,TRUE,2129,200,
7d94077e706880709a3007753611b483,624,FALSE,1470,846,
26b5bee0049e7a0f37b4c0e22509e597,2135,FALSE,2484,349,
95dc8db6b36e0144d006ec4eb6cac987,61,FALSE,2744,2683,Dire
0a5f2ef60f887c4479d0926b3f1cd3ac,798,TRUE,1798,1000,
478037b2cc3cfdeecde3f743e78430fa,337,TRUE,1910,1573,
9836730c292743a14f11e179a95bf450,2307,TRUE,2585,278,Radiant
bb76f89216c5d4a9845fa8ee0c9bb656,750,FALSE,2095,1345,
5807a2adaabad2ecd16d0e8b631c1532,680,TRUE,1278,598,
9a7d284b4e3caac96d2f3b87405a279d,970,TRUE,1582,612,Dire
a43476ce9630177096ff4915aa638527,929,TRUE,1571,642,
542be8023dd8452370ff2b993cf81b6d,3873,TRUE,4705,832,Radiant
c4f4108bfb36c79c4af2635b9368a1e0,2009,TRUE,2162,153,
912d616a8126707a6e5a27aad32b73eb,2316,TRUE,2736,420,
9636e96dbbaf6347777f5372c7fee89a,970,TRUE,2511,1541,
beac4d1e1b25e9647596d5c6fe6f5da2,1340,FALSE,1892,552,
9fbd3c1fe17ea5a799c6ccafa08a0503,823,TRUE,1910,1087,
a4e1423e795522be96944eff26da08a6,1130,TRUE,1813,683,Radiant
58f995f831f3d49ad0a670fc7d472c6b,869,TRUE,1640,771,Radiant
3be51b928016528378d98409309f17b3,664,TRUE,3187,2523,Dire
69bae77f4ac910b61404b42e58424202,686,TRUE,1151,465,
d0d167dffba7cc3de386acbe4397ab36,340,TRUE,3013,2673,Dire
fb087e8077e4ef1d2021405929205e39,1656,TRUE,2589,933,
2050cece7fc6381693439fe34c59f9d2,611,TRUE,1916,1305,
e26d306c747277688d9bf16a6bf3b05e,1262,TRUE,2019,757,Radiant
d950e3b5475cca6d99fb85f1383bd465,699,FALSE,1972,1273,Dire
27a6d9416246ee8abe725084272e77af,501,FALSE,2146,1645,Dire
34c01f8911f0b2199d4d3ab269fdb685,1753,TRUE,2136,383,Radiant
ce9cf1a5a633b3b0be4d66c86abe2e06,143,TRUE,1521,1378,Radiant
610d3d196b4404a56bd6b9db681f5d82,523,FALSE,1703,1180,Dire
fe5a24371919681acbe077ea870f5c72,476,TRUE,1304,828,
550adf530ba61a66cc53c26f5bdeece5,1250,TRUE,1667,417,
95b73c760d94e6780fe09f2908a8614b,749,TRUE,1964,1215,Radiant
e826d90a663b0f10b0c3f2184a5eab02,1273,FALSE,1579,306,
f5194d7a3bc08083f9a7a3a91b47ed2a,597,TRUE,3874,3277,Dire
5470717687ffadb9408eb6e50518fb56,1750,TRUE,2735,985,Radiant
42202099a5acc78143b1bff7a5b1d1fa,754,FALSE,2342,1588,Radiant
5e4dbc5d622fc19ecfa59aebaec7867b,1060,TRUE,1856,796,Radiant
7fc400d3142c02d9cc8ded3850e29cff,1632,TRUE,2465,833,Dire
c343b5559cbe53153cad93dec46f29c6,576,TRUE,1907,1331,Radiant
6f566b102d13ab608a65f66e9bb13812,2867,TRUE,3015,148,
b7f1edddf8ffad52e4e191e379d46f70,687,TRUE,1626,939,
0ae9336ccb0ceb5c2daa2f7adce0de74,895,FALSE,3029,2134,Radiant
1b061c289dbd29a8a25aaf7801a9d2c1,220,FALSE,1153,933,
d69db2969698e324b04eab18de9b7cf4,1140,TRUE,1442,302,
0576d3216a0b4409ab7f01e718485356,823,TRUE,2702,1879,Radiant
796d79dc4bfff6c8cc003fcdb5abbc71,124,TRUE,1768,1644,
b690de86fe20cc45b8ce8da4c67765f5,356,FALSE,2124,1768,Dire
058a40264b731f97e3110df853127fd5,2385,TRUE,4633,2248,Radiant
39533a39311fd7a3d6a6b5a70fccd97e,2455,FALSE,3100,645,Dire
d007ae31fbec427f497877791e75d058,2050,TRUE,2209,159,
b72f2df88edf330eaeaa59c63f7c67df,426,TRUE,1979,1553,Radiant
f803f0b1cbf911493e3788cbe9b1ea7a,2292,FALSE,2417,125,Dire
0d6e068630c40ac52b0485eaa4c5ade3,1374,FALSE,1732,358,Dire
ace9ef5368b630391eed0acc6aa1e05f,2166,FALSE,2662,496,
d87f0e66b8a2bbdf2264017931d8f01c,2099,TRUE,2560,461,Radiant
513926f6147189a1f8dd3fb009f0a0d8,1306,FALSE,2437,1131,Radiant
db9dca33e4f2db0c84b158c1c46d3f74,181,TRUE,1023,842,Radiant
fec8997154733f2c9e10e43bf72f0f76,2236,FALSE,2353,117,
8b27f9d731f75d26945bd2c7a6ee1758,1074,FALSE,1647,573,
a465ddb6d2855a4710f6ab5d6a3fc6cf,1627,FALSE,2188,561,Dire
3cbec618e66f472494aee4986ed56c43,2324,FALSE,2486,162,
f8b0702ad6f608c643043b275c9b87ad,2640,FALSE,3775,1135,Dire
2a0b5e25b6106a04b1868661fbc44d78,1687,FALSE,3102,1415,Radiant
4a2c3d661ff970713b6121e0a6df3cf1,1863,TRUE,2039,176,
369eccd2e397044f2b169406a998b6b6,1537,TRUE,3258,1721,Dire
5ffc223326a8300d106898798377a6f1,564,FALSE,1128,564,
f826b7637be5b3803afa8016cbed4b6b,1681,TRUE,3690,2009,Dire
b62459d2eb642e9d14590ffd00a5902e,2560,FALSE,2656,96,
6dae31b4477d6d824d9d2b58d36e2d83,495,FALSE,1942,1447,Dire
a9c09e72d72e689ce2673cf4a44b4b38,1533,FALSE,1695,162,
71e6cceaf0ab4d358307ef9392265783,1682,FALSE,1866,184,
d6a870f34b3bb77e9b1b1cea7b00d793,1888,FALSE,2300,412,
367b2eb7a4674071b35d7877c2532899,1582,FALSE,2841,1259,Dire
6f6b911c3f37390231dff80a95b77113,965,FALSE,1658,693,Dire
9ebfc805b759693b4e1aff7f3e178c81,1646,FALSE,2254,608,Dire
4d65650e8e593e9c686e0facc53209cb,754,FALSE,3069,2315,Radiant
23de015f9967385987f10d6205e0f821,903,FALSE,1949,1046,Dire
a21a34fdd8e8f348f27f84030cf0a048,604,TRUE,3431,2827,Radiant
8d234879b581dc660963002134c77d55,1925,FALSE,3165,1240,Dire
a8195dfa1c70ffde5db7b9accd65a6c4,301,FALSE,2515,2214,Radiant
f4d273cc0cc5830c47a2911e2953bbb9,175,FALSE,1561,1386,Dire
52533bd2fdbfb220678729abcd36e956,984,TRUE,2459,1475,Radiant
bde1adbd2ca4cc9495980f84fdb3a7be,251,FALSE,1670,1419,Dire
df63e16d72aae2e65a5e2b11166ee7e4,308,TRUE,2893,2585,Radiant
25d49b3c440002a425df92a55c366d8b,1345,TRUE,2672,1327,Dire
61549ec036c55cdcaff8e4ee5e99934b,627,TRUE,1530,903,
5f5cb874e62812b1df17bd5bfc4082de,1255,FALSE,2156,901,Dire
3d76b0caeca06539efeba4ab8b2bab54,98,TRUE,3060,2962,Radiant
1eeaff1ae4652a67559476eb332d86bd,1274,FALSE,1361,87,
fcc1c440ba93f304db982a04483e0c47,704,TRUE,1932,1228,
9e1f35ea1be53df75d0e77bfeeafdb9b,1855,FALSE,2220,365,
244239be48a1cdf1d3451e5424a10d26,3060,FALSE,3398,338,Radiant
6aaa5eacfa0fc4f500aeda47903a8592,689,FALSE,2417,1728,Dire
b7265ab48638cd273603052a02b78b85,967,TRUE,1887,920,
a48efaeb74e4ba4ed82fd75ece0ce536,1940,TRUE,2529,589,
501bc1b426046a0d0617971b39945671,1875,FALSE,2568,693,
a5f50a810986620e5349fb51bb8ec403,1689,FALSE,4139,2450,Radiant
d2284bd43e3b2f85157b4466d8aa1eb0,1441,FALSE,1509,68,
81ef24fd20134a65108c7def232fcae8,1471,TRUE,2483,1012,Dire
7ba76327838992aba11436bfb7e86e5a,3239,FALSE,3791,552,Dire
99a070bfb744e69578d05ac92db06230,64,FALSE,2161,2097,
213011cf7596e725eae96507593a7598,87,FALSE,1919,1832,Dire
a6bae5856032f95837d7e1e9d793f02b,2335,TRUE,3025,690,Dire
600386aff68916c58b52a4f293ba0a82,2379,TRUE,2591,212,
a520da1789b7aabb0024d6c1f3110e06,382,TRUE,3091,2709,Radiant
a0d7da277278b4947dc7063c4c1ea1a6,2585,FALSE,2826,241,
c93623d5426755a609c3a1fa5ee8756c,1280,TRUE,1480,200,
e72ef14e6f8d533f74e0ac58dd8d3f60,1457,TRUE,1500,43,
1c9adc860a58d36fc9f0df82035179fd,1766,TRUE,2217,451,
d7b820b2c70d868f3f45acf0898f818a,566,TRUE,2463,1897,Radiant
7b3ff58d56484db3c42ae38153aa9318,1249,TRUE,1292,43,
80f6b4fdf5de7474bf1114c2c95b14c8,483,TRUE,1462,979,Radiant
d5d2e3dcca8db1b6aa2666a20e40509e,1108,FALSE,1738,630,
a27614e8215f1f8b9bc762fe712dec12,451,TRUE,1166,715,Radiant
aaee459034f17886f0dca6de00692873,1939,FALSE,2214,275,
68bc3081c6708b34ac09b491f99e435c,1280,FALSE,1351,71,
5a7dcb9b70066f4742328e7acd6e9da4,13,FALSE,1502,1489,
c3428b4d7f83526133ee01b65253a16e,3432,TRUE,4260,828,Radiant
087cf0c3f2dcc669072c2f126512a8b1,880,TRUE,1835,955,Radiant
167c12e551bebb3734fcd8bd99f3a742,2725,TRUE,3175,450,Dire
3a0ccdd009288ae87f85a4b3263040a7,2250,FALSE,2865,615,Dire
8ba371da85c88fd0ced84f71c9cb327a,102,FALSE,2957,2855,
2e9747cc9612292fb6eae83ef543d590,1378,TRUE,2191,813,
8e3a10f687bba7e8429ad50dd7e034ba,774,FALSE,2589,1815,Dire
6b2e5729f33c7b5382bfe65bc87e8948,153,TRUE,912,759,Radiant
cc8a00b609292a73187e45a3380d20f3,1038,FALSE,2968,1930,Dire
c7b0eece794dc669c9b9493c848ad7af,1888,TRUE,2094,206,
4d81d99be52d5823cd1f6d2cd2f24c24,535,TRUE,2010,1475,Dire
152b15c14fa27165fc39682145422bec,255,FALSE,1626,1371,Dire
8db996d64f0dae465e8678c45c640b47,1221,TRUE,2795,1574,Radiant
50248e605e27e3adb6e555567fa3d807,1049,FALSE,2267,1218,
d252176d05260124f7626cf448626152,1894,FALSE,2238,344,
a5b616b9b973b893c4f28b8bb9fe1d38,923,TRUE,1673,750,
ff632f2edca83feb2ebed611641dfff0,2962,FALSE,3720,758,Radiant
44564b4528c520b4d50b513f9ff600e8,1546,TRUE,1758,212,
4861bc9e66cee98d874417607a6d5eb3,2068,FALSE,3388,1320,Radiant
c4c23f414fe5af28637aac04036b2f14,627,TRUE,2535,1908,
e5cddb3abb70d9df1978fe51f964c5ef,1442,TRUE,1555,113,
d6d7d449bc317dc232232ade665e853f,367,FALSE,1912,1545,Radiant
69980d9d950167c8f65434ba14ae2c14,27,FALSE,3085,3058,Dire
ae0462c7d305053ff2403c5b9d21d049,1202,FALSE,2357,1155,Radiant
abb7cf576e4f192a7eceffe33afb9970,1637,TRUE,1701,64,Radiant
d5e11a0d50d946fa9faa349c1f5b171b,1415,TRUE,1518,103,
0f70e56fd39db51cf14d5bc3692a3fc1,2467,FALSE,2881,414,
efa9f1ea26ff27646f58cc72b213a185,910,FALSE,2113,1203,Dire
970a7575e7f82faa87a799b04c91584d,416,TRUE,2645,2229,Radiant
2c53594bf20c2b53f85a6ea90b4dafbd,59,TRUE,1972,1913,
b8e385aa29ab046ac9d7b8793a66615d,785,TRUE,2572,1787,Radiant
146fbbc508df63367d08576d7214be28,1364,FALSE,2434,1070,Dire
f3354f8e60b438bea38360ec85ec3eca,859,TRUE,3211,2352,Radiant
c5fd790433a2a26699919f69d406ac01,1819,FALSE,3939,2120,Radiant
7e60aaa2f4c19d059289afee0273729a,509,TRUE,3481,2972,Radiant
f8d3a30a2c4bd536a03f5062adabb50b,958,FALSE,1019,61,
a88d2cb8512df53846290aa52ec1c6a9,689,TRUE,1542,853,Radiant
295bac1b4e26fb615116939dd8409bfc,2010,FALSE,2401,391,Dire
71fda82717e4ae36913e208c31ba1a87,56,FALSE,2521,2465,Dire
d1f4cc291f06986e23ab68076e1efdef,952,FALSE,2173,1221,
bca01c7e0bf75065fddce3d7a540a4e4,1724,FALSE,3956,2232,Dire
c13d756990b09e4acf9e685b790b4b26,834,FALSE,1772,938,
9f0750b72c4c6d1c7c3831113c1c349a,1413,TRUE,2071,658,
c5a9a04c0d6e46ef8cf7ae3d8af9cf7c,852,FALSE,2907,2055,Radiant
e0a089132f346dfe43e597798d9cad8b,1185,FALSE,1321,136,
bc2d57b099c0bf652600769e10099592,1381,FALSE,1819,438,
c33bf7de67f08591b6bc978896da8a16,837,TRUE,1963,1126,
c42271129bab0bab154910fd93c42e50,1486,FALSE,1939,453,
b15b0ab12da667d075dcfbd18ac6920d,766,TRUE,1775,1009,Dire
b9fc02be02762e77ddd1ea47003230a8,453,TRUE,2990,2537,Dire
0bd25933247dd73d5838ea69ac603f2f,1477,FALSE,2603,1126,Dire
d00f72add3e4d4799100168f4d864403,1354,FALSE,1772,418,
1fb5bfda1c497a165470e5da68559457,1744,FALSE,2608,864,Dire
eb02afcf4d0a27b43611ef1a173ad2ac,1827,TRUE,3223,1396,Dire
b32162ccca49a794fa1bee66f9015fbc,522,TRUE,3349,2827,Dire
364665875283efc0f0bbda3091859023,1929,TRUE,2058,129,
d98aaa73b9f35af367803b2f87161d7f,1671,FALSE,2206,535,Dire
32e47e0b4a655b6a43ba4885b5a99e5c,2146,FALSE,2417,271,Dire
1ded4049d93105a3aadd09255e8afb9e,1067,FALSE,2800,1733,Radiant
abb23784a33a24b07d65969a86c4020d,1009,TRUE,2215,1206,Radiant
2cab84c560bfc7c6053f016139cca909,1943,TRUE,2562,619,Radiant
08300420465c19f4daf2026d55bbac09,1296,FALSE,2546,1250,
3136f8de1fb6e37c388a6a173341cfc2,993,TRUE,1569,576,
17509970526b0df019cb9219b17ab875,1342,TRUE,2461,1119,Radiant
d58828d6c1aa195ddff8bcb3e72e5da1,1598,TRUE,2243,645,Radiant
ef8a330689b7d5b956f78a03e1afd52f,453,TRUE,2128,1675,
bb12b1e1e1bd7349cbb8af535f463816,997,FALSE,2045,1048,Dire
576aa3689cc5964d06a8c68954ddd640,590,FALSE,1577,987,
767da6ebb923f56ab618ab3c1c1c32f6,783,TRUE,1958,1175,Radiant
38e68de85d760c8687bb75e00e11e6a6,1264,TRUE,1844,580,Radiant
4111315adf34866f0c1e74d28bdecafb,911,TRUE,1953,1042,Radiant
562a3e586867ac0143e1e8e0ee071ce3,2322,TRUE,2626,304,Radiant
3c4a35a734302ff45a3068c478bf87aa,139,TRUE,2604,2465,Radiant
b5cbf77e99ad9315d05021860f9b73d4,256,FALSE,2082,1826,Radiant
d3189686440cc3d92d857cdbbc2571aa,2028,FALSE,2271,243,
33f8c6d560b3a42e5367d0484ce5be81,778,FALSE,3016,2238,Dire
09cd89c52a5d34dbb0ba6f8cf1a1d2d6,1597,FALSE,2215,618,
a75e9128278c24b89d36955796638b5f,802,FALSE,2672,1870,Dire
18bf36d5f8cbc807959bdbb30ab2c2c8,90,TRUE,2508,2418,Dire
fdc40fe164537a750f140ff2ee9f1591,391,FALSE,2873,2482,Dire
f33958add56242a81cb3560344aa1d21,723,FALSE,2981,2258,Radiant
4a8ebea0be9ac0286fa8cd6a8cbca585,478,TRUE,1489,1011,
2e87a6a24a0425547184de59d1718b44,1021,FALSE,2408,1387,Dire
617bc8244febf899feaa35bb9d7bbc63,791,TRUE,1082,291,
a2bf0b8da7baabad23b62189fc948cab,3277,FALSE,3392,115,
df747186618e51a967084c30b4fb1999,1801,FALSE,2358,557,Dire
647300e6fb9dad29988a7ddb332e6b58,2060,FALSE,2271,211,
be6131da39c3f47758ca7a8c1baa6871,453,FALSE,1486,1033,
50a20c650e4b366b5d0d5191ae7a1ba3,1858,FALSE,2593,735,Dire
d0897078fc16e29b49b22cd24e5c331b,1563,TRUE,2410,847,
0bc4b35c685b2fba500497e5c8b2e563,2008,TRUE,3092,1084,Radiant
4ae4ecd0acc02ecf8757bfd006992d5c,965,TRUE,2013,1048,
5297e99cbd5a5d2940434223ce2c2b19,340,TRUE,2129,1789,Radiant
d1da3720b5b2199b3964aa9e42916c42,669,FALSE,2639,1970,Dire
31afb9017cf7da30edf867945b91aade,1967,FALSE,2511,544,
1b6e8f33623638d065bca4128f7b509a,1362,TRUE,1735,373,Radiant
66b767ee13b2c291474147e021d62a94,1295,FALSE,1669,374,Dire
1063658c5b3b33d9fb33c08408dc3555,1433,FALSE,2871,1438,Dire
178087d513575c0b3f9265941d50f670,1206,TRUE,2147,941,Radiant
8987dabec0f92a992c4ef1333ee3769a,1821,TRUE,2396,575,
15d80ce443320ceece3f67e451759ab1,1443,TRUE,2960,1517,Radiant
860fc5026b6a739ff94ec8dbbb640af2,1370,TRUE,1996,626,
886ff02edb9dfaef51ac512cedc65adc,542,FALSE,3089,2547,Dire
93365c5f1d90b9ba808a1d046efc8bc6,407,TRUE,1923,1516,Radiant
4061da4691176259f269e18b7ebb2960,1517,FALSE,2685,1168,Dire
00cd7fc2ccf97750ea93ac085230d08d,976,TRUE,2176,1200,Radiant
062c3357d48c2f4bcb47c5a47fb4ae49,215,TRUE,2244,2029,Radiant
93ce9555e74e1cac7572a7b84620f505,2149,FALSE,2992,843,Radiant
b7d258406a17fc523f5fbe120ffea51f,1198,TRUE,2519,1321,Dire
851c99d8fdde51286f97fdfd4727fd21,2178,TRUE,2886,708,Radiant
285163961a47020b7f47755c03657e78,691,TRUE,2625,1934,Radiant
bb55a6a66001f81eb5af692a318246f5,894,TRUE,2655,1761,Radiant
7717f41c13a8e5cee12e457b3a9e411f,173,FALSE,1076,903,Dire
42c939bee3dfdf99dbbea0da58ae9c87,1768,TRUE,2171,403,Radiant
5652943619090b6309188750d04ce233,838,TRUE,2217,1379,Radiant
dc98838fbe0968897b2c633dd4555539,59,TRUE,2425,2366,Radiant
6b62aea59c3d069c1318e82beb375fb9,825,TRUE,908,83,
a24559f9f00ed177febcf9d393611745,1568,FALSE,2283,715,
c4224c9aa166ef984b83ecd73ab79c5e,139,FALSE,3029,2890,Dire
4e0430a825e058e6b361c00adfeae52d,513,FALSE,1836,1323,
140f554d6d0bacb4703974bbc22c699f,2063,TRUE,3823,1760,Radiant
489f527c08c27e4207f7d289e3a34497,963,FALSE,1711,748,
f7a98e5c38cf1b54111f92483f28066c,926,FALSE,2020,1094,Dire
084129f83133fa71b7748db7800410da,1777,FALSE,2330,553,
5f13b5cd4880340705922eb325ff7454,1786,FALSE,2078,292,
fdeb0b1b8fa6ccd99c3e7d9859b74260,397,TRUE,1783,1386,Radiant
53d1a56e370a69fd01a2715271409a4f,145,TRUE,2485,2340,Radiant
66be5a215a9c722a3bfba10b4dbaf93d,1351,TRUE,2173,822,Radiant
13be9cb6e02114bde54a9adaa44fecee,2122,TRUE,3543,1421,Radiant
75586eb31a5b171763f3eac887c0d6da,610,TRUE,2824,2214,Dire
4a0f748aa446e28d4a80350158518f7f,1676,FALSE,2656,980,Radiant
7ffc6ab82f828576bf7e2a0ff3bd4f93,251,FALSE,927,676,
aa597397dc204acc3a488b30e82c1108,737,FALSE,1767,1030,Dire
1ccc3a0f83cf62ab96639050e9a1dc41,1668,TRUE,2435,767,Radiant
2313a8d5b8423cec92d2166a4af1497e,2273,FALSE,2699,426,
da407c19944b0fe9dff1db3d1c25f04e,1235,FALSE,2243,1008,
bba804820eaeb9b7433a0af8946bacd4,435,TRUE,3401,2966,Radiant
f0657af7c437b09108ad00db7cdf6e67,593,TRUE,2479,1886,Radiant
239c6a3b0e170b480d1ff3ad6290f500,1985,TRUE,2086,101,
4d527a181e91a34f2abc8335c174027e,1189,TRUE,2224,1035,
7033ebcfcfd8463a5dedbdbfaf00b5d4,1591,TRUE,2286,695,Radiant
e17ca580873f34417b91baa5ae4762b7,1677,FALSE,2551,874,Dire
fb902ee12f9adfc6e61cb9afd506184f,1117,TRUE,3730,2613,Radiant
25dd39544d09c308a9b68fd9810b0f38,301,FALSE,2655,2354,Dire
c2f04a5280e663caf05e8959353a13fb,671,FALSE,3203,2532,Radiant
5b080e28ded01965d926151e8d34ffa4,191,FALSE,3450,3259,Dire
b8b2a44389490950ff66cf5e11c323ec,629,TRUE,1063,434,
2002206296870240addf0ae7b0a4fc89,2674,TRUE,3086,412,
73744a92ce8e3ccdc1be37436344b60a,242,FALSE,1667,1425,
485aa9af53f556d7c3767692c924d7b1,1381,FALSE,3203,1822,Radiant
0244540ec4117d94c37b5ed83a079c5b,1545,FALSE,1877,332,
9c3ac63b829b4c53441c40b16ec34d25,673,FALSE,1810,1137,Dire
222d11868325d95460898b3707ec66d0,367,TRUE,2209,1842,Radiant
0fd48f008e60486a9f668a21745edbb9,1662,TRUE,2588,926,Radiant
41673aefb645dc07a4f05aa10c8262ba,1263,FALSE,2170,907,Radiant
ff2954b411db4cec90647c3b886f6cd7,2601,TRUE,3411,810,Dire
e359fd63729a5dbf861b45acf4d439e0,3311,FALSE,4448,1137,Radiant
8d79d48f2c970bd11812b72cbdf93c57,2332,TRUE,2507,175,
113e38cd3924cf12348bac89babd0a75,430,TRUE,2317,1887,Radiant
eee2ee73ecbfa673bde50f974cccc8d3,586,FALSE,1794,1208,Dire
c57b7d430daf15890b61219022febdc2,650,FALSE,1428,778,Dire
f83be7d4f3e8bb0d6cefc2ecd6bdbf91,2249,FALSE,2600,351,Dire
064c377db41005965910e91793ad55b1,2913,FALSE,4028,1115,Radiant
de2be0b25d2d0377730962f50e20cef6,1344,TRUE,2938,1594,Dire
d74769972c8a9ef6595dd76ab0a6998c,2605,FALSE,2873,268,
56f79d5d6273081f21a6717a7ade0ba5,476,FALSE,2576,2100,Radiant
7dd7c48b444c5940d7480715a5b3d2c2,1002,TRUE,2163,1161,Dire
a920fc91a6fe49332731bcce1b00b126,2568,FALSE,2660,92,
bf09de8e89f206bae6638b6d14071a5d,963,FALSE,2058,1095,Dire
fde1e8264afa4e18f3d6d2d3109decaa,238,TRUE,2460,2222,Radiant
5cd2aa62c8ef8c9b11b0c060561365ab,951,TRUE,3586,2635,Dire
348060d673adc5ed793556ed2e3aca80,201,TRUE,1717,1516,Radiant
a17b0504b8cbca77f552e1264bc1e171,908,TRUE,1764,856,Radiant
357ab8e06b3a4273f582db251d35efe0,1362,TRUE,1879,517,
abe74f947f67b2756b85dcb894aa30e0,989,TRUE,1386,397,
37301fc16be58103056893aab982c277,35,FALSE,1195,1160,
4a5bf8cc397a623800342feefaaa2a31,1768,TRUE,2020,252,
9bb0e6459e43437da80fa4b8d75a8b44,599,FALSE,1522,923,
77425f552fe227639f1e6a21cdb3cd30,513,TRUE,2508,1995,Radiant
4b0c3e0e2d1e000b49762e8533215ace,618,TRUE,1016,398,Radiant
6242955b3ebd735f911d7b5facfd16b3,379,TRUE,1165,786,
7181c40faf3ded7dc3e375e19e04c88d,1137,TRUE,2274,1137,
06327288c4bf217f88dc2995347f4601,943,TRUE,1976,1033,Radiant
02c01ff3214c4a4366c0bf25efa76f22,1539,FALSE,3124,1585,
e0323738f08dc7b66a89ebd13573938f,428,TRUE,1323,895,
e5d8cd642742a9db60e3016e781fddd6,186,FALSE,1889,1703,Dire
395618a3a8c44e028355dd7587e8f0d4,48,TRUE,1802,1754,Radiant
9b086e024b3409c80581f5d7a4627c5a,474,FALSE,2368,1894,Dire
f99cf8e7d76ee571eb7998e0481c0681,100,FALSE,2051,1951,Dire
54c87756c3578a8e37d0b647c47f450e,1663,TRUE,2035,372,Radiant
2ae5c934ba8eb5dd02e893c10c59871c,401,FALSE,1627,1226,Dire
3e04dc43d39e69afb57f4cf2dcd3e3a0,848,FALSE,2392,1544,Dire
c483faeb0a2d7635351c3f8f48dafb4f,894,FALSE,2440,1546,Dire
f2f09d4f082334b0fdce0de13c0c4c5a,1489,FALSE,2502,1013,Dire
5c04642e12e3b843d45cdb64bd24e819,965,FALSE,2544,1579,
6dfc1b919131b77517f99cd7eae4d07b,1321,TRUE,1932,611,
5bf482fdfbb3a1de7718e29f265bd953,2497,TRUE,3664,1167,Dire
8181501b02769e9e6506ec4a933c23ff,404,TRUE,2390,1986,
48549ef494ac6d8c01a7c59de617993e,1653,FALSE,1762,109,
664f72c328c2e2e179373132ab82b98a,799,TRUE,1929,1130,
d0603add62e5ac225b30648562825367,891,TRUE,1793,902,
2afb6cb8ed3ae37967abcad55f6a4768,1019,FALSE,1572,553,
3942aaf60d122fb81c6d6de9268b1508,675,FALSE,3189,2514,Radiant
352ebd2dfe101374b05a3ee693a1f0a2,621,FALSE,1346,725,Radiant
b19c3ca490e1b44b665629be02609a9d,282,FALSE,2359,2077,Dire
975637def01405de7e11812efa79aa4e,3238,FALSE,3643,405,Dire
6afdffb09f70e0be262b45f40e38938e,1023,FALSE,2179,1156,Dire
a865b8457c3470f783483a9787d104a8,1152,TRUE,2461,1309,Radiant
4c8dd7b73691970bb140195d5a21d5b4,1283,TRUE,2452,1169,Radiant
57a57b1199e7fa7f97eb574cf47566b3,463,FALSE,2290,1827,Dire
6e8882831f94bed2c123a0b58596a03e,651,TRUE,2245,1594,Dire
f0e6c9f6302db5700ae156ec3b7737ef,894,FALSE,4348,3454,Radiant
2eb1dad77974f3ca9710e15e1a71c475,832,FALSE,2494,1662,Dire
993f0c1eda92e6f0cbe219eb000ca635,1147,FALSE,4633,3486,Dire
1a57db338b8364c81f4b41877beb1ab3,86,FALSE,1887,1801,Dire
1be048f8facdd34f381c93c4bd5bd29e,572,FALSE,1738,1166,Dire
b4a1be523b0573020026c01a4c05b2a4,772,FALSE,1876,1104,Dire
7781bf816b3123445bea5398651b68e3,1352,FALSE,2218,866,
0359323dbac06253ce13cb9bdb71f2fe,1221,TRUE,3081,1860,Dire
2c013e48f18149768793c9c01868659e,1322,TRUE,2358,1036,Radiant
ea75cec991288a24882fead0d3f8cc8e,1544,TRUE,2490,946,Dire
90018ff40fda931eb395ac2512e7f21b,973,FALSE,2373,1400,Radiant
590b2dd65e40502899c87be6d70d8b30,350,FALSE,3533,3183,Dire
f318323b794dec1f9897f2deb14a101d,1462,TRUE,1855,393,
b1747c5bcf0f51f2a6b28ffe7d0b840d,346,TRUE,2049,1703,Dire
1d44de8b37c3059e114179b9b6c2bc0c,2418,FALSE,3180,762,
28823f038b785b9e839e88f335af69b1,2707,FALSE,3593,886,Dire
c1163d173bf327895a9c9037a1ec60de,405,FALSE,3508,3103,Radiant
c5e4f6d888687e7e58c648a887201885,716,TRUE,1806,1090,Radiant
8be1ae5537808881448b0194b686bd6c,2369,FALSE,2745,376,
c745fe6ce4cfd99f851508444a6274ad,2689,TRUE,3884,1195,Radiant
93d67508d6d57660d5e437f53cc32a27,3195,FALSE,3735,540,
5c1429b0d7c4e579bb84e6cf034be395,1118,TRUE,2193,1075,Radiant
ab78331a51cc25b9edfc3ca294cb77c2,99,FALSE,3377,3278,Dire
359c81424f45dfcc6f08b9d58646074f,1684,TRUE,2343,659,
6524d04c761bb094421f584ac614cdcf,2439,TRUE,3030,591,Radiant
c80be47291fef4e3dd769bdd22d785b0,680,TRUE,2097,1417,Radiant
278fafc9311608dd1fdab8ecabbee4f4,133,TRUE,2168,2035,Radiant
edd340dc461671bf93f057d2db57a135,211,TRUE,2071,1860,
34a305ccb544d68103f6ab7c3ebf3b63,851,TRUE,3354,2503,Dire
9e1e37cc7e27abf5515fd1b6f6a7ec3a,357,TRUE,2844,2487,Radiant
ecc481a1018f3633925e94bce8c141b0,1279,TRUE,3126,1847,Radiant
e68808ec64289ac383320c5b9c0757b3,238,TRUE,2243,2005,Radiant
085aad5d41ed5fb0c37812b19fcde60a,601,TRUE,2262,1661,Radiant
f8b6ba2af55e0579df0aa2fdf4fe7823,1102,FALSE,2534,1432,Dire
e815327ca904ac9fb860accc1818ac36,170,FALSE,1675,1505,
2133831a6e7919ecd338e7bbc7c27294,959,FALSE,2926,1967,Dire
9b3a002fc42d7243e2964f8e4a72ef4f,2280,FALSE,2749,469,Dire
b4c849cfaca183a039cb86c6b7fa8562,738,FALSE,1446,708,
a4a2c37a6d21f5bcc6a1e57f12c90862,1248,TRUE,3416,2168,Dire
2887ca275cc589fd426f234449198912,716,TRUE,3932,3216,Radiant
0f83c7d4b29e2477accaeba4ce77d2ac,288,TRUE,1364,1076,
aedcf74b7260e60a2cbb2194ce2a6971,760,FALSE,1566,806,
c57607fa809b2c85e6b7b0a775a45135,1260,FALSE,3198,1938,Dire
b55ccd5467cef31b3fc343f8c6bc72a7,2585,FALSE,3109,524,Dire
cbde90f11d30246a91f89bf006e3b505,684,FALSE,3291,2607,Radiant
63657ea74e6ef74c12d42cd2e617cdfb,928,FALSE,1694,766,
06fffd8bc9aff2621a05621f93049d7d,2289,FALSE,2495,206,
ca86a9b0bb26f060a5924b29217355e3,1112,FALSE,3384,2272,Radiant
eddb7a93e6e5745af5250e3f08aa54ff,2722,FALSE,2952,230,
230c85432329c48fd7f5f36684286c0e,880,FALSE,2028,1148,
5c6cd2bfa7ce398ec9d1bdd526d48088,1477,FALSE,2832,1355,Radiant
96d6c4f20dd97431c217f000cebc569a,1160,TRUE,2898,1738,Dire
ca5d1b76bf4e4732039329ab1014ecb1,1193,TRUE,2609,1416,Radiant
fa218312ed595a3cc462bf6afa05240a,908,TRUE,2452,1544,Radiant
a6c54ea48952aa7202fa832547505817,920,FALSE,1878,958,
76a05fc9ed7c3d98a116def9e3a6866a,100,TRUE,4000,3900,Radiant
691abfec5fd96ceeef5b3b1c8aa8b1d9,695,FALSE,2139,1444,
1a37cf454c70af5d2add43d71a526b94,1742,TRUE,2183,441,
ffd7d7e30ddd74a208c0d640bb579541,1695,FALSE,1918,223,
1aaba706b7071a6ad476bb00358e397f,788,FALSE,2935,2147,Radiant
c7e3cd7525f4492a6dccd42b154ce9d8,1965,TRUE,2538,573,Radiant
d0e39bde879f5238076f96d52afb8778,1182,TRUE,2987,1805,Radiant
2fc4c9a966448ac63f20f2eafcadf5f2,85,TRUE,1285,1200,
4cf501dc372fe6614b2977a9f6bbe69f,1094,TRUE,2040,946,Radiant
ee417485d47415e07d14b8a3ce482f24,594,TRUE,1886,1292,Radiant
83fb467f3b3128559e7277f4abdd70d4,207,TRUE,2248,2041,Radiant
7ef467b1f708ef7bbce153d7c988a231,1356,TRUE,2321,965,
4faf8691343804e14ed71fed10ee2f21,557,FALSE,1674,1117,
3e7b22db8d7cc0b2576450d67ec8c7e3,3425,FALSE,3609,184,
4e8a13ea495e888a15a4e55340d54e20,857,FALSE,3551,2694,Radiant
cf180be76ccec8da3ff8f93d9ad80d0c,713,TRUE,3138,2425,Dire
d6c063fa84f9bdc2a380813ae077ba89,977,FALSE,1635,658,Dire
819f9ba6832460cdc0d4ac389b0d8556,991,FALSE,3253,2262,Dire
7a659dca589f9993e190b27491cceaac,45,TRUE,1692,1647,
70b11aa640d2788f6efdef52ae11f116,2322,FALSE,2842,520,Dire
a7abb01f5912d48fd7d7f5fa44c64705,1575,TRUE,1608,33,
e8d537bd963c3e58399689c0af8674f4,2232,TRUE,2687,455,
413bbeb69826d72eca6685d729654218,425,FALSE,2084,1659,Dire
2a353eb474a6460c8da4ed051c57139d,982,TRUE,1605,623,
6c954a0c38bb1cbfdaf3effbe1bba01a,362,TRUE,2580,2218,Dire
89b454ff5ab04171d2925e4145c36d02,98,FALSE,1016,918,
7c791fe17b46e5a7839f6ada3bde562a,1792,FALSE,2142,350,
a9cc6a7d3a9c922acfeba349dec79274,882,TRUE,1035,153,
7cffc72516c9c5b1ea8832c6d22abf54,2815,TRUE,3746,931,Dire
b268be48228bd501246921accde40a95,1229,TRUE,1475,246,
7426af9c0a452d95e2cd431bb16548a7,592,TRUE,2590,1998,Radiant
bbbba7cf099a7abcc1d428d34adc27f9,259,TRUE,2057,1798,Radiant
f9f907085c8b8071c46e5cb953fa8e1b,228,TRUE,1967,1739,
3215a5aba03402cd0e05166ab1c1f521,214,FALSE,1129,915,
4c99dd865f97b69096ae423502553792,325,FALSE,2281,1956,Radiant
f737a4f6a0b147d4fbfb6eb20a831060,67,TRUE,1857,1790,Radiant
a10811a59c58ff8dac5b7426d11d3640,800,TRUE,1485,685,
782da767721744a755983dd170671c18,521,FALSE,1483,962,
d691a3d59326953347165cffdd571d1f,475,TRUE,1629,1154,
bfeedbd432ab7cb3043774ca6d0e2ce6,877,FALSE,2171,1294,Dire
57f76fae30ca455bbc1bd7d5a32df7ae,1139,FALSE,2195,1056,Dire
68aa7970e0ae623e2afee4c23fb77ce9,1431,TRUE,4016,2585,Dire
7a3dc82b02ee248ca7176305fe22aec8,167,FALSE,2121,1954,Dire
6c0237feb025404b018e91df6d650198,2475,FALSE,3000,525,Dire
cfcc35922dcc3adeef9aacdfbd7ecce8,1190,TRUE,2197,1007,Radiant
c4714aab9ed90b0367ae84f0a03e6ca4,1263,TRUE,1660,397,
85e93be456df1963c8c05ffec59e5fab,1373,FALSE,1760,387,
24d8049e81a5bcba4b5de45da2a91d94,1368,TRUE,4014,2646,Dire
1108e0076c40634b74b6ac1103a9da0b,40,TRUE,990,950,Radiant
d51e3e687ae1b64b373bfae689e56f03,1941,TRUE,2087,146,
3bf473e818aca3507933609fa2b4bca4,556,FALSE,1980,1424,
a3585b530d8b3b8c2d181e3fbbc36267,457,FALSE,2845,2388,Radiant
24d368abbc93bf108e4ac44ebb910842,1464,TRUE,1600,136,
b50402987558aa05ebbbdb845b2ff3af,1102,FALSE,2907,1805,Radiant
16d9db588cf4593221f7fd480e0fe8a7,2068,TRUE,2728,660,Dire
75b1e64ad1f62d387b5c2b61b7e30526,1871,FALSE,2178,307,
782eb208472a49c425d4c9a06ff7aec7,1583,FALSE,1902,319,Dire
c9bd6136c69e739f7849890b8bc3ed88,2939,FALSE,3113,174,
07c2416be06c465059de0877daa2aa0f,776,TRUE,3450,2674,Dire
3c030bac33ebea7a70c19cd0b1cc1ce5,172,TRUE,2892,2720,Radiant
ac448d865a62786f8732582dde32835a,72,TRUE,2485,2413,Radiant
68aa5469cbe5b38622ba753a5b3bd458,1547,FALSE,1719,172,Dire
be4f4b08419629593219cd9358749cd5,523,TRUE,2392,1869,
1bd4321f9cf6362117fed59b4d231c8a,1595,FALSE,3303,1708,Radiant
f567bcb690ec93182eb416275810033b,2792,TRUE,2862,70,
2138ba9daed511c8ed5db016ef3e3f68,1344,TRUE,1927,583,Radiant
b7f9e73386aab610f4166da5a56e939b,605,TRUE,1628,1023,Radiant
8391d13641e58e69302955de0dfd41f7,1289,TRUE,3486,2197,Radiant
72a27e2a6bf94188eddbe08f1fafcf65,107,FALSE,957,850,
98195a4d7b7f189ebe60b054ae8e2f6d,1883,TRUE,2198,315,
1fd509813317195bb7242feca898b6b2,582,FALSE,1914,1332,Dire
4629c41bda456ed0d5fc05952561369d,226,FALSE,1053,827,
b5ef3cb3f15e552f3ff1681ac003b6e3,2591,TRUE,2857,266,
6381ef19f1b413446838ea5e6506a414,1888,FALSE,2248,360,
c8b09202af932b40bcd4586c06f19d33,1138,TRUE,2007,869,Radiant
68b40eec3c8b922732a3723cf3beccb3,264,TRUE,1764,1500,
28c2e9b7201c51f5d2b38bd17c6d3a0b,2631,TRUE,2923,292,
c8b174a337c95ecfd7301f5ca891fe43,1795,TRUE,2477,682,Radiant
8bdc35f61365d23616208ec31b5c84ad,743,TRUE,1921,1178,Radiant
8e94b3b4b31cd2c9ba937fac5508fcda,338,TRUE,2052,1714,Radiant
ee7b957c49af971e9a736c91204c5c43,1548,FALSE,2768,1220,Dire
635487eb9ef413286bb65c7f58ff1ca1,8,FALSE,2993,2985,Radiant
610877aca4a69566392f791400700ad0,2405,FALSE,3159,754,Dire
add65bfd6e269685eafe9bcad4e632e0,2367,TRUE,2768,401,Radiant
9c68f5b7666a2c18b9d9f44c62f5e1d2,1956,TRUE,2555,599,Dire
6301cfa7efa64a5a4cfda35afa9e7e42,2188,TRUE,2994,806,Radiant
e44d651118ed9d2e5cc71dda8e6bd4e5,1366,FALSE,2910,1544,Radiant
9cc2bb2f7dc685da8ce237c35f61092f,167,TRUE,2059,1892,Radiant
e3d3d84bd8317d65642153fa8c94915e,66,TRUE,2250,2184,Radiant
336256c9d055011ea6ff88c880230722,1622,TRUE,2711,1089,Radiant
8795bfe7e1b4770658bbd70609391b51,798,TRUE,1895,1097,
79c077e776cd9a0f3e415c36f702e554,1158,FALSE,2804,1646,Dire
2ad4ec3d6ee913b58e8c593e4a9a5adc,1609,TRUE,1739,130,
27dc4b124b31b77e53b4191a125d30c3,1201,TRUE,3397,2196,Radiant
a894602fcda02b5832b97333b0633f8a,1266,FALSE,3557,2291,Dire
23b5267b363a3ccecccf6fa226b5100b,463,FALSE,1080,617,
a2407329eefd70d0853ad319e7cbd965,1961,FALSE,2238,277,
a317bf4817d8c73fac657fed0c770b07,1465,FALSE,1573,108,
02f47482527ee25c87721c053a5d0017,1405,FALSE,2474,1069,Dire
07dd0fc0f5f4bc424a37a012a1739ae6,1084,FALSE,1934,850,
3c2e12182da4a81146b7e5d8d8fa9aa8,685,TRUE,1374,689,Radiant
6d535b1cf47f68aaa4a3f9ef984d6381,1536,TRUE,2207,671,Radiant
15636cfea8eae9ec0e54bb13cd6ede13,268,TRUE,2454,2186,Radiant
c899296f4c6ded992aa08f596b62daf7,2921,FALSE,3068,147,
0192c5967de2c4ae1e749631011a2d53,1978,FALSE,2274,296,
65bbf92f0f892b2b529e7c69d0cbad3e,1232,TRUE,1715,483,
6c9b0d2d14a20ea4f645ce30eead50a4,985,TRUE,2611,1626,Radiant
0bb55b832bb39938cb0d11a9b458b485,1596,TRUE,2001,405,
eb201a0d5f7d73fce9b6a0f918021575,1069,TRUE,1536,467,
911e5adf39763b76bbea049dfdd62425,827,FALSE,2868,2041,Radiant
41fd319482c162cb5138e63b3fb18e31,1058,FALSE,1578,520,
b41ff6ef82f804ffc61ca07c96e3d236,1029,TRUE,2162,1133,Radiant
ccbfa80ec4eb22151bc55ee5f663a314,703,TRUE,2288,1585,
ce73c99275a24580addec06121552711,2229,FALSE,2432,203,
c69f116b22cceb2b76d3bf3ef0fef8b1,1800,FALSE,2101,301,
257573f1da2a6f77edf64afb09001f92,1433,TRUE,2492,1059,Radiant
94eac4597cc61a792595682f93c1fe7b,1620,FALSE,1662,42,
60be5f312c84e4dea3c4947f387390dd,395,TRUE,1686,1291,
cec3238013cb23a550450991cf4ba8ab,197,TRUE,1909,1712,
e835438f47e35d5fec66ae11b601e904,472,FALSE,2927,2455,Radiant
510b2d7c2c75afecce2a91a088608596,42,TRUE,2078,2036,Radiant
a3fd075919c519d39e7d86e13f27def8,1279,TRUE,2608,1329,Radiant
f538a00b524a46015ad1243c5b9f4ec9,1468,FALSE,1770,302,
5ba6f72b57fc0144bc9556c9ba1385f8,371,TRUE,1538,1167,Radiant
110d4aa5ac49a74cf082d5c573b8bf52,1139,TRUE,1548,409,
be8e6bdb8639a77399249d1719e3cf8c,2002,FALSE,2989,987,Radiant
7032ff691a5104ab0448290c5e1faca6,650,TRUE,1673,1023,Dire
69a4e780e30c948cbf84a1f846339fdc,1041,FALSE,2610,1569,Dire
dda57f42370fc3c79f506d4ce816d583,272,TRUE,1943,1671,Dire
b07121ef7da201f86ed7026aaa278090,922,FALSE,1874,952,Dire
a629839770ed2c15883d42856a9704f3,1403,TRUE,2140,737,
4cb856178c1fe9e605d33271822b21dc,1961,FALSE,2840,879,Dire
7e24410bcf4da3ace4ae0814c5cec94f,1682,FALSE,2668,986,Dire
bc824fae957d74a8ee6c770ed9c7549a,240,FALSE,1137,897,
a3ccc47dd56e21fb7582abfb607c0aae,1360,TRUE,2112,752,
4eafc2b18cf21601d4afa4dfc5af29e1,440,FALSE,1667,1227,
ce362682dbaf3e3f1fa7acb86ccd2d3b,340,FALSE,2159,1819,
6cf357dc11307980d6e5c02d629bcec0,1347,TRUE,3019,1672,Dire
6c59fb805e6e9cf64d02c1cdffa1bf9d,1373,FALSE,2475,1102,Dire
3dfe546fa2cfb2eb5ecfe3e86387b669,1935,TRUE,2179,244,
200ff1c99d2bc627c0d24dad0fa816ee,139,TRUE,2350,2211,Radiant
84fbffa038a50a56d2a7de957696a027,1090,TRUE,2214,1124,Radiant
744d16ea9cb5f2f0c9c044beaad29638,700,FALSE,1582,882,
fbfd1860229dca0789b76345a2e6a7f6,642,FALSE,1893,1251,Dire
c213ac60309b9b9d2829c9c468eda6ab,3353,FALSE,3963,610,
2e20749da7744db1011e852a87241261,1867,TRUE,2826,959,Radiant
c44d53a49f08e9c2ce92b7dfe5f319fe,379,TRUE,2247,1868,Radiant
81e7d363bd0aae2eb7adcb87993540fb,1241,FALSE,2485,1244,Dire
d2534e5a7af74b354c905918f8982ade,814,TRUE,2745,1931,Dire
61f8d0da221771579d4f74f1827172c7,988,TRUE,3973,2985,Radiant
190edc25d163bb6d709564363f8a44ce,26,FALSE,4044,4018,Dire
6d560ff42f3d088207175e01fe8e9c3a,1260,TRUE,1927,667,Radiant
c978a251588239e8227c3c5dd9db20e9,1016,FALSE,2044,1028,
13088228348ecbf4a9ca87408814ab31,1024,FALSE,2169,1145,Dire
92659949b4d2297600dddc7fbe1d3ac2,825,TRUE,2289,1464,Radiant
841735e443de42b65d88a00ae55c6cd1,469,FALSE,1551,1082,
eb3cc0f439229e7cb3a1cc05cc94e107,312,FALSE,1470,1158,Dire
187a573887fcce3308270d5474c9e780,1511,FALSE,2284,773,
8c8a4935824ff2556e2305d85e9facd6,2221,TRUE,2567,346,
8d68eba25bc1e8df26ae2b75c08bc954,2208,FALSE,2383,175,
1608e3d171f2388db01c67bd795df49c,132,FALSE,2051,1919,
11919d85c142564d0a31a83d6e14ada9,2772,FALSE,3217,445,Dire
cea31d875932172c52f0870bcf0fe2cb,774,TRUE,2864,2090,Radiant
aaf7bf4721d0cbfb3973d691d30cf15f,389,TRUE,1299,910,
7c1c5d0588621deed22eb4d6b14f712c,308,TRUE,3382,3074,Dire
8e2c51122846b01e836bd4df1fef5917,238,TRUE,3185,2947,Dire
319d83dcba853f0d88f6b00e5aeff39b,1064,FALSE,1622,558,Dire
fe6488981592d31fb56061a1cf1aed10,339,TRUE,2273,1934,Radiant
b26dfb6e9885f795812a1f020010a688,1627,FALSE,2139,512,Dire
71dfece61c9a4732dea48485f0246c32,1376,TRUE,1912,536,Radiant
c6d01fd9e79b73c71dd1bc121ee4c5cf,639,FALSE,2272,1633,Dire
5ec4319d3def53ef39ea45e1be73c815,707,TRUE,2283,1576,Radiant
429dd5eb4ada1594cf7d87d11895a954,2070,FALSE,2625,555,Dire
b4d49c478a901a5d605dd2327caccbbb,1197,FALSE,3376,2179,Dire
ca207a77000a892e6171fe4790b9ea18,704,TRUE,2490,1786,
b8b01165a1821ca565c780cf9de9daa3,1043,FALSE,1764,721,
e3032b645d7780c87e9c60ef9aedb370,1145,FALSE,2129,984,
d6264d2985fc7ec1223b9d1f1affe002,1151,FALSE,1670,519,Dire
40bdd74098374865fc1bb9996f96d377,683,FALSE,2422,1739,
11a8d787bb66f45fc1e137344a63082b,1271,FALSE,1348,77,
69b2b3a58c8cb7d7064949da5db88dda,1629,FALSE,2519,890,Radiant
7d1585306d93401df48dfd6a58d273df,1880,TRUE,2626,746,Radiant
8532cb538505cfe4dde13b14a0fdbfc8,2803,TRUE,2880,77,
fc2eec27ec8641d2629ca090f953abf8,2981,FALSE,3396,415,
15ef49575176207ca1952d1f798de1fc,1200,FALSE,1769,569,
7e98d30edfddfa1bf97515dcccd12aa4,2109,FALSE,2666,557,Dire
e21ff7a1de787c8f44cd5855bc3b4c97,725,TRUE,1606,881,
fbdf0d672f8d9b468eb538d179991bca,2123,FALSE,2231,108,
720e52d0d2a3d4bbe3f62172e66f011f,425,TRUE,2152,1727,Radiant
afe63090a13458f43344838b24194bec,187,TRUE,1777,1590,
741a461e0312aac62627ae27bae0e7e1,200,FALSE,1965,1765,
c63f53216938710fbc56b8cdab4b6012,1076,FALSE,2003,927,
f2b91112ae92985c7ec37d0e1f4b12bc,1327,TRUE,1752,425,Radiant
118eef2a8492ac455757644843b0f7b4,1946,FALSE,3606,1660,Dire
2341cdb6be1a508e4fa24306be436b5a,126,TRUE,2179,2053,Radiant
4ab9f18c5a5c145724c354d47a744ece,781,FALSE,1906,1125,Dire
fa2381a61964abd4ff3acd80a9b4e9d9,446,FALSE,2488,2042,Radiant
278e5589d2017c8ae6129ed2c56e77db,1030,TRUE,2070,1040,
2d84bc7f980e089b9b35fe754ed7cff7,729,TRUE,2244,1515,Dire
7e15ab6eb0f25be97320c410a8ef960d,1023,TRUE,2471,1448,Dire
b98db6b21c70c267de111c36d096dd34,741,FALSE,2858,2117,Radiant
b60e55a05a357243971dc9e76e31fab4,1957,FALSE,2056,99,
037a4cf28be8737bb223d881226cf053,1004,TRUE,2183,1179,
2c674f7f26e2f290ebb98f2fc395b6fa,2117,FALSE,4067,1950,Dire
cd2a91e2c73f37f043afb81c822028f3,1631,TRUE,2263,632,
ef24af025dbaa484b1906de355288e0f,1206,TRUE,2007,801,Radiant
d64ad0bcccddbf5f457e150001fdceb5,3047,FALSE,4497,1450,Radiant
9718a5eb46555f344003c5afa4beac40,737,TRUE,2479,1742,Radiant
79505c5a3a978b70cb28a9e35cb7cbd4,562,TRUE,1717,1155,Radiant
90f67876eeeceaa577e1696ebbbcd2fb,1964,TRUE,2396,432,Radiant
99ec27ab8cec2bdb36f301e88b0a438b,297,FALSE,2681,2384,Dire
10163211277c582fd64d9ce5f07933c6,397,TRUE,3081,2684,Dire
c35bbca17eedb95f2bc476ce8d88dcbb,2002,FALSE,2190,188,
a806fac2619c9e5f60309d0bbb75c70a,1886,TRUE,2071,185,Radiant
ad7aba9f4c54f17696fe3f35256a37eb,1489,FALSE,2058,569,
992731a155e9667e5daf2044f3f8b70d,1650,TRUE,2043,393,Radiant
b0aa815373273ec6c052f87b500399c0,1476,FALSE,1986,510,
816997057d184ecf02b919bef58cd8ff,1153,TRUE,1991,838,Radiant
e43bacaf006f160fe1f9979bf3598bac,1565,FALSE,2305,740,
7af9d15edbbd4918dadd39f0c5a252d3,1543,TRUE,1897,354,
4c14366f9f954ecb89ef6f9a648522fb,1853,TRUE,3735,1882,Dire
42f8815c7bc5e680562e80b598ed555b,1486,FALSE,3326,1840,Radiant
02cea9bf6db843eda22ffabf1d62818b,2160,FALSE,2420,260,
9b786424ff5cb7ec648d0f45abedb4d5,45,TRUE,3140,3095,Dire
6efcb5496a7bc8ee715ca181d740e8fd,696,FALSE,1279,583,
73e5dd79d636d4b71c53773f5aff88b4,1100,TRUE,1239,139,
bb2881ea741d8e816c8175e7c8661e4d,273,FALSE,1931,1658,Radiant
4b1958f3c2b08266d750cfe00a8fda22,1997,TRUE,2075,78,
236b15660eb652773552954611cdfa54,1082,FALSE,1280,198,
3d9a64b754c29b8d5aa85a026d1efce3,218,TRUE,2765,2547,Dire
f113813b1ab4b8f4ac4d96752e137cf7,252,TRUE,1543,1291,Radiant
c289a72697baf1ed81ff0e24cd8cc046,1510,TRUE,2850,1340,Radiant
2654354f3ccab1d2f59e52efb54cd064,559,TRUE,1697,1138,Radiant
1da469747b5a9eddee72c905e2d8af9b,46,FALSE,2842,2796,Dire
3eed9b06f0a390f52d2d6db0fb240f00,1068,FALSE,1398,330,
64097b0899c03f1d6b4947a8782d920f,431,TRUE,2591,2160,Radiant
a606aea4f8d9b1901527d1197207d142,2632,TRUE,3442,810,
346c802e93210848e3c51c55433f555c,222,TRUE,2919,2697,Radiant
62d24f39f95bb5fe2bbfbafb3e45b2ac,2040,TRUE,3445,1405,Radiant
f42abd63e3db7f115b40ec2bd92584a2,1843,TRUE,3218,1375,Dire
80c4e76e8fdd353fbe725095745676b4,1185,FALSE,3140,1955,Radiant
f69834d2c0608790d047b1e41bf03d18,1719,FALSE,2516,797,
1d84cf0768adce380bc116184b15d153,1377,TRUE,2060,683,Radiant
bae2d386a1f8aefd575931377dbb2afc,864,FALSE,3095,2231,Dire
d140e1a440b23c8e1dd1beff29553079,769,FALSE,4336,3567,Dire
40691b0e5ad1d99f613861be60756629,727,TRUE,3363,2636,Dire
bc335c7bbdc6f9c43cc58fbccfdb47eb,1864,FALSE,3204,1340,Radiant
c1a0da4ffb3d9acd33e9f2c1e3da5ed6,1167,FALSE,1337,170,
547ec1042de54606efddafd673ece714,1175,FALSE,3377,2202,Dire
fc4c6b8c68585494b4071c3e55eff4e9,1205,FALSE,2402,1197,Radiant
677844b52affea0bf105f391123cfea6,3197,FALSE,3712,515,Dire
59d23115bcb07a0cf052fd668ecf6725,420,TRUE,1504,1084,Radiant
dc9e3160d24b13990667e1b68c8973cc,770,FALSE,4071,3301,Radiant
09a9fbc1e0d7523b45b6d533c51c925e,276,FALSE,2063,1787,Radiant
c1a5ab31858777f7c334a7d0e4044954,992,TRUE,3771,2779,Radiant
7df353f79d53d4bf7e8cc0a7149d2693,222,FALSE,2505,2283,Radiant
2c3b7c9a362e02c76944f60de467b35c,96,TRUE,2170,2074,Radiant
d0dda6d77efb3366b502864d32ebf878,121,FALSE,1649,1528,
c0d7e9ff6dadd63616a2368807d40d19,185,FALSE,1463,1278,Dire
789ce55ef3170a5af3e8e02080c8be54,185,FALSE,2108,1923,Dire
d68e5450802b71087018360a601a7841,926,TRUE,1767,841,Radiant
79bc3bc6265cba5ee32e8fc058ec19b1,3088,FALSE,3426,338,
68d790b460a1d5febebc5442e302bf43,1167,TRUE,3463,2296,Radiant
6bf222790645762300ff06f671c8c325,1790,FALSE,2604,814,
71aa8d41696d198f4f6b3dc5ba74c4bc,1946,FALSE,2126,180,
f7bd7f93590a170455671c594294a98a,1279,FALSE,2080,801,Dire
4a34c6d41d68e98948ed45c213882c61,1109,TRUE,2298,1189,Radiant
4e22fecbd590a8117bc0febc2ca600a9,2040,TRUE,2124,84,
139e3de585de4c0626acaca89742e776,1666,TRUE,2168,502,
f1ea81a9ea3cdc933501c6ddde390ed6,2039,TRUE,2964,925,Dire
ba9663b32407c52eea95c13149b3d09d,1623,TRUE,2180,557,
12c26b31aa5f320122438ea08b79cbc5,742,FALSE,3619,2877,Dire
524dd4255e6e82ced5c8a66794cadb0b,1197,FALSE,2670,1473,Dire
8ebe8fb7022b6423a7e0b114702541fa,142,TRUE,1967,1825,
4db9ef6b3ecdf8ec13b97091a05f501c,2897,TRUE,3097,200,Radiant
fe5f0350234c1ec02d84266e9d503ed1,131,TRUE,1972,1841,Radiant
3efd8e985a2de5afdee0bd2ac2040d5b,1465,FALSE,2348,883,Dire
3214fb9a915a1e873a98efdd25f0071f,553,TRUE,1730,1177,
684b0d6f1ee5ff88612e7ef0276c7bb7,624,TRUE,2278,1654,Radiant
d756c381f4dcc8bb099fd0e37d9704f4,1103,TRUE,1762,659,
709fc6c17f0ee52eb1fb7f2c7ad9be3e,1140,FALSE,1911,771,Dire
4ce4175d049e695224fb2ad2cd4530de,1243,TRUE,2707,1464,Radiant
2708a2512fbe6e62a2463765f2fdd61f,1525,FALSE,2049,524,
6e22612917cbf6f39fdcaf38105bf0c9,1136,TRUE,1912,776,Radiant
4264dbebe12fe1c24dac0ccbf8aef368,129,TRUE,2499,2370,Radiant
a0bd219aafd1d2a1f477da309a38d7fb,1228,FALSE,2013,785,Dire
e17dfc8337454964337a81943694146f,447,TRUE,2213,1766,
266220ce8a33584745851ed14b441a8c,2065,FALSE,3590,1525,Dire
e6c5f1a600b09ad298d078a9a4e2f164,871,TRUE,1864,993,Radiant
f356262bfe58f75a70f8d2f9cfdbca21,1892,FALSE,1972,80,
7f5d3fb73453c93b85fe9e163bd20ea1,2224,TRUE,2733,509,Radiant
96bff037ba9868b7b3b7d9b2e4d5f80c,71,TRUE,3231,3160,Radiant
a2826ca7bbefaae068ab4154d9965a76,1316,TRUE,1927,611,
2b94b3582f9b96d50730a13a3290de62,713,TRUE,2088,1375,Radiant
25bcd517fc2017ddc9eb3ec000ebb9bc,1140,TRUE,2129,989,
0c5fab672b420e9928c2b4865881b997,2389,FALSE,2835,446,Radiant
e5303763103259f17d57c4d689bcaa91,1599,FALSE,1657,58,
91a09703ce042f6c54feaa80f3d60d18,38,FALSE,2064,2026,Dire
b0420b91874f68a94afa9dd3d38fa6e7,3169,TRUE,3421,252,
b651608f5b7a98266777d34455bc6283,1164,TRUE,1901,737,
8c367c933b9450d63450e8eec2bfbc17,1263,TRUE,1683,420,Radiant
84b2c09b21112abc9b2c4d3e920b5039,3051,TRUE,3322,271,
2546e0cf9072acec43f29d6c8104e366,123,FALSE,1878,1755,Dire
90aeba62df799d987596a44bd860a2fd,1469,TRUE,1525,56,
8a8ea982c756c1fe32e475987fa0a2d4,991,FALSE,3427,2436,Radiant
b878c2896470f9d0cea6e6059bf14992,555,FALSE,3266,2711,Dire
92786414ffc09f7c0704aa78f8020511,2161,FALSE,2834,673,Radiant
2681d3b2afc3b689779bef2a65285a92,405,FALSE,1331,926,
b68367f5ba174f2053dcd1f127c3062f,1302,FALSE,2211,909,Dire
09735af297f60be9b8cc07019704094c,1250,TRUE,2818,1568,Radiant
ca2e3b6d9ce001376150ab55dc4fe590,1389,TRUE,2108,719,Radiant
bc53c56b5ab73d92f9637aff0af261e6,26,TRUE,2572,2546,
d2feee9f5603d2a47c928539743267e4,50,TRUE,1974,1924,
3ce52538b84c6755e8650b531d3989d5,434,TRUE,1798,1364,Radiant
e88b4d6affc146f3b2348c2a82dfb8ad,1497,TRUE,3219,1722,Dire
ed73d21d9d08e67ac54ddb4471426a89,611,FALSE,1750,1139,Radiant
01d95b7350838bab33e92587d85bf0bb,497,FALSE,2113,1616,Dire
270f57448a36d6401e2caf268459f3aa,2097,FALSE,2934,837,Dire
fda05bf4704604842bd04ed024816103,2463,TRUE,2548,85,
825710af9dc2eb63bd97533fdd2d8fc5,808,FALSE,2715,1907,Dire
688e58c4df0c9fcc3f2c91ff3f070514,755,TRUE,2925,2170,Radiant
f866d91e604dd8317955f812e3f77606,1840,TRUE,2019,179,
48215e08048e977fc61ca4ccfadfa5b1,656,TRUE,2948,2292,Radiant
f9af2a9b48bd234a368d450937bd6294,1823,TRUE,2201,378,
dc205f019d957cb02b051af77f2ea232,480,TRUE,2508,2028,Radiant
e01f0cac3ad75139cd5bfb653a7fdce4,877,TRUE,1431,554,
932064a79f601aec4a0735e7428a6e50,700,TRUE,2471,1771,Radiant
9656e6fcc5158e60d5b621fe2ee2d008,929,TRUE,1833,904,Radiant
50b6ca484c9c0629042c2696831d2dc1,1241,TRUE,2911,1670,Radiant
8694f98747bbb276c5703726dd50b16b,1493,TRUE,2705,1212,Radiant
0f5d4f423822a079d4056a8129b5946a,316,FALSE,1782,1466,Dire
028bbaba421e1430f73cb1494f30f034,446,TRUE,4163,3717,Radiant
b90b2445624cd2f34a324d416f36a39d,2656,FALSE,3117,461,Dire
8cae94905094443cdff1184c3b139790,783,TRUE,1853,1070,
669f2f3a6222067dac9f30cae0381fb6,240,FALSE,3081,2841,Dire
c3a01ed28d47b23546280d4ca92ea8c6,1640,FALSE,2691,1051,Dire
043c34ccd144fabd862d785ff867a4c9,301,FALSE,2652,2351,Radiant
181cb6b679cbff8d8564f4bc1a48c1cc,447,FALSE,1506,1059,
f5c43363aa0c1b2fca5c2b34391981db,399,TRUE,2722,2323,Radiant
33f109a0ee92da6ad2452d0eaa3dce91,955,FALSE,3818,2863,Radiant
a2ebef0eedc9e9433cf79b3e10024eec,1466,TRUE,1633,167,
271b99d71baec40a82ec8f8d46e5f62a,663,TRUE,2575,1912,Dire
ece12c4a7cdffda36ec46174415ed7f7,550,TRUE,1288,738,Dire
e0305b4eef68315ac5d7aba92dde998e,1334,TRUE,2538,1204,Radiant
68f3db7c6957528a4ae34608e00e238f,558,FALSE,2536,1978,Dire
02d71dca58b762e0e5c093658914c466,492,TRUE,1831,1339,
5ed2eca486c9b3a1bdc22a0c58cb2a43,1734,TRUE,2064,330,Radiant
68b17c9856b59640a1d2e4d337b9b1da,635,FALSE,2191,1556,Radiant
6a076254e98d1e439743c82fe3576402,2250,FALSE,2452,202,Dire
d509b851df427dce09cbe09a564dc7f0,933,TRUE,1698,765,Radiant
2ac024f147296ff25d7757da058804e2,1564,TRUE,1825,261,
4fcddde33c60411a74f15b678c5736b7,986,FALSE,2138,1152,Dire
64adb669bdeb1f42b0909e560bd74cf1,51,FALSE,1487,1436,
2c11017f1ed7f03494229bf0fa30b86d,1600,FALSE,3015,1415,Dire
2a87f013ed2f5c9c700bbcdd1bd6edbd,990,TRUE,1529,539,
5dd2c1ca3417c59465bce15ae8732492,797,FALSE,2204,1407,
f5478298168f5ffb2c82db5d0b63b163,808,TRUE,905,97,
20200447be1ad6fb9aeea90d40bb9eac,14,FALSE,1701,1687,Dire
2dc474e3cf485068bf30cfdf2e0ffceb,224,FALSE,4178,3954,Dire
9eea99bcfbcf7dc8737c04fac799d105,551,TRUE,2568,2017,Radiant
33253b9ece4a4d9cd9c75bd6c4d754e2,2167,FALSE,2972,805,Dire
39673eae6771c3a7f237d7cc36dc8456,1487,TRUE,2164,677,
e851559be2c9ee25c542843394071179,1988,FALSE,2577,589,
74c1c8fedfa3d23024f0456c0098371b,1562,TRUE,1721,159,
b364cbc61410490f9e29f022e6b4bc11,22,FALSE,1548,1526,
243b0d2b2d166c73ff09fe6a099fab05,1439,FALSE,2487,1048,Dire
b06e5d7e4ee6337aa556e651854e1eec,2616,TRUE,2870,254,
2a5509da8395aedbbccca15c5700cdbf,1896,TRUE,2999,1103,Dire
8f8cf34f2d92f35727b43d47920d05ef,1062,TRUE,2176,1114,Radiant
970a7af9f42f62f84774fdd452350563,2242,TRUE,2646,404,
1d22fc97d385c71ad9ec3687d7c6f798,2212,TRUE,2918,706,Radiant
056c3c50e386e1a7e0666146deb26db1,2065,TRUE,3046,981,Radiant
1ad8f4237576ed0ce553f326aaad9273,2267,TRUE,2736,469,Radiant
a2daef9babe88620bbf7bdb4eb0f75f2,53,FALSE,1552,1499,
2a567b96302ce257b52fe447bee904d2,802,TRUE,2693,1891,
0eb372ade57b59e3e0c095189c3cb3bc,396,FALSE,1791,1395,Dire
fb10acf08961d0a27424faad67716edb,1104,TRUE,1449,345,Radiant
f0bf2eb9129cec2215b7657b674d206b,391,TRUE,1478,1087,
be46174d2a754a0051dd76ec4799630d,857,TRUE,2805,1948,Dire
63e732537dfc3b046b0b2d83bf771309,628,TRUE,2055,1427,
69c695c87ab1acee05af81b4a6f32d6a,106,TRUE,2196,2090,
69e5f427ae84e49e6923a8b9f72cc8d1,1950,FALSE,2432,482,
387ba2b5038c4832315424f487b820ff,1855,TRUE,1952,97,
793137aebf55376847efd3c026d35a46,144,TRUE,3125,2981,Dire
351f54685d5504762f6ad7a908cc0e5f,1562,TRUE,2212,650,
353f01c5947a50401616b116aaaf79bc,257,TRUE,1569,1312,Radiant
a38d77fe548533ff37661c49a30a6dc2,536,TRUE,4115,3579,Dire
6ea81d00ba4e13a3c1b7a43dbeb9e681,566,TRUE,1637,1071,
8e881a9352a81f5aa13b3d168f43a2da,1939,FALSE,3050,1111,Dire
c54b2905f97797e7cdbf8d2961d55b0e,1722,TRUE,1809,87,
f3a3d23d8c66ae63f3a4391aa455dde7,1509,TRUE,1904,395,
50afa110eb8423d49fb6bfde8b656aaa,2519,FALSE,2564,45,
349496dcd44b9fa414f2725334c0893b,173,FALSE,2033,1860,Dire
3865b8d4e67ab400b8fe008dcb10c8d1,1236,TRUE,3500,2264,Dire
8c0f0c917173bc7b0173b88b42e9a452,643,TRUE,1123,480,Radiant
9cc38f283671d6dbeaa095ccab8d8a3e,638,TRUE,1913,1275,Radiant
ef6ba20eeb99e73b088157e87f36968d,431,TRUE,1312,881,Dire
cd8b998bc5a3c5e54b38efcf148e210d,1235,FALSE,1696,461,
e688a922986daa797f405b8848e592cf,1449,TRUE,2030,581,
d8f9664bd1691d5201671b9af87984c5,1359,FALSE,3450,2091,Dire
09d8d691998b5b5394b7427c8a4a9fc6,360,TRUE,2329,1969,Radiant
f4dc1fa314877871620a17d3d165d520,1252,TRUE,1694,442,
536479da43265a5284eff065734d507b,2145,FALSE,3271,1126,Radiant
41a761ce5c6c6af3b14e4cf96e10f9c1,1585,FALSE,2063,478,Dire
e280814cee2d9c79856f4d83542efecf,233,FALSE,1888,1655,Dire
b784d4b1cb4654bb4d99680c55a144ae,658,TRUE,1736,1078,
392a99ab84df25d9454f1217e995e0f4,2870,FALSE,3908,1038,Dire
7138079e1cc641e1c40d54cef00b06dd,698,TRUE,1871,1173,Radiant
3fc1697c157df89751e522093a140014,262,TRUE,1360,1098,Radiant
06c0230cfd5cc24f874f8f2d0fae9702,733,TRUE,2379,1646,
f72ac71dfd99246fe2d5c71342083057,208,FALSE,4109,3901,Dire
7a275745580d900ebcf2e764ff09cb18,1085,FALSE,1416,331,Dire
ad44b3c77eef5112c17d29ba5a1d7072,269,TRUE,1668,1399,
0818d9f1ad289d02f5b3ec708fd43202,1531,TRUE,2496,965,Radiant
7a0eb817cb29fef42065db779184a0aa,81,TRUE,1372,1291,
9349134399be709fd75a0100d2227633,2330,FALSE,3332,1002,Dire
0c26bb0aa6491ecd863e7d3156645bf8,533,FALSE,2426,1893,Dire
d99bf777a951e76ee9346fd4ea8eb899,611,TRUE,3108,2497,Radiant
25a9006eb4d702b2bab0ab467460bd1b,770,TRUE,2211,1441,
c137306d5446c43a68327caa840ce7af,1304,FALSE,2196,892,Dire
bdfac3a9fb3f6f01eb92de59d2a93d4c,509,TRUE,1542,1033,
6aa82be997ab37b81015adab22674b35,1386,TRUE,1429,43,
7bb0ddac9f0bd8ab6a0b4c857671ae73,595,FALSE,1177,582,
4197d9920e9c22049a0ea38a7f0b1d47,1463,FALSE,2921,1458,Radiant
1e1dbd84e436e4de4c412ba21bec7ebb,320,TRUE,1476,1156,Radiant
de91a458745b3b423687628542910b70,1282,FALSE,2865,1583,Dire
57ff4c221fe832e0d34c25fd8198e716,945,TRUE,2564,1619,Radiant
dc7be52492c01a92f01d35fbb573fd8e,994,TRUE,1877,883,Radiant
929f65ae7091f3565aed9651f66ae9c6,1120,TRUE,2599,1479,Dire
cdf1297eb0a9ff0786ea10e439225286,1193,TRUE,1887,694,
7b45be89587e504b431dbd79402bda14,665,FALSE,1704,1039,
1ab1cd409684e64b364c9707cda7a14a,833,TRUE,1775,942,Radiant
844bdb5a6063de2c95596491d820f2c2,1693,FALSE,1863,170,
0d94e1115734a1172de677ba694e511e,1313,FALSE,2098,785,Dire
1bbc4a5af0a5f91ddbd667886bd1e07a,681,FALSE,3093,2412,Dire
608f8191660185252def250ae3b84c94,2076,FALSE,2520,444,
098bb59985fcf7f731836d7b3bf40c67,3080,TRUE,3196,116,
d077e3a3f8773c9f2815aeb45cd1e660,1283,TRUE,2495,1212,Radiant
8b7d0a8cf2ce5132993b7054a876fec3,1241,TRUE,2079,838,Radiant
10e419e49d6dbf86e3bd97de30063799,2479,TRUE,2837,358,Dire
ac2731338cd0e5fe03a2c996e7179921,1645,TRUE,1927,282,
dbf34133bb2475327ddc914a023d54b9,597,TRUE,1567,970,Radiant
a896843017c3d96b6be362f0f59e2a19,1223,FALSE,2765,1542,Dire
7ef2e4ed903b3855270733532ec79ef7,1057,FALSE,1877,820,
444a0fb7ae0430b6477dd43a413ac941,1310,TRUE,1884,574,
65aa29ca38f92e1674caace52a0a67a8,1915,FALSE,2216,301,
a805d311facd305134f5f77b27c666b4,1330,FALSE,2621,1291,Dire
d3b6b410ed98b52003bf5d4da451b31d,286,FALSE,2378,2092,Radiant
faa2a50ec37111a9aecb2c5bf9622991,1225,FALSE,1878,653,Dire
a7cb0b1ef0195be682a86102de2463ba,493,FALSE,1470,977,Radiant
83a086acea7da50b1814ce435ff1b112,934,FALSE,3140,2206,Radiant
16fda87c5abe17d5ac06653a1363329f,1708,TRUE,1859,151,
8dc30309563945993a3effc5b5c9e0be,764,TRUE,1549,785,Radiant
6571ffc9b0ecaf2ace73c77ab6ade512,2056,FALSE,2186,130,
1bb8b1855a76bb0ff0dadc1b7424a1cd,1654,FALSE,3711,2057,Dire
1effcad1e924b0d054377803fc3711ac,1078,FALSE,2056,978,Dire
af1258d12364da8960ccdb11a7a641fa,1123,TRUE,4178,3055,Dire
4d8b5304ba1ccecccae0b4b3156b4bc8,685,FALSE,2230,1545,Radiant
96457aff863ea12cb682f9843446210a,1589,TRUE,2511,922,Radiant
b33957d6a02d16325f402102a7c4bc92,144,TRUE,2397,2253,Dire
b580561a9c590ee87ecb5c49b39b8a00,2579,TRUE,2985,406,Radiant
608d7c2b658709df4a34f1d5fbf2ec72,863,FALSE,1619,756,
d101a05cc94e1ed913b18a93ef89cd81,1001,TRUE,2054,1053,Radiant
779720c2a639695dd4d746d1e4cd5e5f,94,TRUE,1841,1747,Radiant
f80fb9d1332459647d13354e4b8d27a4,396,TRUE,1599,1203,Radiant
c6295d23494892cb87511d3b15c1271d,369,TRUE,1994,1625,Radiant
6b55c73d2482a125865733d03c5050a5,1733,TRUE,3940,2207,Dire
0eb2e69365cdbbeb7091cba8eabe24f4,2200,TRUE,2696,496,Radiant
2d1aa8c66fb8cd3e30b455b9dae97e68,1985,FALSE,2557,572,Dire
5c257c318aac085d719d7ded236c51f6,712,FALSE,2498,1786,Dire
4d3cd5a383e1178c43d1a85f46649614,1275,TRUE,1991,716,Radiant
0b3f0b423150ad1706bcb180558709c3,2864,FALSE,3369,505,Dire
c3ed9ea8fcf14ffd1d1a0257fae1a35d,157,TRUE,1177,1020,Radiant
79c47423b3f9d8d7272166934ae3bd06,1419,TRUE,1915,496,
f3a041eb323c1df3e5b956d9c82532aa,2384,FALSE,2613,229,
7161c97233821e40e74b69decd0ba5a6,1519,TRUE,2046,527,Radiant
6905cc13e560dcc5bc3ed121131ab430,1422,TRUE,2509,1087,Dire
b689a92f6fef671c542bd8f60e7832f4,1190,FALSE,1631,441,
c4fff46755a072e02cbd22ea5ecd554c,1939,TRUE,2651,712,
7d8f7b5f3660323f1ec93e32175fde36,2347,FALSE,2461,114,
eee63bdc640b642267a6497f8ba8236c,161,FALSE,1753,1592,Radiant
63097d50b508c0fe568918f96ba17ce1,549,FALSE,1693,1144,Dire
5eb04d271f7eccefa964a6ff172fcd4c,515,TRUE,1973,1458,Radiant
6046f024ab1abbbaaa8690dfecab6764,1400,TRUE,2144,744,
65661196b6e8b4a3552b1ac53faa786c,724,TRUE,1756,1032,
c2b91dc2439e382a55309287e98f80e1,2068,TRUE,2142,74,
b029ab1d745d80be5f953ef8f6b2754e,1377,TRUE,1866,489,Radiant
1b9008b03cf77e55850d3cea24cb46df,1332,FALSE,1880,548,
dfecd2eca3a4a42542ef48a76f99aec9,1124,TRUE,2330,1206,Radiant
261b7eaec45365c269ce8533dc0dd149,2037,TRUE,2441,404,
8a8cf8c9dc996391b76acb152b953161,1795,TRUE,2213,418,
0e75e66e71642422a2a80cd979245af3,626,FALSE,1066,440,Dire
d05404057c8d0e9898c90cda99f89879,916,TRUE,1094,178,
551780a662315c000f31a27d8378dca2,1332,TRUE,1623,291,
6a1591fa273a2224997bcfcc32502a34,803,TRUE,2766,1963,Radiant
6479ac7f9659e4db1ebca91a2644726f,1729,FALSE,2028,299,
1565a5a291a92a7f3e2a3c534a387375,178,TRUE,3070,2892,Dire
c69d362f190eb68e5e4a29dcda330e46,430,TRUE,2573,2143,Radiant
cebc7c90a1bdaf50d219f89a62c98abb,30,FALSE,2508,2478,
d4423bcaff1e892ee892ff8fabde704b,1043,TRUE,2799,1756,Dire
3aac91dfbe7d395dc3540ece5b6b2b27,1658,FALSE,1909,251,
4419e2ee3cc6916a09b146c7f7522a1a,1453,FALSE,1771,318,
4647d0615b110c46480dc0c78f84c8bd,2054,TRUE,2257,203,
4baccc3f8776dfc9b978e231ea2d28f0,546,TRUE,1356,810,
9a32e14b134259117ffa2a4807a6bab1,690,TRUE,2551,1861,
b8605ea48f703429f31a02a75613c16c,115,TRUE,2159,2044,Radiant
0420564dec4b5a2cf85bdcce7e696646,1055,TRUE,1792,737,Radiant
cacf73fb7c712bdcca61e968c4d3939d,626,TRUE,1657,1031,Radiant
190836ab650c64f682f3542619e10231,1080,TRUE,4183,3103,Radiant
e56202f5fdaa277c26aa55e6c1bc4de9,475,TRUE,967,492,
955e10e695ff919d54fd9fbd16c6bda4,1354,TRUE,3142,1788,Radiant
edeacddf9e1f87834f7a490648686997,349,TRUE,2432,2083,Radiant
cbd5dc69c6d86e85eb29592d1b78efe0,1291,TRUE,2038,747,Radiant
784341c4d0baa4903a6848ea33540221,1592,FALSE,1907,315,
5b4939491edeb3b713d6f1c9b44be8a0,371,TRUE,2260,1889,Radiant
95b40b6ab14c9ed79c059ec0c1d29850,1951,FALSE,2057,106,
d1c0759d8627889f8cb6c7e86e39e659,1065,TRUE,2680,1615,
5eaa1abfd1c12b8d74662a9a4a7f06e9,1300,TRUE,1692,392,
ac9ca45475d3e66e2b08f7f35104738e,1327,TRUE,1661,334,
dd9665575d3c92fbc223ae4720f7ff7a,344,FALSE,2855,2511,Dire
872df4c3a017d183fa30653db7ae6360,1886,TRUE,2256,370,Radiant
0eefd8a11d360616b9e791c656ca08d4,429,FALSE,1402,973,
eb15171f91ceb5c799af967a9032f8f8,840,TRUE,3428,2588,Dire
a29ed05d303c3a0d9ef7304ffd7b6d28,1555,TRUE,1794,239,
b55bc04456ec78fecc7851a61140d066,1087,FALSE,3030,1943,Dire
f698deb49a16648e65f84078db28a7d7,1679,FALSE,4156,2477,Radiant
9eda7b00be08146fc486439051543e4f,675,TRUE,2237,1562,Radiant
f4f05f3d566fee5bd0503ba6663140a3,611,TRUE,1936,1325,Radiant
be5ec00b134b7a7b7c058dd5081c7528,2671,FALSE,2821,150,Dire
2fa5f01d552efe5e0917d61d91e313a9,764,TRUE,2791,2027,Radiant
48493cd238c5fa6782a857023c608090,883,FALSE,2388,1505,
235a6796c79d951a1e6211d81d6c7f63,674,TRUE,2546,1872,Dire
a5275362ba761c2abde9849826e55d4b,566,FALSE,1092,526,Dire
61118acf83edb54376acf76d6557a12a,566,FALSE,2624,2058,Radiant
d2d0a198f7632586c6807d3300e7c865,2077,FALSE,2122,45,
c5f396dbd10044019c9951b8b5a171fb,572,FALSE,1568,996,
b31abfe10b530dc0698f206266288aeb,862,TRUE,2621,1759,Radiant
405046a3829a2561bb666ad2f1613d55,3719,FALSE,3840,121,
e6dd5de7e00c1dfbc75e4c66b1ecee0a,585,FALSE,1472,887,
3d51755b587d8fea9df1ddf6f8c527f2,897,TRUE,2636,1739,Radiant
9bf20b4f8fd3da2c1b4d47f5bd1736e6,3027,FALSE,3087,60,
614b4bf86546ae62b4b4c0c0e03a9e5c,2771,TRUE,2846,75,
76935aa52e70ab112890a4d5446ea5b5,1215,TRUE,2207,992,
ff19b1588a19bf776f7f89fea2edaed2,1366,TRUE,2228,862,
13f84f1f291675f9c49fc7a168451bb1,3596,TRUE,4811,1215,Dire
14e0d8fa9fe50a9bcad7e386589eeb39,641,TRUE,2190,1549,
26a3ebc44ff88d8e89240ded211c5897,1648,FALSE,2223,575,Radiant
34faabeca2c9a3abd45c171202b5046c,2097,TRUE,2395,298,
9ce79420cc38325f569a907ea3be54ec,2852,FALSE,4484,1632,Dire
4df79549a5fc83fb25ca33e273a7cf62,1663,FALSE,3179,1516,Dire
c82c379f37d333a1f062a512be94fbc7,1062,TRUE,2091,1029,Dire
d054dc25a14e3981f2e64cb3acfe50a0,1228,FALSE,1922,694,Dire
7a3009168ceaf8687ac5322d4cb544ea,55,FALSE,1768,1713,Dire
a81b70ccf4e2635c7b5745b4fb3402cb,411,TRUE,947,536,
55b6fde76c6a6d0412ff77485eb39856,347,TRUE,1231,884,
a805b7e2b7a4e09b796432149f2c8fbd,2465,TRUE,2604,139,
99d5c24c69d329ee24d2263899837285,1889,FALSE,2463,574,Dire
7615e0d790aecdae29b19817915b3a92,943,FALSE,2492,1549,Dire
a7fc6a8df5707ca10b6b4d65615b549c,453,FALSE,1414,961,Dire
e386c1e318fb093c7b3da28a4b2e4e93,979,TRUE,2253,1274,Radiant
952098f73278cc075a6b47381e25aa35,2613,TRUE,2748,135,
15bb8fe042e5644b8c5753c238070da0,408,FALSE,2182,1774,Dire
8e9ea1dcbe2a20851e6c4aba454855a6,270,FALSE,2011,1741,Dire
040a014931639875420eb070711e709e,667,FALSE,2226,1559,Dire
c2252265b71d8841f130f4ec7bdb538b,158,TRUE,1178,1020,
a087cf4982f8881d3b3d85378b841e7e,2858,FALSE,3079,221,
98da621c568a344047de5f1e80396bd7,1321,FALSE,2738,1417,
d12ddf26647bbb877270f7cbbdcd0b70,1300,FALSE,2693,1393,Dire
c790a8bf620411b1808d169c92e66676,2095,FALSE,2303,208,Dire
d71ff0cbb70a604f3cf3fba2aac4fe91,488,TRUE,1484,996,Radiant
fa7d902b638eedce09e1656dba212cdb,1016,TRUE,1345,329,
1673712a4097a45ed43a780a6361fa91,705,FALSE,2196,1491,Dire
05bdebf7063f5abf4d7f0ae09a05e583,1082,FALSE,2852,1770,Dire
82f32d68c25fb2ce5e0590abd2e1aa33,1262,TRUE,1900,638,
526bc29bcead2cfede1c0ea6a874d22d,1032,FALSE,2505,1473,Dire
9b24936c120b0e12b2ad731895e8a2c7,1868,TRUE,2430,562,
4756e7dbebadf93e97eeeaec621c5333,603,TRUE,1456,853,
47ca506feba4488a4d0f2185c8fb8e16,2583,TRUE,2745,162,
dc9e4f511c1ca895b5a970e5921ad2ba,1618,FALSE,2700,1082,Dire
be02285012f95bdecff544be8bab1c59,2691,TRUE,2821,130,
9ad5742675c2fa6c096ea1fdc2839249,1647,FALSE,2874,1227,Dire
7291456d55d1d1c33c0607546f95253f,127,FALSE,2395,2268,Dire
5d195e567f27b3644ed53bff70d456c5,354,TRUE,1960,1606,Radiant
3737e7d186b5be83c110a2c62b3fb786,641,FALSE,1866,1225,Dire
5b96d1a301d366a03375bfd77b27a92a,1947,TRUE,2874,927,
60c05ce81fdeb1e8bc5bfd751ec60a9c,1172,FALSE,2825,1653,Radiant
08b0a32a19c5178979dd7f416cf33487,165,FALSE,2758,2593,Radiant
545fd2c7932807c313aacd4e1f4d49a9,1063,FALSE,2866,1803,
13a1baefd32bb924b5008a57fe06f4fc,1038,FALSE,1904,866,Dire
c58fd6584b337c6694df7d10583893dc,794,TRUE,1828,1034,
89fe5f5218e9eaf0201702e1f478db98,1955,TRUE,2175,220,
096eee23a2acf243cc0533455ee4b68c,64,FALSE,1368,1304,Dire
cc1dc2339c0d1b17cf6fb2615d54e343,816,FALSE,2780,1964,Dire
61aa760df7a4aa8e96a014f1968f0271,1733,TRUE,2189,456,Radiant
cf58b32e3fb212fbb8bd542a586bcc28,1102,TRUE,3037,1935,Radiant
5093f28021b0da678cc7e6c68d62567a,510,FALSE,1529,1019,
7ca68df981f161c1bbab63269bbe90f5,1858,TRUE,3127,1269,Dire
1a794750542bb7db9145bac9fc2423b7,867,FALSE,3081,2214,Radiant
198e70e49743431d3e682f90ba24d11d,246,FALSE,1241,995,
301ce337305af00bd185076a5215f742,2946,TRUE,3083,137,Radiant
5ea1b5842f704ea37c3b60eb620987da,979,FALSE,2267,1288,Dire
e0805b524744c77560a61d44b106ba8c,750,TRUE,1790,1040,
99b8ad72e7e661cc3c8d75515f69ebae,261,FALSE,3133,2872,Radiant
3d315d63c45a2a83206d4c7de249600a,1950,FALSE,3402,1452,Dire
3fdb1ec327de0e3ecef04def7e8b6678,1111,TRUE,2272,1161,Dire
51180733e13b42738e99b362ba292241,2344,FALSE,2382,38,
cdc7e680a28df9d04d561e99ae8ae1e3,192,FALSE,1716,1524,Dire
ef89f7aacd78d39d3d13229f328915f0,2265,FALSE,2308,43,
5ac23695984318e950643b4f294637e8,1399,FALSE,1649,250,
c6ddcb83155d03d9e21a2a3e6571d4b6,505,TRUE,3757,3252,Radiant
46f5fcc4dc1dc941cb58c49bb77bfad7,1241,FALSE,2443,1202,Dire
1c9275a75749d09e38e3d872c773040f,584,FALSE,2580,1996,Radiant
07c8b14d70ad223a4628566221d6eadc,168,TRUE,2369,2201,Radiant
9f371a17cd0483a2e548eaf07f14fd85,743,TRUE,2636,1893,Radiant
4d742333925ad09c9cc923ec79f12d84,1587,FALSE,2237,650,
04041be1f7a2248a124d1378f6ae14dc,2259,FALSE,2329,70,
25ceb76ac14817031121f75ade0108ba,850,TRUE,2005,1155,
80f79664f97ccfc65a1fd8a188b6785b,409,FALSE,2677,2268,Radiant
5f6761aae600e7d39a7158ebe08d2f15,1978,TRUE,2081,103,
914044da224f2ec91206b7967302c0a8,2031,TRUE,2701,670,
863010a1c163e70f41fb499753816009,713,TRUE,1720,1007,Radiant
7af8f7198f2adf7edf927cb1634ae03a,1753,TRUE,2849,1096,Dire
62e334d8433b4038c54c995f855386c4,2019,TRUE,3228,1209,Dire
d60cbd58ac017bf810773dd6e3f93090,204,FALSE,2753,2549,Dire
43ee4a1410a65de6aeed6b1901e652a9,893,FALSE,2605,1712,Dire
028ef3ae9fbec029ef5c5c04b310689c,758,TRUE,1707,949,
362e2a35673cde70d29caeb526e4a616,763,FALSE,2212,1449,Dire
97ba44d8f0fc8ae792364b66ef2088e7,1013,FALSE,2474,1461,Radiant
c64bd7f2b432a12ea5de3dba7af18054,1427,TRUE,1869,442,Radiant
5912352709672b609f8ddaeabb241e53,2140,FALSE,2692,552,Dire
f71f1330028774ea984420d9fa24ebd8,1825,FALSE,3966,2141,Radiant
cf3a59769553da4a4a3af6d2d77b612a,1383,FALSE,2546,1163,Radiant
fcdcad318732c942236ad41516002869,1216,FALSE,3042,1826,Radiant
b28df2501e188288b5f8bc89213edaa7,694,TRUE,1625,931,
c4e272a10e397c052d286056ff742d7a,1226,TRUE,2675,1449,Dire
99b11d33557eff02e3001092dd62dbb3,1656,FALSE,2561,905,Radiant
ab9dff86d95924468d7bb53bc6016be2,530,TRUE,1939,1409,Radiant
23089c0f9762de4483fb007abe09cd1c,140,FALSE,1117,977,
0090e8d9186aaac43b59ab9030c379d6,587,TRUE,2708,2121,Radiant
422992e318fb972d4fcd5a68b656adcd,529,TRUE,1971,1442,Radiant
4dc7a3830985e9a779387b7a85664733,398,FALSE,1792,1394,
7f04399c90847fa16f259820f3faa18d,2848,TRUE,3075,227,
edf7d91c9b87e16853066b76171ece41,2575,FALSE,2967,392,Dire
f41abde31922fb8029016221a81a9a9f,1691,TRUE,2373,682,Radiant
053d5a9220b952fdf24d825ce485a603,692,FALSE,1585,893,Dire
d8f559b0d02b1f3f745a2d21d50dfeaf,1157,TRUE,1892,735,
3711155112e3bb648e6abf0e61438c82,412,FALSE,1964,1552,
a475210798d5370215ce49bd06b333dc,1212,TRUE,3315,2103,Radiant
1bbf1baab77f577960063e3c9c6eae85,2626,TRUE,3635,1009,Radiant
b7f5776a2b08e02f7359adee5916e3c0,1206,TRUE,1628,422,
92efb9ac2a79f4994151378ad0cfec1f,1413,FALSE,2930,1517,Dire
8bad1e84c9eaae335b218013fe97466b,2582,FALSE,2724,142,
5b58bdbc760547acd53c565b526ea453,828,FALSE,2092,1264,Dire
66e20829f9da4151a0e6b3e535ec7a2e,1311,FALSE,2262,951,Radiant
056d0b155c94acae54ca9c751a6c7b3c,1572,TRUE,3027,1455,Dire
2fa40bc08020e17f9ead1482fa2ed1e1,1020,FALSE,2302,1282,Dire
2ce8aa91c57eadbbf19cee9183334bf8,1405,FALSE,2838,1433,Dire
473ff66f1c8de460bd51180a00d018eb,291,TRUE,1851,1560,Radiant
93e3f7db4b9af526c68896a1f92bc715,2546,TRUE,3109,563,
6d2e06c1ad27b846bf36fa0ecdf08c67,884,FALSE,1579,695,
c0a71f781bd8321a88880329dcdc98ed,848,TRUE,1667,819,
148cc40804f42d27d5085fb9007a3c5b,1544,FALSE,2291,747,
6f81bb453ca57211a01e52c67e506e9f,267,FALSE,1744,1477,
aaa0303ec2fa45f43b90dabd86cf8388,1241,TRUE,2605,1364,Radiant
08f4453f8f5c1d72c5f00cc3cb9163ea,2434,FALSE,3134,700,
97857bbab7ce6e14c1a550b790958095,1141,TRUE,1694,553,
696e2b3990b76f2ecdaffe62f79f4873,1216,TRUE,2014,798,
7fd3a2fa733405f8b31aa19356e01ebf,80,TRUE,2723,2643,Dire
93eba08fa7c9d969573e3eb5291448e8,2476,FALSE,3000,524,Dire
ac831d981032ed9e63c2e9dc824d9d65,2052,TRUE,2304,252,
730820a46c48bc6f6e2004450a08d5d2,745,FALSE,2358,1613,
e3365899dd22feecc08dc181064331cd,412,FALSE,1658,1246,
0853fe19a1caf1ce775463a7f0852606,3248,TRUE,4094,846,Dire
d67725c7eab21e6fa810ad490fc16f52,26,FALSE,2586,2560,Radiant
2d0942fc8c3e7a5686a05b8ec4113897,1356,TRUE,1942,586,Radiant
249f5bca7496ebfe81bffbd7fee283af,1632,FALSE,2388,756,Dire
4e37d9da7d6f3bf8957a8acfafef5dab,662,FALSE,2539,1877,Dire
511c0a699deffa26cea340378041eae1,1637,FALSE,1951,314,
80eb150811c2d56dc096621835d8eafa,107,FALSE,1451,1344,
a2d5877266b8bfa9c8676adbe2a877a1,499,TRUE,1853,1354,Radiant
5838c7fdb8922ae9ebccdbf4f614f0f0,1198,FALSE,2167,969,Dire
9e218dee3df7d701ea3f9a3f449368a0,590,TRUE,2729,2139,Radiant
261136a2d7cef258bc66f39085e663f1,131,TRUE,2349,2218,Radiant
255e0ae421682afa17a08160046a8e90,637,FALSE,2052,1415,
57e05598667742e850386a1ea45f37fd,738,FALSE,2228,1490,Dire
6d55888cff3000ea127955c782c4698b,1851,FALSE,2364,513,Dire
5b70ca2d33a33f4496ba88dd27c4d0a7,985,TRUE,2262,1277,Radiant
d8e7d67f43572254e12faa3fc3084009,1404,TRUE,2295,891,Radiant
fa9f4764b2a7d41b649eeebcc0e61a8b,997,FALSE,2633,1636,Dire
93e7a789befb289724b76f2319bab482,508,TRUE,1904,1396,
d0c4968e1da5c0bcae85dfbc840c7395,1261,FALSE,2014,753,Dire
fec973be1f82f3fafd102b3ff81866cd,712,TRUE,1407,695,Radiant
0bce3ad42f7da40828996928ed323969,1867,TRUE,2157,290,
09e59f3225a9e7ff31a354179f36d3c2,1832,FALSE,1920,88,
e50bcc0e5765b5b3c69d3f55e4e09f6b,2482,TRUE,2649,167,
e9550dc4058db38171028327b29f410f,1822,FALSE,3391,1569,Dire
f2ceeb457f232ac4b06584bd191f61ce,1274,FALSE,2621,1347,Radiant
2af7bd31f8a3d55aff22ad2879fc66de,801,FALSE,2660,1859,Dire
1ca94d46a8b4159515abdb8df78f1cd0,2974,TRUE,3775,801,Radiant
c69ab032806a64203bf501431c1cc027,1851,TRUE,2109,258,
95a78ffbea94b14ba50f75d6714c3a1f,341,TRUE,1520,1179,
a65c4dcfc62a809952c97c7db65e46b8,1984,FALSE,2457,473,Dire
751e993eeae07933e365078a6ac665c7,2884,FALSE,2995,111,
cf64ecf38f1362c17e59975f11c010bd,977,FALSE,1498,521,Dire
fe069dd665ec3b052abace815d5a59f1,266,FALSE,1788,1522,Dire
b59af74239be3d8bedb9ebbace5a8a2e,1340,TRUE,3407,2067,Dire
039d37f99fbaacc47468929b36479bf3,368,FALSE,1798,1430,
cd7cbc7a020ffdfc19c1893338265697,483,TRUE,3990,3507,Radiant
234718eda04d85eb7e3c6a7f30f6e5d4,505,FALSE,2754,2249,Dire
cfba5bc69195a25fb69aa5f07ce26a96,323,FALSE,1746,1423,Dire
9f1e8a95325de0549cfd4d99d5a8a3fe,1189,TRUE,1645,456,Dire
a8704a7c45b4ee7314bc0271f8ca3b09,932,TRUE,1431,499,
f7a3a3f7f5d789e32507a728164f3e4c,1265,FALSE,2891,1626,Dire
e93c017339c7688e4a829e3d64b24c0d,1538,FALSE,2975,1437,Dire
abff2b5adc27a09252a31ce773bec0ed,676,TRUE,2373,1697,
5ea9f5196a95b07e7256117ecc2a284c,428,TRUE,2544,2116,Radiant
2bea2c9d990dc741d5bde6d2badcfce2,272,FALSE,1716,1444,Dire
38d6a4a571b419c87028577ec8cf48bb,284,FALSE,3171,2887,Radiant
7b18cc07559baeb7f59bac47e7f6183f,835,TRUE,2984,2149,Radiant
adae92341375222ebd8060ab7d8e4ba3,1829,FALSE,3014,1185,Dire
1f63160f23c17e5a4b3edca94b9e1935,1667,FALSE,2202,535,
c73379c4ba024febd144b9a5737c1562,1162,FALSE,4411,3249,Radiant
279899d504b8a19b10c9a994e3efcd91,31,FALSE,2931,2900,Dire
0b52d90694fd6cacf0177b595c7821c4,2053,TRUE,2438,385,Radiant
67dc42ffba06b9e5e02ef21136bd9387,483,TRUE,1774,1291,Radiant
0a646d98f73a38818741711821c32c9b,128,TRUE,1523,1395,Radiant
865b6f5ea1f1384fc42ed0db8c0f5bab,1159,FALSE,2670,1511,Radiant
156eb407eb74375ad14233b6f680631b,1106,FALSE,3880,2774,Dire
623a3bb65aebadc96a760d51f01576d4,394,FALSE,3108,2714,Dire
4de07bc90ad6f30c27bf53810c76e3f9,2333,TRUE,2690,357,Radiant
76dc6b3c6c60c4fce30b1aee2a217426,826,FALSE,1007,181,
7b15d51269bc6d226b50ef02d933d439,1607,FALSE,3398,1791,Radiant
b11481be4298a477a814944caa704606,1783,FALSE,2108,325,
737c891dca328a8cc92e2c87b32c32df,1190,TRUE,1272,82,
eab2d5962514dad332325add6f5b1d5c,637,FALSE,1727,1090,Dire
41b62cbbfb3618bb834fe33a4486eb50,619,TRUE,3702,3083,Dire
a51a61e3a0d750ae69fe187a189c8a70,95,TRUE,2427,2332,
7a21f7fd553dfa81c8f4adf55ef8c81d,2793,TRUE,2825,32,
481435a90bb9b99cfb5117440342907e,341,TRUE,3482,3141,Radiant
017f9c31f7796967852ab3d4644acbc5,3158,TRUE,3459,301,Radiant
b9e29e99a2309991941c7739b510dd39,2254,FALSE,2691,437,
7e2bc3a3c1d6f40e9ca03610d074e92c,1312,TRUE,1496,184,
be9f67a7662988b2368388aa807f06a6,440,FALSE,2034,1594,
3e3601239d8249cb461d16f76a40aa69,3028,TRUE,3615,587,Radiant
a2cf3c288fd289e9fd9259b0672f8119,0,TRUE,2514,2514,Radiant
355fcef1b1283973dff75fad090831e6,2093,FALSE,3121,1028,Dire
dfc0dce6a382e311a784bf73132c8698,1387,FALSE,2479,1092,Dire
1daa398867215c9aff01f1fd9314aba8,12,TRUE,985,973,
88fd81a40a7c0a5ed11ca515946edf4c,1154,FALSE,1440,286,
b45b8db880e590e347355f9fd1928a1d,246,TRUE,2221,1975,
da5fbd565756d929447079aff0436fdd,970,FALSE,1674,704,Dire
a7d85afc1cd94c796777596fe9bcbb38,1044,TRUE,1538,494,Radiant
d4d64a4f701b9e8913d7786ed819add6,321,TRUE,2076,1755,Dire
f999dfab5d159239a80b4cb53cd746da,1437,FALSE,1938,501,Dire
7b71eeb56dc1a2a4132cd837b2764772,815,FALSE,1778,963,
d9c3766f4f1364d9c14296f74e0cec61,475,TRUE,1456,981,
706f64f9473a58d9b2e735aebf1cc1bf,423,TRUE,1301,878,
fe204233e48f22478946b9079f647947,601,FALSE,1512,911,Dire
116391938cd4cbe613ddf4a6daf35d68,791,FALSE,2528,1737,Dire
66d27414270eb8788bb583dfe48959c7,2353,TRUE,2405,52,
a048b6594e2a5483f87b570c52358dbc,445,TRUE,1784,1339,
0ee545ff7295c29264a51ec1346d9bb2,653,FALSE,2071,1418,Dire
dd14db4cc5b0e281d266772162f90a7f,3182,FALSE,3392,210,
dd40395580b202e40c093f748eaa67d3,552,FALSE,1913,1361,Dire
9342f0b515b15cff1d1dbcd49119dca1,2719,FALSE,2807,88,
9a10f686b961c9b88c235f43cf59e8c1,1601,FALSE,2008,407,Dire
232858becb2b6aa49191e4f07fed76c2,603,FALSE,1316,713,Dire
7b20682d800874f98165d0168bb4f301,591,FALSE,2695,2104,Radiant
c7b20d83a27b61eb628bb90bd9cc77bd,376,FALSE,2488,2112,Radiant
9067f53d2cbeeb2222d14bb47ca928b1,1511,FALSE,2607,1096,Dire
2a98cbd2ec9de1d6273b0e8f13d7cd4a,2767,FALSE,3192,425,
61cf7aa6d30b3e8da781fd3f224d050f,1739,FALSE,1889,150,
e41d0e434f2845ca78b90e73aa6275de,1419,TRUE,2070,651,Radiant
065671f6b2865bda8e76bdea3fedbf2d,1098,TRUE,2254,1156,
1d850c3b4fa6647667c710fe4d7a7b06,824,FALSE,923,99,
bdcf25c4ca853c5c79fd8ad486a0ac34,0,FALSE,2287,2287,Dire
48429c293bec19153f7486c32a1a1bef,2043,FALSE,3081,1038,Radiant
43324b8717952a09bf0d55acd589eec6,52,TRUE,2040,1988,Radiant
3d568b614ac2ea57a59a71ca08fa662d,2336,TRUE,3140,804,Dire
4436503818e095bb5355a0307df7b3bf,964,TRUE,2435,1471,Radiant
242eee27693742814a57fb6cfe8bdff7,980,FALSE,2331,1351,Dire
70defb6bb05af59d557551281682b7c1,1426,TRUE,1639,213,Radiant
5139cc1ee71e65c092b3ef0827b22d86,343,TRUE,1761,1418,
3cb4538be09c0df235f2dd3bb0ea5e3d,82,TRUE,1322,1240,
dc824dcaffd2526c9e05f5417234dc8d,540,TRUE,1297,757,
53954755cce0051271a47d0d50c0d197,611,FALSE,2572,1961,
da72fd6f209a5deb7621f57f1d550b6d,1986,TRUE,2096,110,
d463a82677fdb8fa4517438daf1149fa,1958,FALSE,3847,1889,Dire
42df9ed0f4394d11c4445742cefb49c6,2362,TRUE,2510,148,
b2ee406598fb559a16570bbf3e95d5d0,1411,FALSE,1755,344,
6172038845b3b14766ba400f003ec5ef,110,TRUE,1404,1294,
f55e87e16f2fb484f5d28a19b09215ff,1628,FALSE,3017,1389,Radiant
f3b11079d9cbbf6feb68b8ff5ff91a96,392,TRUE,3075,2683,Radiant
98f9ee33f67e4de99f6dcddbd7d75446,1740,FALSE,2160,420,
1697244425ca0b3d9117dcbe2ff26852,860,FALSE,1260,400,
b054ed26315d6c9324ca92c66f66e9f5,1169,TRUE,2475,1306,Dire
f7019cf5d3f7b7c6c31d07c02e267c8d,1590,FALSE,2270,680,Dire
141330561948e68e8d51807aab6c41ce,1694,FALSE,3389,1695,Dire
40d00c9482c66e15b0e6f2626ac8388a,1863,TRUE,2509,646,
88245fa7b44647d810a0bc7d522429fe,2770,TRUE,2810,40,
59352f7a1d24fae292f0d60de65a386d,1854,TRUE,2218,364,
884c85bc8715704aaa85eb13a4f1e1e6,1313,TRUE,1927,614,Radiant
382ce6c37a02e477fafd020edfe2209d,813,TRUE,1531,718,Radiant
f3d8dce756b576024cb152490c3a4874,2287,TRUE,2978,691,Radiant
65726b3b8446ed6a062554c324602bca,874,TRUE,1835,961,Radiant
c3d77054216e41062e672ec342845f0b,1270,TRUE,3319,2049,Dire
a485b1b9cc487b6c33e5006186e15784,1438,TRUE,1472,34,
781d370b273e6b67d97f3429832cbab2,1839,TRUE,2211,372,
9ade31794c539743e042a98b67277369,179,TRUE,1312,1133,Radiant
90d356726b6664a2d9e851af7c6a7e91,972,TRUE,2475,1503,Radiant
8eff44455b30c042e6ebb03a9253c5f7,955,FALSE,2920,1965,Dire
700019f3fd21439634bcb4aae6ad19a0,399,TRUE,1736,1337,
41c4b638b43e6dbff0c90e9302cfe498,927,TRUE,1537,610,
08158cc56d38583deb908a81564b45f4,2440,FALSE,2728,288,
b0763a5f67a879890f9f7f95970e6f96,243,FALSE,3292,3049,Radiant
df29ae25ba264fb00276fcb741ceba55,628,TRUE,1913,1285,Radiant
f8500c6dd37464e91a70583093ade3f1,333,TRUE,2795,2462,Radiant
1e6f93cd6d89920e5b26bd0ed4e73f19,898,FALSE,3231,2333,
a6c747b601c7b5937ad35d7326bba937,268,TRUE,1381,1113,
cc0228f71c82d64643ecbdf809754951,1153,FALSE,1489,336,
eeaacbfd1ef17719948c27c9c7ad24ed,213,FALSE,1897,1684,Dire
db0206ba0accc417ef87c5b02dbfb066,723,TRUE,1153,430,Radiant
4a166ddfb220ae61be57c127b62f5370,2032,FALSE,2607,575,Dire
aae6f6976fafc280043fbf315a11aa8a,132,FALSE,2348,2216,Radiant
503b71ae07147a4c3bdbc6b55b6c99d0,1811,FALSE,2096,285,
252dd1ad4a58d9e4aa75eeec6a6470a5,1001,TRUE,1619,618,Radiant
8e13d36f986a438982b430c741b2aa16,36,TRUE,2549,2513,Radiant
e3f56ff9f8f60a12a034d9043d2a6ecf,1477,TRUE,2447,970,
f7bea3f00a3ed4ac554ba9395fb8786c,539,FALSE,2020,1481,
f9f5e44a01019e849471136785376021,465,FALSE,1900,1435,Radiant
283d0aab8af943f4984e5d14f5b6301a,1466,FALSE,2557,1091,Dire
9a330dfc98431c11781d841750bebf7a,240,FALSE,2116,1876,Dire
d9958599371e6da506bec76998db5a6f,479,TRUE,2428,1949,Dire
b61941b1d5619dd8ae3e704d414af488,1670,TRUE,2152,482,Radiant
5232cf453c7a31442722d425cf6d0810,992,FALSE,2478,1486,Radiant
f8ac4dae90c488da6b7bc19b5fc79dc0,2237,TRUE,3288,1051,Dire
9d8e1ad2e7d2e078ed19128c2f4331e3,747,FALSE,2829,2082,Dire
6f92d083e25417d35d8bce2bacbff919,180,FALSE,1863,1683,Dire
56ece986fce08b736d54446bd561dbeb,1375,FALSE,3392,2017,Radiant
713736da19be545e400e5f252427af3c,1603,FALSE,2818,1215,Radiant
382c08862273cb2c0592b753dc77c490,1770,TRUE,2410,640,
3071c232135b8b8ae408b3b7d77e1b6f,1906,FALSE,2067,161,
87754eac3bcd2e924e08e5356cf111f6,1069,FALSE,3268,2199,Dire
8721fd0e71d98f6eb96e3b3d2fc39aef,931,TRUE,2104,1173,Radiant
e5e605d23365923c95664abf27b66d85,631,FALSE,3481,2850,Radiant
292d4e8b72ca9f63da7229108f389d1c,552,FALSE,2666,2114,Radiant
b9067d966e2eb134fc7d35513d865e29,1374,FALSE,2037,663,Dire
8ac4d918b11a49e0b7bb8debe72128ff,127,TRUE,2170,2043,
7c9af0f59f676f4fccc4c152a0fb35fd,1029,FALSE,1240,211,
ef7cb98a79f402e8cc145a440f8f7856,1171,FALSE,1482,311,
3bd1761f5c705827812d2f1d46bfa78a,2038,TRUE,2391,353,
e510cd9fb48defc48430179feed409c5,2028,TRUE,2316,288,
fa629654d0f42c0ff30083c0ae07311c,2295,TRUE,2379,84,Radiant
3d1f28b1386cbcfd45ec829ad1420f08,647,FALSE,2943,2296,Dire
cf179d04c814a6af2d830fcdccc15365,1672,FALSE,2149,477,Dire
e5b3467820cd8dd781481a7f26c67c12,744,FALSE,2478,1734,Dire
b9bce1c19664740bb7b29fe5898fd2fd,2000,FALSE,2371,371,
2bf611a9e015684b13d378e2311870a7,456,TRUE,1110,654,
9a710528138d7fcdfd739b732881f7de,674,TRUE,3328,2654,Dire
57fb781c4c16ba3241919540ca7723cd,699,TRUE,1759,1060,Radiant
488015f4a4476d9c186ba19e07c75768,1260,TRUE,1592,332,Radiant
82d024a8d9a9f81ccebc88a56f413cee,370,FALSE,1098,728,
ac12df8b0059e64d033cc6351ce7bf6d,2643,TRUE,2719,76,
0a82a8c6df28a876e5da17ee00e74b85,2450,FALSE,2770,320,
5fa50481101d8743b8ef98cc884ae1ab,659,TRUE,2341,1682,Radiant
9a851018300ef530858647b4980e34f3,782,FALSE,1510,728,
f6fb21da8113b307b4691a304513f64f,908,FALSE,3115,2207,Dire
6c924a72cc713b1380245e9020cf6b4b,358,FALSE,2486,2128,
fd69a769026a97d08b532e6309b942c4,195,TRUE,1701,1506,Radiant
d889429d3405ec15fdfbf815bb689543,1407,FALSE,2664,1257,Dire
4cf8e53ed9ec0f0ee49e7a6d0f4357a2,494,TRUE,1563,1069,Radiant
98992cafe24eebb276972ddda05c357c,453,TRUE,2540,2087,Radiant
e3ee04292f142ed05b919927daf8b4d2,550,FALSE,1502,952,
351576e9b300763e2a594c6b387f2c02,462,TRUE,2202,1740,Radiant
db19a8d01fe9514e9d3596bdd4af4760,1871,TRUE,3394,1523,Dire
4edcf6f807409522776788be3d6de883,1993,FALSE,3675,1682,Radiant
ae5ad1f4a9c80826481b9fe40bff32f2,312,FALSE,2164,1852,Dire
6e726395e239ac1596c4862d2e62895c,1423,FALSE,2055,632,Dire
e8ad6dcb22b138c5d389ea8ba92ed483,122,FALSE,2516,2394,Dire
b4c31dcfa25e57852e43e5baf904bc70,604,FALSE,2853,2249,Radiant
dd3ae4751ed65d29f1c840df8687bdea,3085,FALSE,3300,215,Radiant
7647209b99d0d026d87467bd453eff62,498,TRUE,2116,1618,Radiant
6cdd63b510ea3d1fbd4f1b9c6097e01f,649,FALSE,1879,1230,
eb4172dde200cc132a181c8dd47aa78b,597,TRUE,1054,457,
cc63c9bc7449a1c1a593c164fccfaebd,200,TRUE,1297,1097,Radiant
013e26bb0e3d501ce93e057fdbabb834,490,TRUE,1785,1295,
c3de75a7f19e833d24bd0195f5cb4ab8,374,TRUE,1411,1037,Radiant
544d94ddcff187ab9b89ab50a544e99e,1923,FALSE,2913,990,Dire
d9866a120856bdf1b4ebad0d9b17af04,214,FALSE,1891,1677,Dire
1cd0e9feddf40c884cef7abacb15d2a9,1937,TRUE,1975,38,
35fb181fe20487a935445974398ca24b,1502,FALSE,3142,1640,Radiant
cdbb4a280434f7b2f9cb40098d338a88,2092,TRUE,2510,418,
d82e93961bc6504aa874e5f0ec369d8d,151,FALSE,3057,2906,Radiant
6eb1bae653b99baef840db0882a30e76,304,TRUE,1739,1435,Radiant
0b35b6d1de33deef2e85de6682e92e8c,1075,FALSE,2280,1205,
7360296aaa1474b798d4d04c0fe3c019,543,FALSE,2637,2094,Dire
14c48b4f2cc7d5fbdf1f285da409ef17,1636,FALSE,1888,252,
3269ee802114c40e2ad82ac3cb90f840,1111,TRUE,1534,423,
db2674625d442fcc26ba8bc042feaaa2,1672,TRUE,2048,376,Radiant
5b20bd82849a68a29b29d691bbf7f8ad,313,TRUE,2040,1727,
64502dbd6fc14adb58081944269ed13f,1920,FALSE,1980,60,
924d463dbe5721428eced2afc722881b,669,TRUE,1922,1253,
bc2dfb30fc97b1910b8bfc7a3615c880,2264,TRUE,3000,736,Dire
8d8482c43d9dd8c12c0a5a7d174bed14,2984,TRUE,3242,258,
fef01c158948121c959e22b000f370d6,252,FALSE,3459,3207,Dire
338e718f2e48d86dc1c1b59979b8fe16,825,TRUE,2889,2064,Dire
9f81b6e24b37d12f3e7462ea0a269733,3640,TRUE,3919,279,Radiant
d4ea4365e224667786eab11d5cb6bbee,1372,FALSE,2199,827,Dire
1415530a062511d6c56c766203eb1f8c,778,TRUE,2055,1277,
c908f544c74fc23c77a555f1b8bc45ca,329,TRUE,3008,2679,
b8957ecee17fbbb9b7cee8dfa32264e4,1392,FALSE,2479,1087,
3d3a6a63b24d0a4843152f2c4f890479,2545,FALSE,2607,62,
5a877c69e05a1018f4b293185038f80f,339,FALSE,2202,1863,Radiant
8432870841fd4fa9bf794d49eed7ecb3,1606,FALSE,3051,1445,Radiant
2e5870a97df45a107d651edf298601ac,388,TRUE,1267,879,Radiant
ec54126d6615beca4375686ef8cac94c,2775,FALSE,2985,210,Dire
52adeac66e12cee13f891ee180ad5c49,2238,FALSE,2331,93,
6d07627f63933acc1b64fcf998dc1348,1869,TRUE,2822,953,Dire
edf8cb2149a2f4c79cc9d2dccf0a2901,1301,FALSE,2822,1521,Radiant
81fbd1c6a47f835f819c15b16d05993f,1939,FALSE,2684,745,Dire
2f4f3c348cb2ada999b5bdbc15b6d23a,302,TRUE,2895,2593,Radiant
84a8cd9e979092763666cf66dfcdf9f8,2192,FALSE,3163,971,Dire
44ebd20478c70acd5fda830fa7ee1774,1856,FALSE,2191,335,
bd3567efdec6f486267afb0e31924b5a,1,FALSE,3197,3196,Dire
c78225a9ecdbafeb2cf2de968de8bc89,1090,TRUE,3045,1955,Dire
8dfc3abc8e4b979c2500b47046bdc255,96,TRUE,1447,1351,Radiant
4baea882f60837b72950f5bb41c97660,1581,TRUE,2191,610,
0c63424c9c28e3527ba0b21a603ccbe1,1021,FALSE,2574,1553,Radiant
6db5cb7aa4452adbaff06ea0f4acff70,38,TRUE,3105,3067,Dire
5d292ee9afdccd96caa9f9194c50a3fc,639,TRUE,1554,915,
2843d7d6c6a3a587aa4f40c146f5f9fd,435,TRUE,1238,803,Radiant
a7aaaf061342459975ee70e90b1f7c16,942,TRUE,2109,1167,
434f4610033fe4d11ddad5782c8ccb0b,1860,TRUE,2068,208,
2240e56e108fed6a4c70484cb5e67500,363,TRUE,2393,2030,Radiant
1efbc61374b189790020f6028372f808,829,TRUE,3200,2371,Dire
910c019a169dee7ddabcc79f0caf79ef,1100,FALSE,1970,870,Dire
97300382247b0d124e4edd16866e23f2,448,FALSE,2606,2158,Dire
b225aa739e319646dafeb0fa2c11a60b,1194,TRUE,1481,287,Radiant
6821d7ba02cd243322e249ad4804c49e,320,TRUE,1584,1264,
26b4a615c7965140331e3d0d2ad2fd93,288,TRUE,1711,1423,Radiant
799d00636dbe47826477542a5289e4d1,1380,FALSE,1621,241,
044ef1c102af25fc40de6bce867ea851,1571,TRUE,2416,845,Dire
f31c7d9e421a3ce1b5c5a1185da47fad,377,TRUE,2576,2199,Radiant
f0708f680271590fba363a366d3bb63f,1081,TRUE,2254,1173,Radiant
18100c71aa10b72901c88d946647ff8b,1985,TRUE,2918,933,Dire
4a1c1d8316d180cc9267f7e8ae4ecc0a,716,TRUE,2581,1865,Radiant
07acc82ff53cab6b7634fefc18bfc8db,818,FALSE,2745,1927,Dire
76a01681c37bcffaf75e217e48ef1e15,1413,TRUE,1606,193,
2291a92bf4b00061810e71fa2bfa7089,1530,TRUE,2140,610,
f7d761bbd127870819f890f3cd076f2f,345,TRUE,1467,1122,
2c227bee6d92962b525345ce64e4b721,384,FALSE,1036,652,
11e694373e1441310350981650138778,972,TRUE,1239,267,Radiant
bd9426b989c32700c78d3f10015962d3,1849,TRUE,2321,472,
fdb7c384a25d2b12b0ffb00346a1dfd1,1538,FALSE,2551,1013,Dire
70280e9540ac3e59d677a580403abd54,1092,FALSE,2696,1604,Dire
9d5bb64e7aa8178e3df3b1abcc4f8913,1592,TRUE,2519,927,
b1652e11f7c7ec28434441c56c9b03e5,2730,FALSE,2811,81,
3cf7f106a596575ce08e7b41712b4585,1204,FALSE,2437,1233,Dire
d33140a8766d580cb243e7f350950e20,418,TRUE,2177,1759,
a14675bb199dffc8683079cb4e7f7fc0,1542,TRUE,1580,38,
6375aff8b6804ca94f03c9bcdd893ec8,1334,TRUE,2046,712,Dire
79655ee3f43f093c9eb091f2cab21ab8,1905,TRUE,2316,411,Radiant
2c3eb10f890bcef5dec3871efa1e4421,1357,FALSE,2187,830,
908ddda3ee09d3bac375186b366ec88b,1764,TRUE,2601,837,Dire
999cf727104f832c9edf9e5790ef7c05,1405,TRUE,2584,1179,Radiant
8d70a2bf31b640f19aaa04feb5519c5e,910,FALSE,2887,1977,Dire
96b30c10ff708ad26ff62c44f64591b2,1022,FALSE,2763,1741,Radiant
609f675d7c799d18d51ada4cccd80b24,31,FALSE,1820,1789,Dire
b678962e40184a8f0e717950060de40c,472,FALSE,1197,725,
5d0fd8bcfb89211d7a99ccba0940fb34,2630,TRUE,4438,1808,Radiant
4742f59dc54de9dfdf6f6220985a71d8,2783,FALSE,3613,830,Radiant
bfa1e90a1f809d1cb9cdb25d18e536fa,1036,FALSE,2131,1095,Dire
75b085e8273984a9cfda1b6cd9e4521e,1630,TRUE,3118,1488,Dire
a76168fa8c159e00fdc8d6b46054adb4,360,TRUE,1614,1254,Dire
0de9b8bfc255a80a1464b9561a700369,2020,FALSE,2184,164,
96f25f8ddbd224a5dbc03d5654e9f955,259,FALSE,1573,1314,Dire
49be23655c82fbdbe3198aad697bb91b,2258,TRUE,2487,229,Radiant
9308a5423845f43baa86f245ace30b79,564,TRUE,2495,1931,Radiant
ddeed878ed3bb16b8b48cf42158ffbf9,1359,FALSE,2053,694,
3d704b2768f6b0aed40eafb04ddc4292,763,TRUE,1610,847,Radiant
04c5773d735bec43cb0ab5a7bdbc9365,268,FALSE,2030,1762,
a3f6c43e2c4d5645131817e3ad408539,530,FALSE,1941,1411,Dire
ccc31aa8fa5281fef334d06805191dfd,660,TRUE,1209,549,
c494bda0275b73adee6b0332bcc98d18,1266,FALSE,1981,715,Dire
9ab3ca063f6b9c0884c16d2f062f6da6,107,TRUE,3363,3256,Radiant
37f4561b25b99f09d9e586c0ef9cd267,2228,TRUE,2607,379,Radiant
d37aa645d11513db9fa5b15026124c04,2477,FALSE,3092,615,
2ce32294cdda5337887ea6280156c4a4,366,TRUE,1611,1245,
e957531083f000dbf7bc38bcdfd80a35,442,FALSE,3233,2791,Dire
f227b73efc8a7e1bfdf2aa7cbf2cbaab,909,TRUE,1576,667,
6b4533b6aca596af82e5b7e492ce4a46,44,TRUE,1917,1873,
261dcf00b2342e40484542e5d4973905,977,FALSE,2303,1326,
8b8d44cd398d5ae6d4394922625c7896,1588,FALSE,2648,1060,Radiant
0a04e39ea126f49f57cf65bbc57c179b,365,TRUE,1917,1552,Radiant
d414485cd8b9a66870096d511956a73c,1664,FALSE,2543,879,Dire
98d6b0575e348dac5ff499dcb515facc,829,FALSE,1811,982,Dire
e4c82d0e59a12c33a9dfaca744609305,1534,FALSE,3265,1731,Dire
089ad35eb52ca31c3ff1bc8d754e77eb,2802,TRUE,2936,134,
aeaf265e2bc81c735142a7c9454dd17d,1434,FALSE,2274,840,
d6d900f724af9408b5ac4770a8e276e4,702,FALSE,1144,442,
4971586ac16c0a78b45f5ffd83db8a98,1954,TRUE,2413,459,
9cdd8d18fe1b71300cf5f39daa4b4d37,1344,TRUE,2090,746,Radiant
58584e90d4c17869e024fb4c6dfed98f,1789,FALSE,2023,234,
a4c53efb2ef317790cb61ffcb6d35936,1091,FALSE,2099,1008,Dire
9b9ae25b280ba78e8ac4200c3c33f382,1667,FALSE,3228,1561,Dire
8fd425c0da1ae9241d3677184b91f5da,913,FALSE,2179,1266,Dire
7d1f9bcf3ada8025b6275a11c90e12c3,2330,FALSE,3342,1012,Dire
5e9f2b2bb6d33184a0318689f52a1c53,2039,FALSE,3172,1133,Radiant
4c42d2a920e85ae99766c61ad82b70e8,1540,TRUE,2185,645,Dire
dfd20f613ff88829b792e3694554ffa8,935,TRUE,2595,1660,
f9d44a8e31aa7f4fc67abb7a306a5e9f,1516,TRUE,1702,186,
21b81a10cabbd8f19fb6111b8c360cbf,642,FALSE,2517,1875,Radiant
c7e3c4461529af2aeb3844298a7a6d45,3228,TRUE,3327,99,
025e10a8c04c444c4d9cc0fbf209d2b2,110,TRUE,2602,2492,Radiant
94ea6405af8b16c2ca5b2e4fe5cfcfbb,802,TRUE,1939,1137,
917697d26bda2799b1d6f3db0f03d8f0,4058,TRUE,4956,898,Radiant
706e376baf196600ead01a5127a3e032,573,TRUE,1898,1325,Radiant
63d6f0e69f068fcb797f6682dce76ced,2413,TRUE,3545,1132,Radiant
46cd2daf09a8f60c6c7701dd2b46603a,563,TRUE,1546,983,
d7f04b448da42d13a660000b8eff01a5,971,FALSE,2690,1719,Dire
4a4a3558555dcb59aad111895da1077d,1091,FALSE,2651,1560,Dire
0e6b06c3f2c71de478fdb07a7aaf2a08,421,TRUE,1546,1125,Radiant
730132f2f2a854f4dab478b7fe035777,146,FALSE,2155,2009,Dire
1c593e15a4607a1933ccf0c500208a4a,680,FALSE,926,246,Dire
e40c2a20ed1ea077a12ed8f2be1244f3,1224,TRUE,2498,1274,Dire
998a80bfc97284b0228a0990fea260dc,920,TRUE,2078,1158,Radiant
bc55715971607fcdba0126483308642e,1179,FALSE,2126,947,
33d88b1645d554dbec3fda7bb7909de1,1081,FALSE,1450,369,
e37cd1cac466f805f48a7c8a7264c5d9,1860,TRUE,3079,1219,Dire
52a91d02630b53f7f97cb05c7fbd698b,1432,TRUE,2454,1022,Dire
36180e8b260ff23d6419c965c214bb47,1732,FALSE,2445,713,Dire
95eb72b82aee1d0d8b6f2b2dc11e9d0d,1392,TRUE,2275,883,Radiant
9a68d751e1eba3fd454af81700fea7c1,543,TRUE,3243,2700,Dire
128306c83cb51d987731f75e2410e053,2494,FALSE,3732,1238,Radiant
4254816548bab509a8657c90993b01ab,2538,TRUE,2684,146,
14a93a75e69dde312370d748af9def25,1126,FALSE,1571,445,
e09d73de728c777eb524581b8784cfc4,1124,FALSE,2580,1456,Dire
f13400df3bd1a5ef64471bf058b671e7,324,TRUE,2056,1732,Radiant
7decd3f495fa18a09764386282bdaed5,23,TRUE,2214,2191,Radiant
a380749ffacae10335acbcd528fa61dd,2426,FALSE,2747,321,
db8ec3d03a10201a9958b3c3d4f54841,764,TRUE,2079,1315,Radiant
9e14a4cd54efb410886d1adc93e0bbe2,2077,FALSE,3223,1146,Dire
6974e354d910a6759e1059eea7a5b0d2,1153,FALSE,2485,1332,Radiant
4d24e7aca08e1a1b79f4999160826537,954,FALSE,2133,1179,
5a8617987e23d0cbc1d03b82591e8c6d,1787,FALSE,2541,754,Dire
032560ff719383dd3318037a6e1b2ef3,1199,FALSE,2473,1274,
2353d1bf1d5e7d39829b2ec95464f7d2,1274,FALSE,2226,952,Dire
5ad9058310afa3532025d6c905effb1e,1942,TRUE,2187,245,
49489f5d1e18ed3490dcbf13cdcd92fc,147,FALSE,2797,2650,
b8ef42bb21eb1bf8ecf23a9f9c616ab5,421,TRUE,1791,1370,
54de4236b14f42c78e92ae5790fa2427,2002,TRUE,2373,371,
4697f101d124115a38b6781491621cc0,2077,FALSE,2751,674,Radiant
84757fba1b18e8db5502016e0583ed58,149,TRUE,2448,2299,Radiant
f372d3d8bfa36a506621ffb44cfc580d,1447,FALSE,1858,411,Dire
b08cac5f1b131ab6bfa497655ff77655,1197,TRUE,2151,954,Radiant
0ecec9744f85c12da85963eda2e67247,1527,FALSE,1850,323,Dire
3eac3b4a55a2656d02bcb83c0034cb78,3129,TRUE,3517,388,Radiant
a3457958d96bedf18abd7fffcd362d0c,653,FALSE,2005,1352,Dire
2910e545f4f4b686f27a3067fb542123,1333,TRUE,1684,351,
0fdc93c125dfaa33ec9517d7f3fd223e,1425,FALSE,2248,823,
85509d0f42a497a2d962de2f5e6b12a0,980,TRUE,2567,1587,Dire
3eec350cd35550e51debb3a1c247eca2,1867,TRUE,2518,651,Radiant
ad7eb784afa3a11d7870717c67d80de8,713,FALSE,2332,1619,Dire
60c0a52565a0a65b94c661052efb4e5b,1103,TRUE,2577,1474,Dire
d692487746590eb4e104f071743afa9e,427,FALSE,1368,941,Dire
7f4717d0e231fdf28785a66b3f181c2f,97,TRUE,2877,2780,Dire
3634891c29b30a7daa013ada2fcaa709,806,FALSE,2529,1723,Dire
104d935e7af0afa41d5afdd38b6def38,2243,FALSE,2427,184,
3166318c4d39ea16670e3b7b1a084284,1378,TRUE,2487,1109,
6ff769eb95c4123f72e4fa70992133b8,1168,FALSE,1434,266,Dire
76c20838da2f362b5662e1060dab6b20,230,TRUE,2126,1896,Radiant
d92dbfcd9cee093c3d1fb2b348780f11,25,TRUE,1872,1847,Radiant
cf91af9e7fc221833560a6518a52fbab,1533,TRUE,2743,1210,Radiant
eaecea4e59dcda0fdd541b68d2fcb4fa,1743,TRUE,2148,405,
e4e013ce3f55e0298bbbbac32c4b956c,1541,TRUE,1593,52,
8f735f13d35460868bd901647046b50d,880,FALSE,1574,694,
30f45fbb90bf6f83ee39e00aeb4cf099,282,TRUE,2276,1994,Dire
bb15937320559d40bc20bedc9b05f6c0,102,TRUE,2410,2308,Radiant
c3bef51bc609fd65b3b4ce134d326bb9,249,TRUE,2122,1873,Radiant
8b63cea8b749924fe1824850b29a4aab,1738,FALSE,2305,567,Dire
cfb6b4053a093789fdcaede47b3bbc18,1446,FALSE,1704,258,
fbdc41a9e64a3089d3c95542513961bc,864,TRUE,3232,2368,Radiant
43ef976b248bf6ecca8530c4dc1b36a7,1570,TRUE,2311,741,
b37a6d63a8bd9f047a8d63dce11173b5,206,FALSE,1574,1368,Dire
9ea9bf3f2f189471d2f84b631c5260fc,1310,TRUE,3349,2039,Dire
cba6bbaae2c568a1982ec69abf768f1e,1012,FALSE,2265,1253,Radiant
420c1d52b6a90c54d826a94e1ffeccf3,1554,FALSE,3209,1655,Radiant
e57d4398a48986b7ad899978d5ea3935,634,FALSE,2407,1773,Dire
4c8e967849723dacb46a65a1b3c6ea34,1780,TRUE,2533,753,Radiant
3f89d2596455b248b53dc4eb1cda971d,1082,TRUE,1974,892,Radiant
255cab902766a2448d9dd234f2021c4d,2456,FALSE,2693,237,Dire
480b718c1c0ba0e3cbb6ae731ade1b4b,1888,TRUE,2515,627,Radiant
8bfc178333b4ae2be6111b93195cb7ad,901,FALSE,2203,1302,Dire
8432fa2fcd80b26f03c665aef8185003,1459,FALSE,3102,1643,Radiant
a5537a1db2e645ea0cb7be78cd54d014,69,TRUE,1032,963,Radiant
4a90f8d95179f9d46f9a48d806b48ad0,2181,TRUE,3578,1397,Dire
53f45cf33b853fb1fec6f7a3cf877002,2084,FALSE,3066,982,Dire
01427f85c28de2c22d7a1c69bc23acdd,2265,TRUE,2605,340,
d8fc32572b77a35079eae427b6a2f627,470,FALSE,2311,1841,Dire
3ed2ab3921e9ed8f9f27c26be90cdee5,781,FALSE,3129,2348,Radiant
576de50cf04e4b3b604018b06fe51ebc,1463,FALSE,3068,1605,Dire
916b7002f2d7deeb2aa49e2db2ab4ddb,2378,FALSE,3338,960,Radiant
b929ecde5ac32c7fad0a7e4ccdc45526,1434,FALSE,2810,1376,Radiant
09b06773d4ba11e858e1042194985488,0,TRUE,1272,1272,Radiant
a9b6b79417126f1321807f86a22c3e29,105,TRUE,2102,1997,Radiant
7bcb715baa0547ca6fa8e15f69a17196,722,TRUE,905,183,
7a74625b6b53a7540619c2f18974806d,463,TRUE,1540,1077,
26ad781d3483cd0af0565b80b0befa48,959,TRUE,2454,1495,Radiant
8a2bdab4a785a00df8380761eefd74c2,540,TRUE,2648,2108,Radiant
4fa72f8258b73cb8359fbd8712aa1f2f,868,FALSE,2576,1708,
83e7eba591a39f65a170d13ff5bc51e3,360,TRUE,1504,1144,Radiant
695bc335f1ee46aef3c164c5a5d28aa1,1415,TRUE,2735,1320,Radiant
4590db1da2427f6a60f0e8925d7b52b5,1365,TRUE,1887,522,Radiant
53e53d4f5634e0b366f06148f30e48ae,2165,FALSE,2486,321,
f7e9225dfc9e5afd8fab92a8d2acfdbb,2964,FALSE,3656,692,Dire
75334bb308543c69e6aedcd8146999a9,531,TRUE,1719,1188,
8c763b862942a6396a939bc3f1f0ce4a,572,TRUE,1101,529,Radiant
543888dd9f757c58ec20acc0bcc303d9,1647,TRUE,2017,370,Radiant
3f64cdaf48714dfe894515ef497b2364,497,TRUE,2628,2131,Radiant
ab72ab466a06f4e626137b50bb77f2c0,1223,FALSE,3203,1980,Radiant
e48c573658c237896c9b58e30dbf60c6,868,TRUE,3331,2463,Radiant
4aa6cf43813d2b351a458c87bad32ac2,2278,FALSE,2771,493,
86d69c0f3f9a118a7826dfb9c3675518,2130,FALSE,2721,591,
b2ace0db6370ddc89827f9ebe34fc1f3,3843,TRUE,4108,265,Radiant
bfb2ec4201767b8ef22e667e5dc32c2b,519,TRUE,3099,2580,Radiant
1fafa9650b31d39b8658c7d2ed41c5a0,115,TRUE,1275,1160,Radiant
478a4646b575cf19f507c46a7ade93b8,439,TRUE,1113,674,
9767c97507ba2a60965cecfbb4db3faa,1091,TRUE,2126,1035,Radiant
80fda5fc01fedd7894a28fbbe01aae5b,1219,TRUE,1896,677,Radiant
adf5b866665e70694e7e340398c95c9b,198,TRUE,2706,2508,Dire
66e7738b8a4460e9a5b579b463e98a19,2794,FALSE,3090,296,
c6a271adf62b430a348eb15ea884721f,103,TRUE,2104,2001,Radiant
1451b2301a7ab591c80b40c609f5258b,614,FALSE,2283,1669,Dire
b6b589612efde9ffdac06fc3597026c0,179,FALSE,1902,1723,
c7efbcd42a7f247ad9ef7da0e11e171c,2024,FALSE,3678,1654,Radiant
9efeca7fd788161a75a1a6c6c5d3cc33,1986,FALSE,2110,124,
519c3490da245c9e08c0f7e6a05d0505,425,FALSE,1989,1564,Radiant
882100172c46c99cf5840b338e19b5c1,1365,TRUE,2091,726,Radiant
ac92f34c19c068773fcf27ea6ba514dc,0,TRUE,1553,1553,Radiant
4f72b76661befe213852f8f7b1e981a9,1506,FALSE,1639,133,
869e3694525c62e2973138e391ebaa89,595,TRUE,2121,1526,Radiant
732803d96c9d7349f82658ac84ba6f9a,408,FALSE,1769,1361,
81f912f919916f22db572a068f4fe57b,562,FALSE,3021,2459,Dire
196fe256921147aa3573a2ca73271d08,1089,FALSE,2538,1449,Dire
bebd3bf26682ae67d3a0899bb1a7e59e,13,FALSE,2299,2286,Dire
fbfbe667c9d09814d63c167ae1ddec08,1563,FALSE,2519,956,Dire
d1a121b96567dd7778d2214a94837cb7,389,TRUE,2675,2286,Dire
0209ff9d896f0a51911fbba02f1d1944,626,TRUE,1629,1003,
5abd30a83f9e58a4db55bbd38726fd73,1747,FALSE,2508,761,Dire
d0f60cc49dff7eda9a4db7220c951423,2676,FALSE,3323,647,Dire
1f1a45aa5a1819cb61052ff479592815,1372,FALSE,1929,557,Dire
2a7bf54e55be61f9d184d8e2ada38d7b,1431,FALSE,2160,729,
5f7ed73672d168e3342f165de418b7a1,2405,FALSE,3215,810,Dire
a1a6ddb2261743ec26088e28a4f94216,1379,FALSE,2140,761,
cbb7b9e90a6df46c0179cb020227a320,398,TRUE,2196,1798,Radiant
37164f76aad8e36271fcdd88ea29a315,995,TRUE,4044,3049,Dire
46b24eed1126362fc78c0023bfa78252,2071,FALSE,2593,522,
6937015e664a64c2cb0e6b9e04d324f6,1947,TRUE,2002,55,
efd04b8427ed10fadb8f2f73476b17e3,761,TRUE,1294,533,
f226773ed987d7a5839c9c500b6c6cbc,1358,FALSE,1632,274,
4f66b49da275b3c912710c610695b1bc,1009,FALSE,2077,1068,
9ea2906524247acd27ca9f4c50c656b8,2369,TRUE,2568,199,
1b2409fe132e9da8d5cc2015e86964ff,895,FALSE,1495,600,
1e8469b6a86e1781f0a5ef9dc0b760af,2054,FALSE,2092,38,
c0abd6fe4755d8e93617341c9a741426,1654,FALSE,1703,49,
7d44a34bb052bf8a65e7fc691c373b09,1090,TRUE,2165,1075,Radiant
f9a0740bc4136f801cb8c2e7e72cc667,73,TRUE,3437,3364,Radiant
b5d87897afd8d8dfbfc6b67e6163ee47,1433,TRUE,2196,763,Radiant
f8aaa1051b649160beaf11ddc16294a9,387,FALSE,2619,2232,Dire
11c6bcf92eeea334e555bc71306f0747,720,FALSE,3832,3112,Dire
8d7b16150bdc2c36e8291aa62d7b7c1f,1605,TRUE,1722,117,
1785bc11dee3d9c0a80b37296f6aea55,66,TRUE,1976,1910,Radiant
e7608a2f0a94b4b123e859c6bb01e4b8,226,FALSE,1519,1293,Dire
94d370c37c2c3555dbc7644bcf1b56fc,416,TRUE,1627,1211,
308c30eb6ad76445660902fa636042e9,1318,FALSE,2416,1098,Dire
0f6da1d8c58d295b57daec984c717678,1400,FALSE,2628,1228,Dire
32b9208e2df0ee6fd7f200bbde74157c,470,TRUE,1781,1311,Dire
2ee962ed1cbb495d21ec8fc1e8bde8a4,2219,TRUE,2322,103,
6bffbb3f7fdab0f3c19cbe43d246b269,344,TRUE,2507,2163,Dire
21b6a7f0de242eee55eb4ac8110f8075,455,TRUE,2638,2183,Dire
158483f4d664c4050d3d274b62237090,722,FALSE,1291,569,
4b8e7df480736a193465af822fa6da15,209,TRUE,2707,2498,Radiant
9e56dd223c635a906a6c65e4b37b8afb,787,FALSE,2737,1950,Radiant
3c299372ce846d3326a78c10ac4e48e8,1010,TRUE,1288,278,Radiant
03efe7d4fee3d05952b618605b69f78a,664,TRUE,1690,1026,Radiant
e37601849c16e69e9b2c82cf63b39318,1936,FALSE,3052,1116,Dire
24c2c1b569cbfb5e383d9ecf94d86325,984,TRUE,1492,508,Radiant
ac363b497dc2f66016228196c7fdfd28,1198,FALSE,1785,587,Radiant
99fc9cdc0631b3451817ad529185a45f,1754,FALSE,1995,241,
c6ab3422538ff4ac659165e37c921182,2022,TRUE,2281,259,
2aa9cc0ad765fffc94da7bf9b456c153,2772,FALSE,2999,227,Dire
1c78f8759bb6eaf13be03db9eec1e326,151,FALSE,1673,1522,Dire
e4cad9e60a227b9a3d1155bc5863f672,668,FALSE,1732,1064,Dire
d2ba418b92d0582ce43a429b6db835fa,82,TRUE,3158,3076,Radiant
1179873c3d0e3755332eaf69d2724b70,922,FALSE,1752,830,Dire
366ae01df5f33915c3ef049f6716df39,1215,FALSE,1462,247,
f826145d042cd41c994151bd8cc746a2,307,TRUE,1375,1068,
766a04dd5a2082125249bdbb870feb63,1014,FALSE,3240,2226,Radiant
b6f65179147ce860d47ef8cc56d94410,498,TRUE,1762,1264,Radiant
2619fcaf862f8a9fb81a0fea6f175fab,371,TRUE,3384,3013,Dire
d7eaaaa44debc437e604879e327dcaff,5,TRUE,4607,4602,Dire
9050b58dc2ea951923d336e3b4cca295,5,TRUE,2102,2097,
7b1d6e65570fe4fc850da2d8a084dc19,1382,FALSE,2270,888,Dire
21a504f87966e8a0e537dff4ad5c9bde,2771,FALSE,3022,251,Dire
a3af67109fc3924d5936855d96b59339,47,TRUE,1450,1403,Radiant
90bc9895a5a622a9bb32e484ec2e9e1e,2725,FALSE,2776,51,
f0fddc56556c9ccdba384596fd59e7b8,3153,TRUE,3206,53,
d518d27f06f720a0f0213078546439ec,1123,FALSE,2076,953,Radiant
aa45a8f8bb397159c4d7095cdb278f05,291,TRUE,3166,2875,Radiant
75fd97fb332c92dc872dc21ddc04d3ee,169,FALSE,2654,2485,Radiant
6fb68c6a8c3a4ff3845fdfcea7cb885e,1995,FALSE,2214,219,
db553eb7e080c2780d77120eac68e9f9,1481,TRUE,2702,1221,Radiant
43e37a9a91b656590d81702b044d45b5,1022,TRUE,2766,1744,Radiant
86bdd2755629283bf491b9bda1c09ced,2927,FALSE,3195,268,Radiant
ecaef7747d790c462c6d589fd41aa62a,926,TRUE,1565,639,Dire
39848cb4ca858a7ef6241a8bf84d2ff1,813,TRUE,2107,1294,Radiant
709f8c49cf80e8632202f1a550d1b3ba,1117,FALSE,3002,1885,Radiant
14e7ea0aad8b9fb0e7da67142b2fccca,2200,TRUE,2290,90,
28a0a03479e8a90629241723cff03bee,752,TRUE,1325,573,
4430a221a6d405d6e1a6ec8bd7b64cdf,1474,FALSE,2879,1405,Dire
461ad72d4b38d24f2136a0a58b28e1a5,1002,TRUE,2492,1490,
bcce53836f2b2582b4261777dfaaeaec,917,FALSE,2153,1236,Dire
759d07be2215bf236a3e763b9320ecf7,92,FALSE,2970,2878,Dire
90c553fb1a7f4d72caab331076259775,2107,TRUE,3252,1145,Radiant
38cd0c75e280abc0bac1e4425b6ccdf2,942,TRUE,2652,1710,Radiant
ec3aeefbd4dfa6cda24a70d58afa2ef0,2812,FALSE,2851,39,
d997b7b0d2ebfd59d4fca42e6a2a2e4a,308,FALSE,2585,2277,Dire
f93a20f05b9e1a03d8febd3b3ac9d8dd,796,TRUE,2043,1247,
aa5851a360e7139b13432e01b8e98c44,960,FALSE,1253,293,Dire
d8f749f62681c73e61d6832304a25b7f,770,FALSE,2717,1947,Radiant
9ae861d37cb6cc88c699e5e544605884,682,FALSE,1710,1028,
c79e6cae0020dfb1952a3f5c590d4ac8,1088,TRUE,3407,2319,Radiant
a5fbf2922b21ee487490a09ce37d66df,84,TRUE,3549,3465,Radiant
039ef31482ac9f1a044219e7a87d1b28,506,FALSE,1629,1123,
9c04f10767cbd8b0e609d5f2f430bfe1,819,TRUE,1549,730,
c6132e55eca437caf7ce2980c8b1ff7a,1825,FALSE,2755,930,Dire
e639a0b6d32cc2c2b681a680547e65b8,709,FALSE,1453,744,
60a5d27dc48baed151025265d9112eeb,1426,TRUE,1875,449,Radiant
d453f8edb029557d0561fffe19838a64,1145,TRUE,2414,1269,Radiant
ad567376f6cee6faacd1fff7351a8f43,1053,TRUE,1758,705,
1d22dd663d211eaa9b6c38abd59b3c31,121,FALSE,2067,1946,Dire
19341885acf66dfc1b0387f6ff5cc425,327,FALSE,1599,1272,
8d7c9cafe465a9741de8da4950513c41,1367,TRUE,3241,1874,Radiant
a8ba8f5594c15f5296a3161f95ed9d8e,667,TRUE,1334,667,
944cc658d5bf59770d0def83fac7c559,1877,TRUE,2951,1074,Radiant
62cdd6d2c44018905bf0f2b4d1d2ca86,1761,FALSE,2170,409,
155cf2ab983fb3b9e2a52aab3a55ace7,519,TRUE,2039,1520,
47b4349079822a10dd90582f58018e19,2574,FALSE,3110,536,
812150a6f76e09996dd970c876d8ea10,49,TRUE,1321,1272,
1199e6b820e5ec6b741195638d27594e,2263,TRUE,3103,840,Radiant
1dc37257074a55d72c47b3dd68cf87e4,2980,FALSE,3030,50,
3cc05e4e64b7040fffbc34777bb2c2c6,786,FALSE,2745,1959,Dire
043a2a522a1c2fac6183c9be5f7606cb,1627,FALSE,2431,804,
732298009591c38d2de7307872830765,768,FALSE,2232,1464,Dire
c3c50a5765e42cb0fea59bbeacc83bb9,345,FALSE,2476,2131,Radiant
306796c8f8209176734893ea7b81b3a8,1122,TRUE,2633,1511,Radiant
d5d5a30ebfc972a1403a8ad5596414f8,786,FALSE,1521,735,Radiant
e69ec37a7ff5405feafc2a16d55e1de9,1617,TRUE,2907,1290,Radiant
92d92152cf90ea14e6f7f1b6e5c8f5fe,1570,TRUE,1688,118,
42cc9a8ef5477417b12d15d2ea65b557,1789,TRUE,2162,373,
c717aead0490173acac64daf038544e4,630,FALSE,1671,1041,Dire
38729b23cdffa574bbbe69856ead14d9,1869,FALSE,3568,1699,Radiant
4e61b047a59849098b16d63ad35778a9,1415,TRUE,1648,233,Radiant
a4d54cd80e8cd9467c24e84f35b37dd3,1175,TRUE,2188,1013,Radiant
00a34aae164a6868f8116aa913223911,118,TRUE,1905,1787,
80b3dceb9e253399d60efb2be8bb4e7e,1878,FALSE,1995,117,
4075e734d2c2204d0e49d086592c3e3c,1942,TRUE,2286,344,
1a7a7c6e81349ec3b6a1926acf57f162,1274,FALSE,1881,607,
58fa59f5bfefe0e63175588ebb02fdad,442,FALSE,1595,1153,
ddd568a0d8a9c9074a82ac3893494edc,955,FALSE,1283,328,Dire
ef27da68b4641488ee7dc7ca6ce01f4c,521,TRUE,1259,738,
c0c8dacdadd3cf26c8b6852e334684fa,871,TRUE,2483,1612,Radiant
579ea3493062529dd4fd107c370c5e33,2283,TRUE,2914,631,Radiant
83757af7fb4540ff83050741b741c1d9,2969,TRUE,3381,412,Radiant
161c9e9742168ec87d907f58859afa59,1748,TRUE,2065,317,
970140da673e1bd72cff9f2cce45391f,926,FALSE,3226,2300,Dire
d14eae5c943e89a435ff2fb1863471df,1297,TRUE,2486,1189,Radiant
04c1cfedc88587b686391f7c221ccada,1060,FALSE,2112,1052,
ff33324023b030dcb653fa9f615216d4,1950,TRUE,3298,1348,Radiant
107f1ab9ec4729cf3bc1fa6840b702ea,1994,TRUE,2388,394,
fa5e0d3317e37598d2de8a40869765af,731,TRUE,2576,1845,Dire
7d94636a8a18a5ad26f2ba3be80eb514,899,FALSE,1761,862,
43cdd4744daa167cc1f193bbf540ec9b,321,FALSE,2051,1730,
d1f8b6c9107c90b528cce6f14eb56182,1681,FALSE,1967,286,
d2c9a4748fd509087ed489e272bce362,858,TRUE,1746,888,
3800a4873598d7be6ce123e4a43c9574,1496,TRUE,1660,164,
1a5a9f325a66c0bdcc49938c1e68df9b,750,FALSE,1659,909,Radiant
3feff694a99eff10e676ad84cf2a4388,1712,FALSE,1806,94,
1e9105c70bf0fee0b51d29e100d26caa,175,TRUE,2220,2045,
c13b9a35212cd94b7d5d3aaffdd380cd,1242,FALSE,1476,234,
b13041ed1bbbd1d11dee8cf1318eaf21,460,TRUE,2305,1845,Radiant
0c5073216f5b142f66ae264e9e1612e7,669,TRUE,1858,1189,Radiant
99848989b6ad9d6a4ce36e0791298cc6,2878,FALSE,2930,52,
b02262d9c13a6342126d5e4c6cb1ff1e,2085,FALSE,2600,515,
e39c1f40b652dace20046aa972c0c17e,1102,FALSE,1800,698,Dire
1f9cc511b176b0950c2bd351ef132f68,366,TRUE,1652,1286,Radiant
8f053ad2a86c73f2791531dc8c3c4338,634,FALSE,3035,2401,Radiant
7ca489d79ab2ad07706dbff1b07fcc9c,789,FALSE,2772,1983,Dire
b9d59c9593ca20f9a2e86455eeeb795f,383,FALSE,2381,1998,Dire
8f7799e13761a634286e7f283ce32c9f,2079,FALSE,2467,388,Dire
5e1885e83f1e25ce726083ead7d50c12,1291,FALSE,2746,1455,Dire
5f08567790715a87d2996f373e130e8b,877,FALSE,1747,870,Radiant
d516341cf1c2e399bc62a7cc6166ce89,1842,FALSE,2164,322,Radiant
39525057349fd49aadc8fc2a7eb113ac,711,FALSE,2068,1357,
773afcdf6485b203e739e4525e966190,3308,TRUE,3472,164,
cba1a9f0c4bbe14702cd921e485dd19b,88,FALSE,1194,1106,Dire
59b6e7f76ef4d3c5489e5206bc0160be,1218,TRUE,1384,166,
eb9bcd44ec8027dbb3ef2af8b660bc64,1364,FALSE,1981,617,Dire
7a0e0abc74a31c76c2cdaa75dfca941c,74,TRUE,2599,2525,Radiant
2c4d3d80b5feea558ecfa4d70a79557b,513,FALSE,2974,2461,Radiant
e78b3a2c252ed75721660d3667e9ca80,1750,TRUE,1891,141,
a8b11bf74ee8ffc7578dd4594d12bf1d,660,FALSE,2277,1617,Radiant
39568e81b2b7209b5a7a436859372181,3303,TRUE,3475,172,
9cdcaa62ef3fa6dbe4734f11db9222f5,2651,FALSE,2965,314,
bf06c5eb9f9d256f7a5a48a096069b6c,1212,FALSE,1340,128,
7bfc3a3d3735c6078e08f4d82ed120d0,236,FALSE,2200,1964,Dire
fe8465a639f6f9d2ae2674f9fe221a4b,2046,FALSE,2336,290,
cee1b21b997ed8c812d6a76ee54707ac,840,TRUE,2199,1359,
3f158812f34808cfd685eecf1f6dd864,2889,FALSE,3094,205,
8b73d4510e770662e446b9e5d3e85146,2176,FALSE,3040,864,Dire
10283f89fed32167389da164bfbe0cbe,1840,FALSE,3284,1444,Dire
69a707e54303432428741423ebaf2d41,2264,FALSE,2608,344,Dire
c7fce959a6ef6f58147c26b9f49d232e,931,TRUE,3838,2907,Radiant
fbcf8277587488157dd8ba1983869ea7,511,FALSE,2178,1667,
d7a8f78d6dcbed66409698d97dc2365f,2640,TRUE,2908,268,
14abfddd1cf8252b03e0a29dae871fb8,1708,FALSE,2034,326,
ecffd9e410023ba768afaf66671ec9a2,1063,FALSE,3061,1998,Dire
f9a01aa45bda3378576b50e85816b525,2033,FALSE,2899,866,
893f8ea825dfa191f43d7c708a0b45f6,900,FALSE,2510,1610,Dire
b00b328f67d1bcfdc029ac58fe9ded07,688,TRUE,1973,1285,Radiant
72a27b4608fa4a07a4995f561abf062c,851,TRUE,2996,2145,Radiant
fcbcc0fd731eb2e316fb1d554d189106,840,FALSE,1060,220,
59f8356ab59f2e19b2601f09b46cf8e0,449,TRUE,991,542,
c95c182deb16bc1af86ddd3c97aa8f39,1243,TRUE,1792,549,Radiant
eca57f449e375f56a72a23a6e403c2c2,2095,FALSE,2631,536,Dire
a111816a44dceb9a2eba5e4450485dcc,964,TRUE,2685,1721,Dire
ccbeae58693b8ec727e7ab4a6e7fdd85,1956,FALSE,2060,104,
c86ceda865dec3bdae2ed94bcc018b92,1323,TRUE,2811,1488,Radiant
4e7e01e767f28eea9b1d50f4327ef56f,2767,FALSE,2993,226,Dire
2a289cc923aae176030e34008f0e180b,2241,FALSE,2760,519,
79e9392bbc9c9189dcea02a30b54e5b6,45,TRUE,2064,2019,
0b1b41d155af28714987c3fa57d8ccfe,1011,TRUE,1681,670,
3544881922a9450a0a6998a32ab52a13,292,TRUE,2381,2089,Dire
e6b527a7d16c343b276c3786daac2eb6,2571,FALSE,2628,57,
fb55a4fcfeda40f392cdbd05da85d446,671,TRUE,2439,1768,Dire
57c95f9ccbf352291f5ebaff3f674bd1,518,FALSE,2042,1524,Dire
7790dbf8ae0a22ae2229cf451362b2c0,1219,FALSE,2404,1185,Dire
65ec42f946d5d766d0ec4bc5e4db9203,2288,FALSE,2490,202,
e0a927dfaeca9b2707a7306d9172e8cc,1901,TRUE,2636,735,
1536ea3b37e5fa04fbc81a9d7fb8337d,692,TRUE,2302,1610,
1bff0c1b0eb1f3dcdee7c7b8a9954751,714,TRUE,1611,897,Radiant
1b4bb1b84a93250e8dc8c65eb847aab9,1113,TRUE,1549,436,
1c2e23466f974651c297db6cc7289160,1585,TRUE,2328,743,Radiant
1fe6c269ae0051fc79880f86a1308827,1501,FALSE,2540,1039,Radiant
097486edb3c4f67e8386fbf8837130eb,1792,TRUE,2872,1080,Radiant
5a96fcb315397ef887a3290a92e63338,1113,TRUE,3178,2065,Radiant
ce2a7b13c3bef400c922a2c03487d688,950,TRUE,2318,1368,Radiant
7f4a9cb897e3db71aef4c0fcfc48400e,1389,TRUE,3198,1809,Radiant
992aff337c6b7fde0cfd637f6f9163fa,250,FALSE,1914,1664,Dire
df6c83db5d5646177ddfe963eb332953,760,TRUE,1279,519,
13b511fa5d2745b475f4e04ad28cb4e9,1541,TRUE,2467,926,
c60abc86fda43c24f6d5b8e14302c4d0,968,TRUE,1712,744,
fffcf580381d053be1a250c9d55c85f4,64,TRUE,2720,2656,Dire
6c960db41a0c5e1b655355a3d7ac55da,391,TRUE,2257,1866,Radiant
244df3dac14e021db6a9f71705a4904c,1586,FALSE,2662,1076,
f2624006c59e3ebc99f797c6e7d786da,135,TRUE,1684,1549,
0f83759cbaaf403ff136d242bd015c5a,139,TRUE,2854,2715,Radiant
76fa9e1903c1ef5d3c0835ed23e33d8a,883,FALSE,1809,926,Dire
389a9b49bce2727c7788762d290cbee3,234,FALSE,1538,1304,Dire
c5de01c94180dfd2fbff7aca894428e7,3508,FALSE,3579,71,
0e0adb81e0f1848ff1252996cd93ff95,1096,FALSE,1317,221,Dire
01333663dd327fbd7ea54243df9551ec,1673,TRUE,2741,1068,Dire
1c1ca0dc7a2f73e7867c17a133cc5616,1220,FALSE,2172,952,Dire
039a28035b59e3cc4626e9cdb08cef21,2680,TRUE,2794,114,
30865afca25999c946f9c81481709ede,830,TRUE,2669,1839,Radiant
76280463fc5ab9a15379481b60233ef7,1989,FALSE,2827,838,Dire
4913de22db6bdd45cd283e970900dc08,118,TRUE,2747,2629,Dire
56a9d999cbea1b2fa49227c4187bc3f0,404,FALSE,2660,2256,Dire
ff572b9bbb441195b530773c1d783d9c,235,TRUE,2003,1768,Dire
8832dbae23462a907183698732d5264f,668,TRUE,2728,2060,Radiant
613f2f98fa1485a109005c73ced98e95,532,FALSE,1228,696,
c1490dced9fe895db679c0ec8bbf5f02,968,TRUE,1522,554,Radiant
8b9c6bb4c6e23ab8dd9ed7f0a5350781,803,TRUE,1300,497,
90d00f5b20f0fa59c774e07a27bfa146,27,TRUE,2059,2032,Radiant
398bbbc9de2f3cd0ce20075679040a1a,2713,TRUE,3285,572,Radiant
fae16450683b6f0b2983463078365898,247,FALSE,3303,3056,Radiant
a74bbaa6e45620b833d643b121b60847,2295,TRUE,2371,76,
ba9355dfaddac57232a2704778711033,1606,TRUE,2841,1235,Radiant
994cfccd2e8d117d0881f81072e99278,245,TRUE,2217,1972,
d0f55e2c162689a6ed75bedd52cb3369,1163,FALSE,1649,486,Dire
e3679812c3aa764722ebd93dda640089,140,TRUE,1759,1619,
9ddafa45c612ff7e3215001deb1f40d6,452,TRUE,2496,2044,Radiant
2c597cc4f6c54f2ba8fb13b4464a8c24,962,TRUE,2021,1059,Radiant
9b3e3f62ca0101d20e5b27c69204e677,1422,FALSE,2567,1145,Dire
02f8fc0439e83cdc6d30094771f91ee6,1875,FALSE,2359,484,
c74dc1ea18d956f3bc18247b5c07e3fe,298,TRUE,1833,1535,Radiant
4a8a0e2ec9457b268093235bfb133d37,756,FALSE,1899,1143,
12295513c3033770ec214032b1e39a0f,2372,FALSE,2681,309,
aec1310e83c69c8f7852cdf00c50843a,1087,TRUE,2200,1113,Radiant
7e48774da0164abdeb016f1f56a894d6,1898,TRUE,3371,1473,Radiant
b86d408796d2029cb94cf08b57d5b5e8,1103,TRUE,2159,1056,Radiant
fdf8cccb1fe9cc4655441a7e845363c9,2362,TRUE,2401,39,
dfd5b6cf212ae3a507a79575e8cfe0e5,1731,TRUE,2292,561,Radiant
497073a2407b5d9e5b28be93ffc5420f,2734,TRUE,3166,432,Radiant
8dfca1543289d2df322962cd775db6ff,180,TRUE,3340,3160,Radiant
1c3aba0fb39314c5e0b586342ea086d1,1953,FALSE,2118,165,
0e6f85c302dabd4fb6fbd1874e89ce35,1312,FALSE,2306,994,Dire
b3fd49296ea5c486f207080798c2b5f5,295,TRUE,1555,1260,Dire
7e5790aebbf3dd1df875da61ab913ecf,2027,FALSE,2234,207,
a600da9447b61237d0c5e9f1f615958a,2569,FALSE,2761,192,
534166a56893de5a95f0e39ba9fb64c0,1864,TRUE,2407,543,Radiant
bb24fdfe7cf167512020cd13b0dea471,375,TRUE,1722,1347,
f0d6fbe24f1adb853c9375ade33b9fc5,1402,TRUE,1914,512,
65b2e4e36634232eaea2954d746eaa4d,358,FALSE,2779,2421,Radiant
099f709f61c06efb908941f7bb7ea35d,1356,TRUE,2443,1087,Radiant
6444530bb96256b440cbb34b7ca172c9,1495,TRUE,1551,56,
a16a86b2d6308a0fa9538b13d417138c,1883,TRUE,2496,613,Radiant
5a4a5ce15b3337d02b53ed68c1d521cf,322,FALSE,2520,2198,Dire
50b7c4a8b40402480af3ec3b7869c002,496,TRUE,2080,1584,Radiant
46061e2341890888fc68a5f74addce63,33,TRUE,1712,1679,
a41e245fd7e14c49af7488a0e31b6ea6,2416,TRUE,4421,2005,Radiant
e1b78f246e5671f545ddb047d4bce519,1129,TRUE,3111,1982,Radiant
a6212a0152fc2c73141992802d937587,322,FALSE,3160,2838,Dire
d154d26eda1874742474d2606a3ba7a7,915,TRUE,1619,704,Radiant
a331359e73cd7a547c6f99848770e153,113,TRUE,1294,1181,
2bda942e268e600bffa9089da3ce6dcf,1220,FALSE,2117,897,Dire
91579a9281a844d79598c2017b51d54e,948,FALSE,3521,2573,Radiant
9bc684e1239b568e5688b5334803d18a,2001,TRUE,2456,455,
ecc49089a2ac0126728d2454c54b61fd,728,TRUE,1433,705,
0de85ed041f3bd9be2fa94bb16669351,1553,FALSE,1847,294,
450beabbfbbd64a3b4ce3616f244ea3d,481,FALSE,1677,1196,
b7c3a2487b7dd00b6fa6474e57c813b2,1950,TRUE,2824,874,Dire
bef9b962d73f9e8ad4549b777144459c,904,TRUE,2145,1241,Radiant
8a7e673dcd11241d4db68f998eb5e30e,2474,FALSE,2599,125,
ec2782ede514600c9dc6a7a7587591ab,2120,FALSE,2396,276,
5827778ea24ab6c078b49d147b307d23,1021,TRUE,2211,1190,
f150d9147b82053eb1fd7bbf90d71ef1,149,TRUE,2330,2181,Radiant
1b6f6c1243c0e26e67454214da45427f,1605,TRUE,2162,557,Radiant
a97eb62c305acf515fe7ea2d5a8b9847,673,TRUE,2606,1933,Radiant
9609a3956bc6fefc0fa91486f61e728f,1361,FALSE,1678,317,
109e0f7926574d964f1a21dffb67c2c2,358,FALSE,1942,1584,Dire
8ba778721e10e94327e7dac9d604e971,763,TRUE,2060,1297,Dire
169501d1fd90289cfd6de54b950d3e66,1179,FALSE,1441,262,
1d05f6edad628c598c8e923f658faf54,1784,TRUE,1894,110,
a3f1d118f4cbf7c812a78cfb54337edd,809,FALSE,2542,1733,Dire
13281fa8f4012ed046d57ee93b099376,930,TRUE,1890,960,
6dd38d93efa0c40d65b1124d743ba8a4,634,TRUE,2205,1571,Radiant
9a6dec87402b9fa09e1bfad2814df89c,2245,FALSE,3487,1242,Radiant
ded057e03c081f059284493c2cf209f3,1301,TRUE,1724,423,Radiant
48b7fdc8c49f92af40192c74156959dc,1618,FALSE,1998,380,
8fb6ab0a063bab0bf2ab0aaa9132887a,1757,FALSE,2212,455,
2479dd526291af6d4bf605baa1dd7a03,965,TRUE,2524,1559,Radiant
ccc9d48ac6f453b642c89b93d5dba796,1674,FALSE,2266,592,Dire
76e17d27a73919d8684fd9e15ace63cd,2125,FALSE,2516,391,
aa622e189a4331171dba5d9b1dbccf4d,1611,TRUE,2706,1095,Radiant
bd324eee56feb1c0f1f3a605d389d7e2,1824,TRUE,2670,846,
1dfbc2d898652417e8f8363009abce5c,2317,FALSE,2484,167,Dire
94d040f0c450609b0316fb3378d103fe,1438,FALSE,2180,742,Dire
d038134ec18d8cf9e7336e1e9409965f,356,FALSE,1725,1369,Dire
9ed0a71d69139231ea92958c83b815fd,1126,TRUE,2365,1239,Radiant
519e889b62821f71fde74ab34ae793d7,1740,TRUE,1960,220,
527d6a9f12ae3cfd077f3df316feb628,425,FALSE,2123,1698,
e012257ee1a85045c5d6e496ea1d115f,1765,TRUE,3319,1554,Radiant
f07a9cbde44b8b954eb2bfc1b77444ad,2264,TRUE,2351,87,
435362220f5dc63c0487f7ba453a3258,1188,FALSE,1777,589,Dire
40a6cb9e17ff2be6348bc9ffecbf8245,936,TRUE,2413,1477,Radiant
35dc162a7597174d28ae18b4de7ce5eb,942,FALSE,2743,1801,Dire
40f3f2a401ad1dcdfeb7d53e4ce71ddc,1085,FALSE,1550,465,
54f658f94aa97f05f2988b6e6949f0fd,1686,FALSE,2206,520,
7ed25ffe50caba519fc3aea141aff7a9,731,TRUE,2170,1439,
f4895f327f45c6d8ea4cccbd46ae1ad7,1324,FALSE,1968,644,Dire
18d58d575ca4f741b0797d8139ed2211,472,FALSE,1565,1093,
0fb1a36eeec3c740da250b6c121a4e57,2009,FALSE,3359,1350,Radiant
d38fb24b22147f9acef50beccc8d383b,800,TRUE,1393,593,Radiant
1bfcde34d56a2eb49f6b7ab810bf27ac,949,TRUE,1603,654,
882c6f1444096f34c0ce37de91111b7a,1264,FALSE,2481,1217,Radiant
a7f2abc392c158f63cddee0d2805159a,1444,FALSE,2215,771,Dire
91ad89f14b31c31e28f5248294a6da6c,1443,TRUE,3035,1592,Dire
8082896352f6226e0632998008e42ade,367,TRUE,1622,1255,Radiant
fc1acad839e867d8c4a4010ca2d2d1fe,404,FALSE,1602,1198,
58631cfd9e34dab8a399093d3ad66139,456,TRUE,2230,1774,Radiant
ad9e40497655e3ddd67593a0413aa099,27,FALSE,2123,2096,Dire
0d24845388e311a4e90f355a79434336,463,FALSE,1952,1489,Dire
2069e1cdb9e1d93c4353c1c7652e30ca,1370,FALSE,1979,609,Dire
30746436be02ae036ecae59e2b9720b7,438,FALSE,1593,1155,
53043a9fe8264725cb0714d10ddf781f,2285,TRUE,2625,340,Radiant
12cd4daa156e95f3568ef22d1ae18588,1077,TRUE,2282,1205,Radiant
6efbcaf964593ced789cdc963d7deff4,999,TRUE,2218,1219,Radiant
9f354b7acfda0e41161c171c9ce7457c,373,TRUE,2173,1800,Radiant
317457335f9a8135f0d563b2f739f797,495,TRUE,4631,4136,Radiant
145dee1a1116edb75a45a64a1ee07b5a,756,TRUE,2236,1480,Radiant
6e925229aa286f52f77b595a86bcf0fa,845,TRUE,2513,1668,Radiant
21cf5a49202e65dad535e12a581c0f91,1311,TRUE,2016,705,
09960b416c99a622dbdcaaa5d1f1513b,795,TRUE,3021,2226,Dire
984839ce1d967af406387df65e3923bc,971,FALSE,2366,1395,Dire
8c9de826ce7d3db9c90e608b594333bf,1566,TRUE,2081,515,
61ef5ea09e5c587d026d3931f9bde5bf,1164,TRUE,2467,1303,Radiant
84503426b342d1f14c6f3b921a10478e,1679,TRUE,2242,563,
e878c68d7c23d7c203221c7ab2d3c239,572,TRUE,2073,1501,Radiant
d90e343003e722dd2345a2dfef29bd25,1809,FALSE,2681,872,Dire
427c1001d455bdf7a2021d4fa1bcaf1d,2326,FALSE,2520,194,
7e5fa8aec4b8813824f8c5922bee5165,1557,TRUE,3299,1742,Dire
2edb355bd4b7e3556ca8209159428300,1030,FALSE,1375,345,
342dd146587b027b80eb258ff5a14131,301,FALSE,2034,1733,Dire
100280412088a42d3813dc5494aaba18,594,TRUE,1840,1246,
005e2a9ce4bfc242dc8ce59bd3fea83b,576,TRUE,2217,1641,
e5b1bd18812b9fa862128505beabfd99,536,TRUE,1977,1441,Radiant
377de3f812fa184e41ed497bd5a058a3,1333,FALSE,1847,514,Dire
8b1b2990cdbbc4e400bab1e3f4dd4cf4,239,FALSE,2050,1811,Dire
a30e720803623a8bc1e8a4d30e4df669,1993,FALSE,3088,1095,Radiant
b68aa628870127aa6c6f3290829ff2b8,53,TRUE,1710,1657,Radiant
d01621e8a7ae97dfaa00b429d46d1fcc,1591,TRUE,2245,654,Radiant
3381fd3911ca39a01632a4f65e448b23,2473,FALSE,3413,940,Radiant
d320df4b5133846b943395f1e8bc6989,314,TRUE,1888,1574,Radiant
b48b5d97b266a61aadfdff5c047dc752,469,TRUE,2827,2358,Dire
e9d88a73b8c0d1d1423d295494cec405,1981,TRUE,2169,188,
504d9bac2eef3bbe2647677d9ea9f5b7,159,FALSE,1695,1536,
1ca418173e3cfcf4f3fb582a47d48d06,510,FALSE,1537,1027,Dire
56f9cfdeb94da4c41bf4155cfb3a5bad,1830,FALSE,2401,571,
5145f14842f4a31125d0ae5c4a876a15,1771,TRUE,2302,531,Radiant
c7f60d02f627d56139ff383b5de2a470,2762,TRUE,2860,98,Radiant
aeafb7ba7399ad8fb5e93f7ea201cb3c,26,FALSE,1132,1106,Dire
44a7b839c31ac609d02bd4414223e0ec,1412,FALSE,2000,588,Dire
4e61d4870987ef861b9338d7f1d900a9,222,FALSE,1344,1122,
9dadd0dc80870f788539c53df19edc2a,1482,FALSE,3186,1704,Dire
9d1245f677b7b88d7a0bee926270a5bf,793,FALSE,2493,1700,Dire
271de4706d4e17207b215e03f23aece8,415,TRUE,2669,2254,Radiant
a5b0ba38b1f5ee9b7efda14ae3890c5e,2140,FALSE,2777,637,Dire
d506d9f5ee4c05ed44289ea25a4c8317,695,TRUE,926,231,Radiant
f9c60e4d5bba9e556f2be8fb1884fc0b,2228,TRUE,2769,541,Dire
f87170ec876e12cadf92dc35ecf3a04e,854,TRUE,2063,1209,Radiant
81918d77b185e8e5b204c509824673bf,1618,FALSE,3835,2217,Radiant
73f0913c7a1f508406f911b871e129ef,1050,TRUE,1630,580,
c5bed7244264bc730e3d2b4af02ca53f,1732,FALSE,1821,89,Radiant
a79639709df1be80c7dd61aba4a58c56,1475,FALSE,1697,222,
d80b1b1a25bc83cf1e1b18d4b1002fce,181,TRUE,4318,4137,Dire
276f27cee3128a2b6e07c30a364894d8,2164,FALSE,3005,841,Radiant
7cf54920f43c1b5bca9dad38d3368bef,994,TRUE,2107,1113,
be993d35b01c4655116920ce6d02283c,1678,FALSE,1786,108,
a53b551cfb132ef042fcc6e6a87160ff,113,FALSE,1319,1206,
c438072bb7bcf2e31f717210edeccd57,437,FALSE,2523,2086,Dire
0217b7ba274c4ca6c436b2326022f669,562,TRUE,2820,2258,Radiant
893a7c6ae3c1190c44582e015782b870,1336,FALSE,3318,1982,Dire
e2a047ec08f9fdd4f77179adbef9fd14,1933,TRUE,2008,75,
4b927922393b9b958c195ec2a3d5f03d,1756,FALSE,3592,1836,Radiant
6c6037f2d53ddc5362c63ad48fc4f1a3,245,TRUE,2235,1990,Radiant
61d2bab1c7ef9db1a166fcf72cf88770,1912,FALSE,2671,759,Radiant
177e7f3b9518e92c026d666779051ff6,2387,FALSE,2996,609,
765bd33cb2ce6f13cab84f452fe4c7cd,1591,TRUE,3024,1433,Radiant
a6004dc2fd6908cfa1ef213002ff90cf,996,FALSE,1547,551,
ec7e6c9891df4bf41858477e43a7cb0a,518,TRUE,2289,1771,Radiant
84b078123066e37a9a68fa58ed9c78f5,1255,FALSE,2782,1527,Radiant
8690f94da2045b4f29ba2865aa2fb8a0,769,FALSE,2043,1274,Radiant
8730b14c54fca84b1b446862ac0e0226,830,FALSE,2901,2071,Dire
6881b8b140cfef554baac85f0229b228,53,FALSE,1493,1440,Dire
c32eacef4b78c754616cf887faeb2b9d,437,TRUE,1623,1186,Dire
a7cc5f4a3c5e486cf38a7bb1b0085cac,675,FALSE,2187,1512,Dire
024fd094da4022bc01fa62e17f22ff0c,933,TRUE,1991,1058,Radiant
e6a2ac59278bc630b1046c92355a1e4d,1596,TRUE,1948,352,
e6e0d4a87e18b3f76dc7b7cb345279eb,1528,TRUE,1950,422,
67d9e4f93cea2b2f051d612448ebef04,1874,FALSE,2961,1087,Dire
bb0e1a7ac8785228a6f7f18dc790d8e0,388,FALSE,2153,1765,
3359b57b944a645c54f8df4505c5f29f,1687,FALSE,2068,381,
b489e5af3e7d3ade4c1c9ce83f1d8758,945,FALSE,1731,786,Dire
22b78dd4a8fe303c38eb034d407e7b81,9,TRUE,2034,2025,Radiant
2c3d4d0bea256017df3ace5b9d48f9fa,248,TRUE,1901,1653,Radiant
f29b949f650d4b33adc7fcf8c98ba61f,421,FALSE,2301,1880,Dire
14e7d979e524c34e7b15b663bf445e56,31,TRUE,1192,1161,Radiant
6679a463ade9e83df77f40026811acf2,886,TRUE,2187,1301,
1e6c2e337e4142920c53619b2e433dc3,1520,FALSE,1849,329,
3332d5a86086e5b3eb4a46538f565d98,1276,TRUE,1641,365,
c6d6371b1eab4dd8c88959fdbe91b92c,275,FALSE,1598,1323,Dire
d471ac9547314f6a930929ddecdcdfba,1787,TRUE,2437,650,Radiant
6d19e709793b7a085f38d217d706342f,1615,FALSE,2592,977,Dire
4b35a04a2521388fc59a57f6df5ef7cb,1602,TRUE,3104,1502,Radiant
70cbd0888a543ddf4d91a325e15e99f2,509,TRUE,2074,1565,Radiant
2516c7dd399dc16c96119e7afd9946f0,948,TRUE,2680,1732,Radiant
d2cb7fba1cc32b909651b1005f7992e6,643,FALSE,1941,1298,Dire
2315adc4d9d7f77c6d365d217304809e,809,TRUE,2199,1390,
348589a280b81c8412bed2e4474a3cc8,386,TRUE,2212,1826,Radiant
cd9dddbe83066fd6f5670c36091d9c4f,396,FALSE,2040,1644,Dire
eb8c69a3a553bd2c6e4c3857655ffd57,40,TRUE,2864,2824,Radiant
18e90afde471644bb6e291789fc2d854,1359,TRUE,2699,1340,Radiant
6db28203f4f5e69ed754de03808d7c77,393,TRUE,1480,1087,
c3014ee8d7345fb4ab2ea7a42a755cff,358,TRUE,1283,925,Radiant
38103871672328dbbea574893ed5843e,3022,TRUE,4386,1364,Dire
f137a5fe5a5d2e69575370d4236dd052,918,FALSE,1879,961,
6fab72d9a7c4fd4b852802279c231126,1640,TRUE,2313,673,Radiant
2f7663c16bba59891d842a9cc6f0ce2f,1547,FALSE,2314,767,Dire
66b93e9d21b8fa0475ca57bf972ec7fb,1085,TRUE,1707,622,
06a646fd176cf9b5d30873198b388aa0,1955,FALSE,3417,1462,Radiant
cf145030e9e4e1c2b786aa9e3f849bf4,1154,FALSE,2173,1019,
23fa3830e1b0e0b496a0b3e3b079b77b,559,TRUE,1742,1183,
67e4f4f15879a93169f2f3b48f6d4a83,2090,TRUE,3347,1257,Dire
064959aa88f376b9ac9bfd88d9d43c98,1972,FALSE,2399,427,
5ea35fbecd5d869aa524900e3ce855f5,2081,TRUE,2116,35,
cba31ed4d1d302fe0b83cf51f1a90683,306,TRUE,1722,1416,Radiant
37bd5041455fccd42ca7bfdf86511bd7,1757,FALSE,2302,545,
0f9a9cb8b46a3f86edd0c5a1f9283716,1086,TRUE,1955,869,Radiant
ef9aa27580670e0ca1dea552ccfa6442,2038,FALSE,4200,2162,Radiant
5668e55eb8180271ede8b8748f391d4d,313,FALSE,2505,2192,Dire
0e48fb201575b0ab2a3db58de06c0c35,1482,FALSE,3264,1782,Dire
299b720dd3a55e9304a85cbf7beaa422,1895,TRUE,1932,37,
82d66c984f90382c05461d423ada3f9c,1999,FALSE,2040,41,
df5e99090475c1eea7073b463835c5e4,1519,FALSE,2918,1399,Dire
2a19bb5955ac06e60163e43d7fcb1d52,601,FALSE,2634,2033,Dire
3865accad09d941ba0860a6682756ae1,1461,FALSE,2166,705,Radiant
1dfbdb9430e4cbd26ba4231a7f57eca4,2125,TRUE,2382,257,Radiant
2a7cb5b9efa14cba95e20953fb259c87,106,FALSE,1792,1686,Dire
3d888051fec5065f8d81f7e7e99004d5,1231,TRUE,2494,1263,
346bad71fac3bcc3a2485ee668664e4d,564,FALSE,1977,1413,
b648dc5a07d6fc66f6ef25226ab83b96,225,TRUE,1683,1458,Radiant
befc59d090ea98d0b5ee9f4d7f979139,983,FALSE,1258,275,Dire
1417d6a6ce954190d5b5a5a7bc6c1d50,777,FALSE,2431,1654,Dire
2a736d7d9c74941d2817df0ba93b06ee,433,TRUE,2050,1617,Radiant
ee123def7326b40e0bf7c55d595f3d12,1575,TRUE,1914,339,Radiant
a4541ee66593abf3fde7ad988a63416a,2849,TRUE,3055,206,
15d625a61a790e517df6501c845df96f,2289,FALSE,2325,36,
80ae5d02bb85a713352cecd1e927770b,1464,FALSE,2770,1306,Dire
10230febfee80ebd94c72f454fe703e6,1360,FALSE,2867,1507,Dire
b166d5fb15e268654e9f6ed554f70499,1150,FALSE,2517,1367,Radiant
c3035a39bd6b221bb033af6c3952506d,269,TRUE,2381,2112,Radiant
87179a8d89fc0c20dd0d2d2b1d963ba0,1234,FALSE,1539,305,
176533d37eb902ac65ea1ac8dd272ed1,1079,TRUE,1750,671,
40e77d99ce06907c0530a3914a91b5fe,355,TRUE,1079,724,
524caca05de20c3ce96d31820d312d4c,1141,FALSE,1691,550,
4269c84d23ff497e995961e6a26bd6bc,907,FALSE,2186,1279,Dire
741b0754b64a6ca92cb7c3c2122c84f3,229,FALSE,2153,1924,Dire
8e8df819c1cf39ec2bd4e1b56b0c103b,1457,FALSE,2294,837,Dire
557bcca1ae8ed367da04d25b02c2f22e,601,FALSE,2302,1701,
dc9c9908e5fe59057d5e0810319c9221,1375,FALSE,2865,1490,Dire
17b15414c0f168e0a10e8291a2b920d7,1584,FALSE,2992,1408,Radiant
e77ed22b87bb339e139776c4cfe2543b,1227,FALSE,1930,703,Dire
e10f6c64c5e9b87844041303b06fa8f3,1165,TRUE,2204,1039,Dire
c91d7ee69bcbfdec8ae7bef747c454d3,1233,TRUE,1932,699,Radiant
672d888d68595bd923f97dd27a35ba15,620,TRUE,2430,1810,Radiant
ec04d971d8f2c2d295a91a64d17898dc,1708,TRUE,1934,226,
199a204c3ef910de93761227eabe5305,1137,FALSE,2393,1256,Dire
42645a8ccefdac9df61f2f59180a82c8,516,TRUE,1664,1148,Radiant
382b41c6d031bdd0fb912d33b9d68d49,1515,TRUE,2692,1177,
9a0ca3620e2e2b8bff0ed2309f9dc537,1394,FALSE,2809,1415,Dire
b5e09a4671490ef26dc2d91e1628187d,2285,FALSE,2555,270,
72c552df0375534e1487bdd11dfec632,2031,TRUE,3102,1071,Radiant
641e4b06741e67ccec31898c990d4397,343,TRUE,3169,2826,Dire
7cd56006a217d31442770053b7635b3d,1694,FALSE,1994,300,
9180af6263c30e7421a23710d13d4fec,710,TRUE,1193,483,
94c98e0798a1137f82ed0230fb05e2b7,1335,TRUE,1851,516,
a6d43dafe17510adc52d110551fb2297,2638,FALSE,3198,560,
0e815a974aed6240a5aa73a17dfc44c9,201,TRUE,2045,1844,Radiant
1fdd805cbd497accee75feb1fd2496e5,18,FALSE,2587,2569,Dire
e07a60d4e81233cd2249c2ca316caba3,177,TRUE,2045,1868,Radiant
084850c41358794327ead06f0961d454,221,TRUE,1524,1303,
76542f03ecf12195afa6deadc1b945a4,1745,FALSE,2122,377,
c17aaa833335c174fba0753006c49506,1397,TRUE,2226,829,
209a9c2507d6ad2de5a030a0274ad47f,382,FALSE,1744,1362,
b41b95a252b7867654f1a9cbc439389d,1372,TRUE,1855,483,
f925183dc439ddea1374b4fa4b859ac7,2303,TRUE,2578,275,
4f70ba5dfe1003b5c0a9d6c680c5c2ee,218,TRUE,1965,1747,Radiant
d0dae5dcc48b6976db8403f6f09f4a40,595,TRUE,1861,1266,
0eae399bbf629c1036003f59437f0c19,832,TRUE,1644,812,
05812f05410e88013bbe6e92b906228b,1504,FALSE,1641,137,
e927737e612569bad70b5b0480ff88ea,1123,TRUE,2222,1099,Radiant
348f3effc82c968031800e6918391f0d,963,FALSE,3095,2132,Radiant
764c71c62255ab5ed6576f178194d56f,170,TRUE,1641,1471,
b814ab2785de25bd2f80dfd712b6aeff,18,TRUE,3075,3057,Dire
0c126fae5b3e29ba1e0e8f1da6854828,881,TRUE,1984,1103,Radiant
7ae54db1fc477e9474ed1598689b8abc,646,TRUE,1699,1053,Radiant
730559c16fd42be639ea35af18d56be7,1034,FALSE,2523,1489,Dire
c9394585c3c784f87c87fb82947019af,1658,TRUE,2806,1148,Radiant
3f29c87e853ea1d9421aacdd82484779,1034,FALSE,2025,991,
5481c67b017fb2c2d2380053f948ed1d,1048,FALSE,2613,1565,Dire
ca527f28f4ecbd09fd065bfa5f8cf481,74,TRUE,1897,1823,Radiant
85878440c65f6f76aae78de2bbbb96ae,779,TRUE,3461,2682,Dire
0bdeda22952401b09e6cbcb302a30b0a,1052,FALSE,1626,574,
c8d2221c8de18d3b08c3d661896b3db6,243,FALSE,2402,2159,Dire
b4c81cd75cfbc01b9ade60d9a56bc8b0,1719,TRUE,3377,1658,Dire
1c1d5f3caf6cdc790f350f364d6e9857,1077,FALSE,2515,1438,
671d43387338ed406926b94cf3819184,2024,TRUE,3544,1520,Radiant
15bde07ca8b3932615e57fcf6251260c,1314,TRUE,1991,677,Radiant
a0f893df9914332c56eacc299c4994b4,2634,TRUE,3223,589,
808d647e9ee9ba1839cbe81e0b5d83c3,1215,TRUE,2447,1232,Dire
a311838023b86c77213cc4ea7c8780da,1744,TRUE,2400,656,Radiant
c3ac7f94bc2d963bb7f6ec5194339282,768,FALSE,2122,1354,Radiant
3083609bdb85c29d2a0f0b400d2a4e2c,2280,TRUE,3471,1191,Dire
8722b6aa999f0456c2b9a22dab76eb17,831,TRUE,2572,1741,Radiant
4c52a7b77834fa1ab546a020d18faf07,1420,TRUE,1679,259,
b90d656c92959c1d48cb112dc0f17a74,996,TRUE,1725,729,Radiant
c5780df65e9ad1c799ecf52b8b22d26a,771,FALSE,1552,781,
008a9cf772f25e9b073cd22b3296e41a,2061,FALSE,2114,53,
d67c1a9a2e608c285dab953a55a74ab9,1689,TRUE,3463,1774,Radiant
10b1a1b2f852bc5600f13028ab26f0a2,3075,TRUE,3860,785,Radiant
a8fb639a7649fd93fdb31f4f26e90025,266,FALSE,3225,2959,Radiant
f9a2e9a74b862f4ad37e1e4cfb481531,2209,TRUE,2715,506,Radiant
1f34ef4575cb4c2272d52274eec12dc9,462,TRUE,2538,2076,Radiant
7b104390bc7574cc539a7b6fd319121e,1520,FALSE,4945,3425,Radiant
aab8e75cf0037f82012115d42c747dfc,802,TRUE,2510,1708,Radiant
5a232dd259889085bbd836fc60bb18d3,2269,TRUE,3294,1025,Radiant
878a04eadf27e08de0361f2d178ee611,215,TRUE,1920,1705,Radiant
054e8aa99c601c77d646dd6aeba612b0,526,FALSE,1311,785,
bb77a37465c2f450eb147e687c72da41,3300,FALSE,4064,764,Radiant
744afd25ff947e9e9d228657cc2d7eaf,1147,TRUE,3973,2826,Radiant
5206c06e8b70adcb0c92355cb6fd4476,2071,TRUE,2849,778,Dire
824eb750bade8b8212c6f258633905a0,1368,FALSE,2986,1618,Radiant
ad0e4fea18cd9c9f8ee176a6a029f615,568,FALSE,2070,1502,Dire
7ddff7d7e3ecacc92f16b43fbe456af0,2420,TRUE,2545,125,
330879984d05bf14457721afd5cac2b8,286,TRUE,2163,1877,Radiant
40ebddd86fe888c0de7f32c1a4beaec6,1556,FALSE,1801,245,
a6eb0f89a94336f10f63c5d0b2090c15,194,FALSE,2548,2354,Dire
ce1420fbcfc3785ce487f729ef392766,176,FALSE,1973,1797,Dire
fe8ce31c78039b678796a893ce4e0231,568,TRUE,3722,3154,Dire
a593a0090b75a2df5625df336ed591f6,1948,FALSE,2604,656,
c5be4987fb145b7d50ac2f7abc4b09cb,2266,TRUE,2796,530,
7c8c537b789f58c1f0a5aa2634584308,291,FALSE,2225,1934,Radiant
628ad467acfb17d9a0a00ca66855f699,2739,FALSE,2958,219,
7708d606885112916b6d5fb3cf173112,1939,FALSE,2144,205,
6f3a1be75985bb0b3201aaec0e911807,1333,FALSE,1825,492,
2ef73632eeb79a8727d19ad398762019,1982,TRUE,2375,393,
2d47b79febc7222407507ebd348116a2,2222,FALSE,2668,446,Radiant
87406ce56182f64e663813f90fe2fbc8,2014,TRUE,2490,476,
ab258d89900d8c3ef521bd9bba10f33e,1909,TRUE,2255,346,Dire
0be18e39d24a7cad218642197463689a,266,TRUE,1801,1535,Radiant
d1666b53859c38febbbe05b1cbe86edc,1713,FALSE,2591,878,Dire
613c7eaceff6bb55ef65f294b5c458fd,2124,TRUE,2487,363,
89c332bdb38b8bbd97c82b0df25eb0b1,42,FALSE,2632,2590,Dire
b8aba4a835a3294755045c49cf6b30fa,1957,TRUE,2224,267,
6716c411310d52f3297eeb815afad539,298,TRUE,3387,3089,Radiant
241e243d1076da43e9220ec369eacd02,1122,TRUE,1919,797,Radiant
78417ac4a8e700971058f896e6f7644b,1016,TRUE,2366,1350,Dire
4111f412d8302336df816c31eec6658d,1170,TRUE,2310,1140,Radiant
7b3ec3ea91dd9b8961b00386ab190222,1623,TRUE,1776,153,
c6e5b22842e03d19394b809d179f051c,93,TRUE,1310,1217,Radiant
9c6fa1c26b9085b9a76145ba1be1e34f,1309,TRUE,3146,1837,Radiant
898264c11fb2fa44c3fba6b20d9b4214,2260,FALSE,2481,221,
fd702a619ba96d600987286941ce9788,1078,TRUE,2288,1210,Dire
5946dd0e729c7f38c60a14489d3291ff,1509,FALSE,3449,1940,Radiant
37669f15d7b11c4cf6b1757255ecd7f9,951,TRUE,2473,1522,Radiant
c00aa93b3bcb122fa4c8edfe6af76cd2,1351,TRUE,1604,253,
4640c5ca74a43f67be29510787332da0,1390,FALSE,1758,368,
8749cdf51a0c682e9c185cd0f51c09ae,1657,FALSE,2574,917,Radiant
48140f0fe153ecce505a00c1267b2ea7,618,FALSE,1453,835,
e82cf34fdb18fd58b278f3e8afa80539,632,FALSE,1032,400,Dire
0c8e5c6e9ea644f67338bbf14f478ef1,1107,FALSE,3288,2181,Dire
859b939ed53b801918a73f4ba056cf61,28,TRUE,1501,1473,
25e1033b5ee99b506bbb2e682bdf5ab2,680,FALSE,2575,1895,Dire
98bfed06ea5a9d3133b26665e6d4918a,1347,TRUE,1970,623,Radiant
f320b186e6ff19a2931a71e3d7007cba,1485,FALSE,2478,993,Dire
1f8e024fb80e5d8318a883250356f0f6,3332,TRUE,3864,532,
6d1f580ec5609c4b90d5ba568a94bc8a,425,TRUE,1772,1347,Radiant
135f93469bba6fc013670bcaa7805a3a,119,TRUE,1965,1846,Radiant
37a3a272d781259500ff3497ad6d7af4,69,FALSE,1464,1395,
91c1bdc008eef676ae252ccac8f9f175,444,FALSE,2713,2269,Radiant
5abbb0994801cc120ab58e36f50ac368,1770,TRUE,2252,482,
7c0d2ab47ff1b650b75b76acf5642bce,797,TRUE,3043,2246,Radiant
1aaab17bcb1f7471d78ab06f5d10f463,1821,FALSE,2897,1076,Dire
714de21fe449fb2c4c8dcd6275a14480,435,TRUE,2744,2309,Dire
b2c11dd06b873d94c68e4d2a89ddf25d,580,TRUE,1614,1034,
05e7db5cbf11bb641f7094fe0699b6bb,3001,FALSE,3974,973,Dire
819a29ffd45cce6e8d83becb48564721,413,FALSE,1881,1468,Dire
18401513969f6c9587b256e4aa787a0e,1015,FALSE,3598,2583,Dire
f218653d69df534949bf350a74a25d12,710,FALSE,1845,1135,
e68c302f1c8a63b7c7ae4354b82b346b,1815,FALSE,2062,247,
ab2e4a739662b9be9e686a54258cd1d0,1900,FALSE,1983,83,
1c7a7a214dc7f1b0cf6f0d959d2c7e81,1238,TRUE,1743,505,Radiant
a2fe7c0f27841c697aa16e9664e90b07,1413,FALSE,2282,869,Dire
1f7c456fc1ae7c18d2720e56f0c026ed,1673,FALSE,2326,653,Dire
802656432a5ac1b0f245206aac83a137,366,FALSE,1598,1232,
6fa0e86fd7424b52c8c0fa38794e4acd,732,TRUE,2151,1419,Radiant
e9648f01282f6c28db8b261a0e6b01e8,2259,TRUE,2776,517,Radiant
284263a91a8a6fc0c29c19d71d27f8d1,2367,FALSE,2935,568,Dire
4a944a9e677a8a741492d9d3a91b1f02,1828,FALSE,1934,106,
be4e16c5858b03bf6eb78ffdd9b70665,461,TRUE,3033,2572,Dire
a88c1ea116b1b851cc3a42d18d1f258d,1885,FALSE,2705,820,
48d2f84982c33dd74f87ae0138d9a4a7,1600,FALSE,3088,1488,Dire
5b3973d20fe26d0e4b2bd7e2d4d99f09,1865,TRUE,2185,320,Radiant
f9fd7dc8399c23e53b837b792a71e29e,2361,TRUE,3181,820,
bf2227393913dab6c2f2b9024c63279e,1243,TRUE,1790,547,Radiant
048c982622f2a05d195a19772ce4b473,1652,FALSE,1764,112,
3bfaa59486915f37cce70528d27e8735,777,FALSE,2989,2212,Radiant
0fa7fcc5e160fb232c57da3b465c1ae7,508,TRUE,2819,2311,Dire
7b8e095e41f840614d73035afb28e201,1785,TRUE,2346,561,Radiant
2fe4d6cfb34a8e110ae4c1f2a32ee8e9,1074,TRUE,1854,780,Radiant
c23c96c5e3c68f62d5c857a07ffb05f9,1457,FALSE,1666,209,Dire
2dfa31f0e2d8c687dcba580c7f6ee956,1377,TRUE,1714,337,Radiant
b3660f1db0c412591bbfbf3d60174728,783,FALSE,2190,1407,Dire
b0e161eeb42483fcba75a38f6e7c9652,1988,FALSE,2376,388,Dire
21f6d33c94c47a765d561e58248c6418,1221,TRUE,2630,1409,Radiant
90f5a025fff08a4a46eb00803a7eec81,3451,FALSE,5152,1701,Dire
d12b578f1f6d1812f711cc1a14a0ac26,2314,TRUE,3356,1042,Radiant
7f7e49bf768e06fcb22145aa0a4d0b40,598,FALSE,1417,819,Dire
bd9d4b5372b05de3e2ffbb6ea6fea636,1485,FALSE,2236,751,
1efff62530406a14985c5790da735f9a,1015,FALSE,3133,2118,Dire
64bfb17ddc3d35d80cb3c884227e0f18,284,FALSE,1394,1110,
b3202ce8e1ba75ebc2d5817b13ddbcee,381,FALSE,1757,1376,Dire
2f08c0caaf7341f64d8b90b05aecc79e,449,TRUE,2474,2025,Radiant
da87cd7f4420b7884b8129058f5d9c27,35,TRUE,1428,1393,
a52878e03b5353282474411710aa38cd,800,TRUE,2050,1250,Dire
75f2cfcf343238170389e1d74c6c0115,1290,TRUE,3194,1904,Dire
b30cc10edd65c771ad61795252051688,141,TRUE,1658,1517,
cf7dd42553bf071fcbe7265df46dcf33,722,FALSE,1997,1275,Dire
73a4267abacee5c5b9081f2306e2e756,1408,TRUE,1849,441,Radiant
83150cae0fdac6f97db41e2a4e680e15,1102,TRUE,3747,2645,Radiant
c99489d8680a748c762a4e26b2ec8c9d,612,TRUE,1911,1299,Radiant
bdbaea19702d3768eb1b00191bbda168,916,FALSE,1516,600,
503bead5d3eee8776c5026079f6b4263,21,FALSE,2274,2253,Dire
2864c95648db0ef7f520faea4147243a,1390,TRUE,2404,1014,Radiant
557143337f404ae33c8af71b65478b79,403,FALSE,1335,932,
316b5f860e377472ee3c2e02410eb878,1437,TRUE,1672,235,
f611aa9a188fa628dde40b1b09af559c,915,TRUE,2776,1861,Radiant
0edd90d28b0b6c9be8c7adc845df9805,1178,TRUE,2321,1143,Dire
e40f0355a935db522f780767b9c510d4,1844,TRUE,2945,1101,Radiant
1fcd949ca77e5f7778c360218438e46a,2492,TRUE,2769,277,Dire
77d77363c2ac5b8f3409d7e367c65616,399,FALSE,2022,1623,Dire
dfd46d8b4f330311fa853d2ef4e8c6cb,2238,TRUE,3192,954,Dire
c1a392a4dc16013d5cc55fbb5e3aad52,151,FALSE,1685,1534,Dire
47622a03a39467dea4d590ca6963c9c3,932,FALSE,2055,1123,Dire
14e1817fa7cc51654d796dbcdf4cdf22,709,FALSE,1366,657,
1d3b686259f1aa5ce9d19e10f2e94c22,2461,FALSE,2652,191,
b3ae7d65f48c5fb02c1b155a931e35af,858,TRUE,3386,2528,Dire
98f0173abb32d1b81082a9d2e29dd2b3,698,TRUE,2276,1578,Radiant
c0f139f10dfd08c576ed08c535cfb2e1,1263,FALSE,2909,1646,Radiant
b0195820448075faf90fbbf37af44a50,454,FALSE,2209,1755,Dire
0b65df58ffe2d5647cfc86f621d007bb,158,TRUE,1465,1307,
52ecbf30d26f4bbb1c0fa8cdb1b22dfb,1552,FALSE,2996,1444,Dire
0f353bea4a6d8567872ea420ba8bd0b5,512,FALSE,2322,1810,Radiant
03e667958f4367451b944dac79a38774,556,FALSE,2185,1629,Dire
1fbba77d6dd36f77d3d02e766244346e,158,TRUE,2955,2797,Radiant
78f0b371b1e132203df0202ef9e9c964,1218,TRUE,2150,932,Dire
477938aee74614ad9cd9d6ec150c4d53,912,FALSE,1881,969,
0e80760228dd093a1b93b5ef8e02fa3e,1374,TRUE,2578,1204,Radiant
8d2e7bb3eb965ea9ddbbc48255f03c89,689,TRUE,1587,898,Radiant
7d7e587e0f7b7d214b2c8dd4cd3e4041,986,FALSE,2046,1060,Dire
20106ddba1f6c544d59cc7fd7d2f602e,630,TRUE,2291,1661,Radiant
2e539ffbeba983ac1b1b0878fea5f5c2,2120,TRUE,2152,32,
d76a02ac50bc00665ac866a8852d4bd5,362,TRUE,960,598,Radiant
68f8ed2e586f8e013b13214c3c12ee64,2092,TRUE,2257,165,
2a898d4daa07a00e5c0eedfa7b826bfc,232,FALSE,919,687,Dire
7fbc1f00a2a582bd20d442969bdf29a1,1497,FALSE,2003,506,
3b69307bef1961d1abf859f6428c3f4a,2245,TRUE,2514,269,
8784f71156afd3d77a21553ae1c54fb6,85,FALSE,1977,1892,Dire
637e72336b21517d835bad5ab6af6fe3,1849,TRUE,2072,223,
8b4a0e7f1c50eac225026799d31c606b,509,FALSE,2274,1765,Dire
65cb669f279deb8e8d6f0f0253090c80,1709,FALSE,3195,1486,Radiant
d6a034a27f3ba65dd686c4a92ce90c93,822,FALSE,1515,693,
61f4aea222a018933b8e977f30882dbc,1051,TRUE,1967,916,Radiant
0ad4bec25b249bdbaa35d45dbc3ad21a,669,FALSE,1704,1035,
12759b826043f58a574743ae1e47125d,1269,TRUE,1906,637,Radiant
edd424e2cfd5415599da4d0938526a2d,133,FALSE,903,770,
1d7edb91a7fa867fb0c751929ddb324f,360,TRUE,1866,1506,Dire
d1c0ce10b68472809a52cd2ce3f8a0e9,2143,FALSE,2881,738,Radiant
746162223ce0f7ca011b8f314660096a,1131,FALSE,2115,984,
f71294df07620bf376ff669a2e297de1,716,FALSE,2230,1514,Dire
06da77f722017263341e56d09c9bac11,744,FALSE,2573,1829,Radiant
8770afe65b25b923ad217c74cad57ae2,1431,TRUE,2658,1227,Radiant
9e356d3e559950080246218f207b737e,1101,FALSE,2633,1532,Radiant
1a130bbded38515bb961fb0fb8b44711,2038,FALSE,3274,1236,Dire
dfc0bb8117c3b098b7bb91e0a0c3ed37,469,FALSE,1858,1389,Dire
778ccb26fd8fe9ee9b9070a512e3b28d,1788,TRUE,2779,991,Radiant
dcca52fd08d1ce69d853b597ffb780be,72,TRUE,2257,2185,
44fd3ca4ac64cef2e06e174ea779266d,724,TRUE,2992,2268,Dire
d7d01486d3582e507263ceddc1c851c3,1387,TRUE,1849,462,Radiant
584e86dad23aafc0eca1f132e6d087bb,1604,TRUE,2253,649,
e3ba668d9da8938aaccf41a894acafff,690,TRUE,3526,2836,Radiant
16049a6b4f1e428e68bc443af1b2e2d6,278,FALSE,2259,1981,Dire
a5afd4567db9b259ccc1ff070a1184a1,989,FALSE,1381,392,
2933e23fd08ed0a80d35f8cb8e6c1164,947,TRUE,1466,519,
3597a2797a4efbfc6905d73af875ab2d,1425,TRUE,1506,81,
3737eda52f224ca921dbe207bca37994,1200,FALSE,2399,1199,Dire
260d9cc0afebf3c6d37deec00218c028,1205,TRUE,1945,740,Radiant
18a48f45c8a960cf88ef352263795f82,1554,FALSE,2153,599,Dire
589fa8273c46b7a8e8ca44f7e7c3f2f8,2210,TRUE,2588,378,
c48c6bde980e2a0df47105b2335716e7,389,FALSE,2565,2176,
34f9758d91762f63201af26ee895ec45,1375,FALSE,2471,1096,Dire
3bbf718ceed9fe2ecb5075dd37471cd0,1089,TRUE,2043,954,
665aabc07cf715ebbd81673e0bba04e9,531,FALSE,2244,1713,Radiant
33f5d953130f74bb1703d6cb39484305,1467,FALSE,1607,140,
ad3e61bc34efd6a7d3bfb65f910af73d,2384,FALSE,2837,453,
8bf6cd21f116b81bb5fb2b76bfb3db75,750,TRUE,2790,2040,Radiant
b4aaf3c69de54a323cac8e1f66a41553,1164,FALSE,2804,1640,Radiant
034fff1be8b7c2d556a48816ef851d72,55,TRUE,1740,1685,Radiant
7d984950109ccfba2540b65c788b173a,1051,TRUE,2040,989,Radiant
8cf3ee81a5909a6a6a899272d29f4bd6,1288,FALSE,1547,259,
b63d0cc63235ce413a0c7a47b5792716,560,FALSE,2894,2334,Radiant
7b066b990d592d5fd8547e465f3e769a,2296,TRUE,2792,496,Dire
1a084789b54de13c029986e3d1916112,627,FALSE,3729,3102,Radiant
71784979ad71f3b9a5e8c0e3505ef2c8,1410,TRUE,1787,377,Radiant
4ae6748f09f20df20152ef682d3f6e8d,1983,FALSE,2697,714,Radiant
d3fa10a6fb1d7379a5a6d754c509fd7b,846,FALSE,2233,1387,Dire
9764030f350130bc817a8f125c942586,690,FALSE,1860,1170,Dire
5079bf42c8de9bcdbca665db5c63aa43,1354,TRUE,2589,1235,Dire
108d54b94d549fd6abb90a039f5b1cd2,455,FALSE,1986,1531,Dire
6435646e1e64b142a4b77166ca57e994,1616,TRUE,2238,622,Radiant
f06a5ce0b1ae1ddf4441d4d1c6a97def,95,FALSE,1884,1789,Dire
5903588906475865ede091ccb90afc8d,1401,FALSE,2741,1340,Dire
b4292595600fa9c4f9b2edd2a3f6ab36,682,FALSE,2810,2128,Radiant
442573aa64f272601f5d4e3d3359a0d3,252,TRUE,1971,1719,Radiant
d212a1e7e2cff80fb48fca80605cfdb8,300,TRUE,2028,1728,Radiant
5b994e869e9f300d01d7943a3e1373f7,888,TRUE,1902,1014,Radiant
080baacbfdce0ee229f5c5dac0f13691,2018,TRUE,3875,1857,Dire
5207e786aa0a0722a7d243c8a77f581a,1162,TRUE,1760,598,
861cc60a206fbb0ff4ef4a301e14ca66,2074,FALSE,2914,840,Dire
32cb14984ba7f1f43ee1c342f317119f,3601,FALSE,3714,113,
bc6d2bf3f711315d03ccf050c015b6b0,1890,FALSE,2258,368,
a35c3a60cbef5965741ed4fc68c1b232,1160,FALSE,1630,470,Dire
079a7081e49c9dc4de8afe1f9c8aa640,797,TRUE,2116,1319,Radiant
ef3b11778be98b783eb597e86c16fb02,2028,TRUE,3469,1441,Radiant
d50533fe382ef396f5375c937adbe743,984,FALSE,2811,1827,Radiant
f682881949439478930a654e7ce004c3,484,TRUE,2339,1855,Radiant
db06ee7e59f9ed221091cb11a069cf79,69,TRUE,3099,3030,Radiant
f3c59590f7a5c3987c369f9438023713,1834,FALSE,2007,173,
7b081ae464904aaabe41fbb9450deea9,844,TRUE,1651,807,Radiant
851e1f69eb7479e7c76d422301fb2118,2192,TRUE,2642,450,
ea0bac813c8df88eea8a02acccc68c01,970,FALSE,1703,733,Dire
17a8a11c9b4fcbcaf089a0230fb47144,1618,FALSE,1887,269,
c68c6775c24773c4ab81a34ff7d8df59,1439,TRUE,1904,465,
7b3bc049de1e695f5b58f51584cb38d6,3445,TRUE,3487,42,
bd7e0c54d9d9d998eb6a04863b91824e,1042,FALSE,2028,986,
049ff7c215af58c98834d74dbb5aa222,1966,TRUE,2195,229,Radiant
17404963d47d9697c604775ee673b7e5,693,TRUE,2655,1962,Radiant
fb2616e439eee95624ebb0996c0066d7,2278,FALSE,2832,554,Dire
55e6da243c28439b2c97bff1cf93b3b8,282,TRUE,2253,1971,Radiant
261f2e0fc70a8ec1fd2686f782e4b699,258,TRUE,3159,2901,Radiant
922d3e59bfc8d5ebaa6c735a5affd821,310,FALSE,2150,1840,Dire
7b845adfc2f4d9fa114512e13c6ad588,713,TRUE,1910,1197,Radiant
e207eeb79545c7fb0e632007a97fe12e,2584,TRUE,3172,588,Radiant
e174f1f0c53db8851aef683948c60ea0,2370,TRUE,2929,559,Dire
47ac515f60da5be370811eabb40d03b9,501,TRUE,1603,1102,Radiant
e722ed1f509c93316b418e9c369ef7c6,1666,TRUE,3774,2108,Radiant
c94bbd17dad00de6c50772c360e9d620,550,TRUE,2222,1672,Radiant
0f104d246e12bbddad946348b84749db,553,TRUE,1580,1027,
a62e7bd29854765b11e57c2905703093,1184,TRUE,2401,1217,Radiant
6832a664ed70e00af7b31a1856182c65,2339,TRUE,2697,358,Radiant
ebb97cf3f423422fb1eb46fb81c744aa,926,TRUE,2014,1088,Dire
21ea5fbc32b09482dbdab08e2bb88e2d,1079,FALSE,2300,1221,Dire
3d5a03ff821a1728bc366231fc9b3fea,129,TRUE,1311,1182,Radiant
73d64ded1cba5f748a6faadaa6bda78d,1468,FALSE,1860,392,
dde3080d5126850a21e8d9f3d8046831,999,TRUE,2099,1100,
84c12b38056360b0a14a5d6a7c795e1d,228,FALSE,1808,1580,
627c6e05e6a79f87a0200f41d3d45539,1604,TRUE,1962,358,Radiant
0a46e0b93f6fae788f5377bd9e1eae2f,1469,FALSE,1587,118,
6d80ccc8891a104297fa5469659a3380,1623,TRUE,2354,731,Radiant
ea5ba6f8a979565ea990d414508917bf,1043,TRUE,1908,865,
3fcdefe8036f6951c2a6bc7f39a36e4e,629,FALSE,2827,2198,Radiant
7a8d2ce9b9ccf87b47521c623fae4d0f,2178,FALSE,2518,340,Dire
abb70110822ba697241aed28b57c2a47,1255,FALSE,1552,297,Dire
8349fc9bc3dd579e56f999a36db980c8,155,TRUE,2472,2317,Radiant
efa4ddaba404eb377e2442b15af98f1c,1916,FALSE,2204,288,Dire
2997e16035a547a7f1d732a0975429e8,886,TRUE,2510,1624,Radiant
dfc6f4cf09265e12296c2c089ec942c2,578,TRUE,1534,956,Radiant
1b6383e3becb6542ecf320957c817f70,1729,TRUE,2648,919,Radiant
08255afb0bb2266aecf2eb10fee70a37,2137,FALSE,2465,328,
3ef83aa2b713d8f380112877bb352f19,590,FALSE,1284,694,Dire
fac8c0d92b6feed983ec4ee4dec79003,710,TRUE,2022,1312,
81c9fac84c97301978991dc5adc0f3d2,910,FALSE,2625,1715,Dire
1c266ec8b8b7f6dbc7e5cee26df5540a,1555,TRUE,1692,137,
f6d6ccbe736af9e59b84489c9b2eef16,474,FALSE,1620,1146,Dire
dc9cfb384b9719f31e3028282fb9a7d4,2076,FALSE,2266,190,
2704499d506984c02ae966eb1c229f58,504,TRUE,1025,521,
31f88c3e6d551b356e869b743fac125a,645,FALSE,3287,2642,Dire
5291c33d7a35f9ee3c59fc70039aa0ad,393,FALSE,1635,1242,Dire
78cbe2a1ccc3f0c10411b19e0a85bcd9,2404,TRUE,2600,196,Radiant
72b33943144699c67afdf24c278c8052,315,TRUE,1682,1367,
b7e5aba5bc524581993cf19d0526572e,113,FALSE,1164,1051,
de95f6f70ad339fe28cc79e1b4f6bffb,561,TRUE,2178,1617,
a5b6dd8f0e24ab9ff03ec80834d9b2ea,567,FALSE,1476,909,
ec273fda9eb6a01f9f85c627eb172595,1268,TRUE,2089,821,Radiant
a5ee7f8e535c58c4c10269097ade0097,701,FALSE,1142,441,
7308b439780313b4b6ee48b96843667e,1279,FALSE,2393,1114,
e8c49fe23b3200bf8ab045429b58d325,1785,FALSE,1839,54,
b3108ee3cb71c9b38da17a17c9c971ff,2299,FALSE,2744,445,
fc23fce4c1c7b8f6bbbe15cda5bfa9e7,256,FALSE,2797,2541,Radiant
93d4562b3121576db8c2018059bbfa46,777,FALSE,2408,1631,Dire
2bca3b3545644df2a368e20c681dedfa,1824,FALSE,2729,905,Dire
4db54fa5231f548fc994ec0c9529c655,6,FALSE,1483,1477,
e1cf74e88ab7eb873f9337c326422f33,2264,TRUE,2356,92,
d2e45e7516ff83da518a0d2bf69c4b52,952,FALSE,2663,1711,
843b2093e122e0eb1cf4c3497d8a6887,1660,TRUE,2798,1138,Radiant
52d7f571ef3e88f4d0bd6e2e98d26314,996,TRUE,2599,1603,
92ce3b0eb2af94369fa52328baec7f03,889,FALSE,1423,534,
2ffc8b4b022e6b230b11f5cc377b9297,696,FALSE,2086,1390,Dire
6897050fd0d1cd694d29fbee2d16af32,1489,TRUE,2487,998,Radiant
3ef169b6bd160f032ba178433bc2d2f7,1858,TRUE,2717,859,Radiant
dedd2749def6d1c58ab641993d8d2a4b,230,FALSE,1856,1626,Dire
277ad8dd99c78a213c43c1b2547021b0,157,FALSE,2244,2087,Dire
2ed1a65f2f3754c5a1aca4e8a7daf3af,355,FALSE,1123,768,
d4cea933526ee62dbea831da1f439ab1,735,TRUE,1736,1001,Radiant
151251413f5fb111b18202fc9f700bbe,21,FALSE,1551,1530,
2f94f9b1becdd6d4ab74a4d618a61320,862,TRUE,2544,1682,Radiant
84a4821b89dda380c8eca86f5183dd3d,601,TRUE,1156,555,Radiant
8b318034e25a04d303a9c3b004736055,1258,FALSE,2319,1061,Dire
31007f00e8d48186de53cade0ef8de25,2170,FALSE,2240,70,
a80d2c6a8143aa7e988abb5a98aebf8d,2095,TRUE,2199,104,
e2c3defb9aa030d9605ee242cc2ca4f6,61,TRUE,2015,1954,Radiant
4f669e2936949c9edee97c32ac29f3a2,775,FALSE,2011,1236,
cad0f7990df8ef05d39903d5c8bc75c1,1074,FALSE,2507,1433,Dire
590e274eb527b4ea5c459f59f9ec1aa4,1240,TRUE,2107,867,Dire
7c1e5866088194947c00a38aa58736ae,1913,TRUE,2313,400,Radiant
5ae33bfded751bd21c2f4586f2032507,250,TRUE,2295,2045,
af9691e65198d58f80efbfc6a371a639,1752,TRUE,1960,208,
f18dd0612618c9049269afe52908ec13,932,TRUE,1566,634,
8088aa5d659d038ba0a396966475e6de,764,TRUE,2525,1761,Dire
157d1ea1853553dc6ebc1a099a6bfcfa,522,FALSE,3486,2964,Dire
28bfe7553c3c1c0b83e886dc7ef56512,100,TRUE,1749,1649,
41b3f324f52de61eac8ff373468f4440,217,TRUE,2691,2474,
63db6b9375b2dbbbe0effaed76859684,1600,TRUE,2207,607,
558e83fce4cb14e1de5d04c4f4cee54d,1097,FALSE,1499,402,
fdc071ef38fb7d1ee5ee5af071c0ac84,43,FALSE,1973,1930,Dire
0de34f47539f6fd007d877283a4c679f,2243,FALSE,3319,1076,Radiant
47a00181f663fa85a2887f00ce88d13e,1661,TRUE,2711,1050,Radiant
fcba43264af7d76ec0b977df13a85fca,2360,FALSE,3438,1078,Dire
d96fcf2a0ac3526f176dd7bcdb21c9d6,2273,FALSE,2949,676,Dire
fd6be8212c79091a95e84339e89466c7,904,FALSE,1977,1073,Dire
259cbc4f4eea36e7b37ed879446d1cc2,189,TRUE,2262,2073,Radiant
38f718dbca57d12a0eee549b80bd4578,2672,FALSE,2757,85,
3e86a580bfca734f8c1be90e6bf34cc3,482,TRUE,2522,2040,Radiant
8320863ae10370c18e417ac6ed54b223,1534,FALSE,2230,696,Dire
53d543b893ddbe503ee98835640e15b6,535,TRUE,2370,1835,Radiant
36761cd95362f4f959b38e674bd51258,2432,FALSE,3450,1018,Radiant
ea6a2bc7399a0dbd214ff48b1d97634d,1190,FALSE,1498,308,Dire
1743d17fbdc5c28d30169a73e9781b76,903,FALSE,1607,704,
6dd675fc9c95c8cab7d7f89a6b684c8a,1035,TRUE,1832,797,Radiant
33cc6cef44723cab2f5a5819e20a18ae,4083,TRUE,4497,414,Radiant
8c4ed43f3c26fb3a0c6505a8c25dfb12,146,TRUE,1472,1326,Radiant
e6cbd4effeb0ec0a2afc7ada02c844b0,111,FALSE,2766,2655,Dire
0aa502b69aa2eac07148286d5a4edc9d,444,FALSE,2161,1717,Dire
6dab18d33c4e298c6234faba7305fe47,550,FALSE,2676,2126,Radiant
64e3fac17eaed7fe2f492d333af742b2,288,TRUE,1550,1262,Radiant
67153e1bc0092e5ff76c7fa8ef10b739,1422,TRUE,3055,1633,Dire
1eb3262461cf962383fa343ca7f3134d,696,TRUE,1302,606,
ab1d8f9d0b4e5f99f7fc340ff8b60716,1896,TRUE,2289,393,Radiant
5af11d41ad50ee6acc000bd3a35417f8,903,TRUE,1745,842,Radiant
3694bf6078280a8a0f7b335ac88fa05b,542,TRUE,1932,1390,
17514ba2fa60583c85218b6b36bad545,734,TRUE,1638,904,
f2857bdaa7e5abe557053c780e9dd94e,3369,TRUE,4512,1143,Radiant
7f14bab2d3bf67c000b348aabacf3394,111,FALSE,3451,3340,
d3c49b96e7d36b4afb6d850e52d14097,375,TRUE,2059,1684,Dire
647fed134288f713a69dd1c8dbec7b49,551,FALSE,2072,1521,Radiant
50b2c441be73ba6e86b596c739b82208,9,FALSE,2240,2231,Dire
b71af98287694bd4a9ff777ae4f308ed,830,FALSE,2845,2015,Dire
7fc10b09c86fe7818d21967c39e19257,6,TRUE,2450,2444,Dire
1435e9dca6d30f8437f0cc05e03d8883,2395,FALSE,2941,546,
c5c17039aae1661a6d564559f0692b50,1027,TRUE,1372,345,
1f6c2052717e15fc7986f3e16c7c7f25,1060,TRUE,3367,2307,Radiant
eacebc2fb6ea73d11fdfcf1ba3eb4019,1863,TRUE,2472,609,Radiant
56254e0593d53e0e439cea4b5f487a23,416,TRUE,2817,2401,Dire
a7bbb45c180384a464d104b33cae62af,72,TRUE,3363,3291,Radiant
0bb8d33beff03f07fc470e6a92a5899f,742,FALSE,3595,2853,Dire
24d08ccf9f06cce9f22151f4d3e856b4,2174,FALSE,2305,131,
0ed5df54a176d9f95f742259a7e80c9e,356,TRUE,1824,1468,
62809d548039144db4c3ad48bee11130,761,FALSE,2765,2004,
a8188e948ced7c8444ce07e8291030fc,1425,FALSE,1546,121,
c06139fdc1ba4c9eed70b8e9390e68d1,935,FALSE,1638,703,
b41d1101e3f0929b2993d55ff75d6d2e,3432,TRUE,4312,880,Radiant
ec844375bad7b1719169b62689e93076,1344,FALSE,2126,782,
8c677e56cd1e2f02a51f49caaa4c4687,2180,TRUE,2852,672,Dire
73158b12a150e3ef1f81152339ba2239,1880,FALSE,2162,282,Radiant
48e573509f543a7233fa4651bd8b1f7c,535,FALSE,1900,1365,
be733a02c869ee44e0f4062b61f6e260,728,FALSE,2331,1603,
d1a8c2f2748ebb24a07889045b9011ea,998,FALSE,2322,1324,
76086370cdd72b1b915cbd8730ed019d,2135,TRUE,2299,164,
5bc118a0d9f9b9287bbd5627e87a3998,623,FALSE,2057,1434,Dire
12443668a27b0d8db4951c74f4cbc2ca,450,TRUE,1646,1196,Radiant
199d65dad4b6758a338ffb4f1a7ba663,1167,FALSE,2027,860,
099332f4aac6153258396b7f20266b4f,1108,FALSE,2479,1371,Radiant
efb1be3684ea35d850aeb4661d056add,635,TRUE,1462,827,Radiant
9b6408904414b403652d0e00f32b9454,1584,FALSE,2533,949,Radiant
c715e7170110ac4e2e0ec306ed14f186,689,FALSE,2277,1588,Dire
90cca3395f7d206ae0ffcfac7229caf6,1515,TRUE,2155,640,
ca36a6c67fa9a51f6f29c23f5ed36c9a,332,FALSE,1550,1218,
f3cbbd090e8748131062313e31f6f5a9,772,FALSE,2185,1413,Radiant
256bc6c476a5f8d529748f975c47a5a7,1722,TRUE,2793,1071,Dire
08451875bd9d5b959f1cbb7f17094d99,2108,FALSE,2683,575,Dire
216042f392670d37a6632f659aefe326,122,FALSE,1944,1822,
8b0ac76466d632239e45fb1ab8a2cb80,2916,TRUE,4676,1760,Radiant
d45190e2bcbc0a262769fbb92f23bde2,3016,TRUE,3184,168,
7eba218a8a3f01de9d0a1f2beb0ccfc3,779,FALSE,2389,1610,
6d9c0b3d0f2e90689e3f422e37585843,1421,FALSE,1699,278,Radiant
c827845f69b074d1d3ceef5185e69657,1217,TRUE,1619,402,
4f128419d76fe91add77abeda83f451b,1991,TRUE,2104,113,
293a6ddd8e6a75c7ce13ddde8b8d2460,1626,FALSE,1947,321,
818c0aa087cf8486a2b1e3ffc22899c4,1560,TRUE,3054,1494,Radiant
ab049b9fa00452364457aff1bd0c8beb,971,FALSE,1799,828,Dire
676cda4f37c551c172aa4983ad6ac6f0,813,TRUE,3120,2307,Dire
746cb5a33b60c56aaa782f9dd382dcea,2405,FALSE,3098,693,
e5353763c6f36dacfd7c1bfd3ba3b588,907,FALSE,1622,715,Dire
101f769f11fd83ea64eaed3e1703545a,57,TRUE,2378,2321,Radiant
ad43361aeebf2501355618cd4355dff9,594,TRUE,1412,818,
2a2e4077b144b6e61f6fc87d12db29e9,1073,FALSE,2096,1023,Dire
463152b818d7ec3d57af8933cad156f5,1204,FALSE,2037,833,Radiant
534ad704f133fe53e60de68bf602d2b4,2419,FALSE,2489,70,
e44d71e80c97f2a615306dda0959e1e9,2730,FALSE,3213,483,Radiant
c876456b2c3ab1b0d759d7d188787c0a,2782,TRUE,2930,148,
dd9ef736c631a901ba36cca2d52e8bb6,1044,FALSE,1473,429,
2c36a2a3ae87e888257a265c34e6bde2,1677,TRUE,2999,1322,Dire
25b09df9ee8fbda5910e51ed2030edaa,2081,FALSE,2230,149,
76d1e071565131f703d377a6ed238390,562,TRUE,1803,1241,Radiant
dda5e332b7f5bd0c0f7443696ada5e3d,2427,TRUE,3302,875,Radiant
a2807e8dcc37bcfd186d0157e185e763,1473,FALSE,2086,613,Dire
bd7b7e3f39d6285e098fa79d915f36d6,582,TRUE,3653,3071,Radiant
119fa2d6bdcbe4867e634aa48a33917a,985,FALSE,2244,1259,
527ff6dc34009bdcc903aa89765ca2b0,955,FALSE,1970,1015,
1462cba3d00110300953ce7419900fbc,231,TRUE,1917,1686,Radiant
95fbb35ad4797f616060e148ee74e720,1383,TRUE,2084,701,Dire
7ee123472646b19217ca700ecac00245,2001,TRUE,2154,153,Radiant
ba5b297397b35ede3e72b3297373fbbf,2126,TRUE,2360,234,
48cd3bdd4f0c47e24322195222a78fa0,146,FALSE,1798,1652,Dire
25181d764d9a5d5c5a60afb9828bba9b,1297,TRUE,2635,1338,Radiant
aa526c17174dbe21f78b16e5560df4bb,483,FALSE,2689,2206,Dire
466575c8d9aa3711b06c5cab794ba3f0,1553,TRUE,2076,523,Radiant
532ae47a3c0180b4023fe82f8f4cda04,2547,FALSE,2578,31,
7dbed9e9a262dc4d3288063ff1504e45,1188,TRUE,3558,2370,Dire
c324f42d868b4b5569e11dc20f6f6b04,362,TRUE,1684,1322,Radiant
926886d98bbc2fe3d6e1f0e41a97a7fb,760,FALSE,2365,1605,
b07b4269b88661dc073cc876d3d1698a,1018,FALSE,2207,1189,Dire
6184554f9d8a338c19db83f3d0d66792,769,TRUE,1236,467,
c5223899ae0d00f9eaf522e26fdbb588,2037,TRUE,3222,1185,Radiant
7f78bd604d48d6896291bda42a060171,1271,FALSE,2735,1464,Dire
8efe78d280dd4321b067b1febcfbcc58,1470,TRUE,2004,534,
aa9f9e568bbca9e495eb659b8f8b52d0,2083,FALSE,2236,153,
ab513a5fb46f25cc592d108ba0c44410,1473,TRUE,1934,461,
f79441adc1817eb9fa7fcd6f0a192de8,725,TRUE,2046,1321,
6395e57fb064082ff8e1c05a34b55617,535,TRUE,2560,2025,Radiant
57ccbaecfbd19ddc9e33d272ef9433d6,1674,FALSE,2047,373,Dire
0b602e582b0f0dabb117b65f7d5638a3,1685,TRUE,1913,228,
4441fa4109c6da4b7e94bb96586e8b6c,1581,FALSE,2571,990,Dire
7a91435c40b8879e1e36888aae03b2bc,402,FALSE,2241,1839,Radiant
c21eff70f937f4b33f6fa76cf889277e,558,FALSE,2133,1575,Dire
65fd556b4c1a9594ea9b86b11bbe2ed1,642,FALSE,3245,2603,Radiant
7c54f531c6cb7d7f5628770a9ec329b8,1775,FALSE,2221,446,
c227cffd87d9c124bd82438502fb84b8,1754,FALSE,3221,1467,Dire
293315d8bd1b6420a25d685da98b6633,2369,TRUE,2944,575,
40c2ff0aa23b9fcb4223594ca292f6da,2335,TRUE,2517,182,
4d7a6225303aa6df82c4a756b6ad2491,942,TRUE,3116,2174,Radiant
e097b3789a4c9342004776f6de28ec67,419,FALSE,3154,2735,Dire
ffe27c59d126e86638083f0933bd6789,987,TRUE,1967,980,
e75491d4d65ae12d2723d4cd1053a4a1,725,TRUE,2568,1843,Dire
1435a343bacb2cd6e119c61374020a43,454,FALSE,2479,2025,Dire
2b40b3845be399d1689e797a6aba4f19,301,FALSE,2054,1753,Dire
b1e8525d0130d7324f1e717d809fa8dc,1606,TRUE,3101,1495,
ab00ab3c63e4e6a0b7801540b49b86b2,741,TRUE,2108,1367,Radiant
c03c211c303457283be257d2798909ef,531,TRUE,1587,1056,Radiant
0031c0ee827f23ca6c4cc5b66d0d3d79,160,TRUE,2163,2003,Radiant
73e1028d5cfec8d62ec003672da4e13b,260,TRUE,1573,1313,
12608842a492230f64206559c5b1d458,161,FALSE,2730,2569,Radiant
a33a59cfbced0ea894bb83b9dd827530,2166,TRUE,2454,288,Radiant
e084a3b0ba5d90910998e5a90e1879ea,1645,FALSE,2092,447,Dire
52e9fd88d1dc404c404928f92fa13138,3471,FALSE,3837,366,
a0bf7b044e608514dfd3de28b4dfa1b8,1931,TRUE,1986,55,
47717e9375a9a537e755560bfe46b375,1601,TRUE,2673,1072,
546d28dc9245ee377d95e4a62841ae58,1118,FALSE,2568,1450,
61746dfd2df0e299e13a4456416c2eac,678,FALSE,2084,1406,Dire
b2e0329e2601511796840b07e15b40a1,2527,TRUE,3282,755,Radiant
d582da198cc2578f35ba4f8a2cf55503,1321,FALSE,2431,1110,Dire
fc66933dcd8a2994974c0a20b2ff86ac,74,TRUE,3218,3144,Dire
d75975e0e8675cc8cfb17be3642be78d,2547,FALSE,2849,302,
a79df47bf1d1b33b694304a3118825fc,1834,FALSE,2980,1146,Radiant
08b8b0feb1a09374953eaae294a78222,493,TRUE,2005,1512,
4d69bea7ee0866f761eb66292efa3f9f,2913,TRUE,3137,224,
3ea6e3bae81d0b327685ad8817e5e0d8,693,TRUE,2412,1719,Dire
66250f6780297b7fc3b49810985216b9,169,FALSE,3909,3740,Radiant
b6ecf372168bc9fbeb3aae93414b8b8b,1888,TRUE,2528,640,Dire
74a1a2542b6f8d25bc1d43a89b999f94,727,TRUE,904,177,
59091e24f7edfe66a77c4caa850627d4,998,FALSE,1865,867,Dire
70a72b0d64f6b703548a6c85a8ea2cb2,159,TRUE,2167,2008,Radiant
19c46dae6384525fd7262433bea5ee36,1605,TRUE,2568,963,Dire
67bffc50529f137f20a72d7b9ed252c0,801,FALSE,1878,1077,
ec728a6c9152b4155d7c127994f0c061,306,FALSE,3102,2796,Dire
14c5cd2b3729d056dd473356687e6454,262,TRUE,1810,1548,Radiant
9ada03c4b99568edfd2fd450aff831c3,1631,FALSE,2634,1003,Dire
b83091d3265670c683ec49e3485bf332,170,FALSE,2199,2029,Dire
2b7fa96ab5fa9e49ddd478e2abd49bf3,650,FALSE,2389,1739,Dire
a116d67e1b4e43bd8765e0adcd59468d,1740,TRUE,2451,711,Dire
4bc7782e0d60ed1ed4693b1c2695e5d4,3729,TRUE,3813,84,
0d4ca6f7095afcb9b7b4d4e48608c93c,1732,FALSE,1963,231,Dire
6528493b5621def5fd11f5fecf1bcdfb,1267,FALSE,1725,458,Dire
e4c7af19ef925b3238ad8629a3447de9,221,FALSE,2325,2104,Radiant
c09152705e339d468fd29c1e0a3e8c73,2218,TRUE,2348,130,
45ab5e0898dd295f73ab12c6bf9785fd,41,FALSE,2074,2033,Dire
c9e07a1f5b5608661b3462c441597c0a,466,FALSE,3024,2558,Dire
4b818399c915487af8a5cca57ef923ad,1854,TRUE,2373,519,
92f0eee408e587f940943e09ef1c806c,590,TRUE,1599,1009,Radiant
e2930e6428d6eec4f65c9e1e8d262ff4,1065,FALSE,2003,938,Dire
6fd86fea6f82d03a74819a34defbeae2,845,TRUE,1943,1098,Radiant
e6a302d9f9922323b18ef24816ba0a95,2030,FALSE,3326,1296,Dire
354a8797f98fa17c17d6982afc99b875,1969,TRUE,2002,33,
1a6b3baf0f786afb445d54a9ed454eb7,2499,FALSE,2902,403,
f7c1acca818966b85d05839b74a590a4,2863,TRUE,3176,313,
cb6d16d3c5b16ac463d252b5f35a8918,1442,TRUE,1722,280,Radiant
3416c7916997e3863172df03837d44e9,1129,TRUE,2569,1440,
da16bc0e2bd8258faf0785dcc1fa34ba,1498,FALSE,1765,267,
ddf543570d28ffe6c0cf8e731a1f7fa1,1690,FALSE,2155,465,Dire
a06bdecf341b601e473b4615ab21bb0b,993,TRUE,1283,290,Radiant
a6b4e2ba803b6582881e5f191b1019cd,2084,TRUE,2648,564,Radiant
c24852ef37e10597bf430ba0c71625a1,1213,FALSE,2326,1113,Dire
f2cffc68a36c61d7c8a0df9805df70b9,403,FALSE,2260,1857,Dire
97b1fc3df2fc12bec55fca6985603446,360,TRUE,2368,2008,Radiant
ad5a1d199ddcb0d4df3f4d4c5201521e,1536,TRUE,2003,467,Radiant
cdbbf51b8fb6058fdf5c9a865c7599e5,2044,TRUE,2445,401,Radiant
2904145e86e73a3cfcbfd4216a74abf0,1223,FALSE,2491,1268,Dire
ef1770323ccac9b76ed4fe188d626afb,1048,TRUE,2062,1014,Radiant
976f40705ac8055f0e604863294daecf,978,FALSE,1392,414,Dire
c0f8eb64b1c9fbf84be349ee5f3e8152,1571,FALSE,2577,1006,
b130a0dc00a245456ee9629ffd1fe8ac,2555,FALSE,2808,253,
ae9f31eba57ff3f545f6382416a09d2a,1055,TRUE,3590,2535,Radiant
7a56690ed209f5ce2586078e626f6fa6,148,TRUE,1540,1392,Radiant
e7ad68131701095f9a631acf3eeba09a,1527,TRUE,1614,87,
696c45466c7c71ce004a3a29c5c8530f,1623,FALSE,3150,1527,Dire
861d92134824c93909f680f439530c16,1042,FALSE,3199,2157,Dire
069b993a9cdf95c784e61d4c391e00e3,17,TRUE,1085,1068,
e2e7f99a0b1244c01dde0c9a1a8c4cfb,532,TRUE,2199,1667,Radiant
d7d247029ee4102b99a187ebefbefe0a,1791,TRUE,1918,127,
9e7ccadc9bea25e342f500b877d27838,1458,TRUE,2132,674,Dire
c50e5b022948b92ec3093d33cccfb7c9,2975,TRUE,3057,82,
7e126c29c07ce36cf90bbafccd8130d6,732,FALSE,3059,2327,Dire
6dcffa73f4c5ec18c4a3d2043fedd9f8,2503,FALSE,3076,573,Dire
6e4b9be986a79d9f38d5579a481d18c1,933,TRUE,2045,1112,Radiant
5767a4fe2feadc09e56665cd7f40d295,1219,FALSE,2264,1045,Dire
43334a3f10959fa06fc8daa0c26a34b3,1397,FALSE,2007,610,Radiant
66e465c7a60425f855681c0104956079,537,TRUE,1705,1168,Radiant
43fbedb340e90f50a003b9aec63479a6,655,TRUE,1083,428,
89c2e0387467d8e9a3f950f2385e7dc4,1257,FALSE,2406,1149,Radiant
f4e8f2817db055b85c74b3daaef0559d,425,FALSE,2022,1597,Dire
69fcf87c53f9894f075c6a9508b9905c,459,FALSE,2380,1921,Dire
b318ebe3e8f51c9099cce703ba6ac8be,2111,FALSE,2205,94,
daecbff9354c363955bf172bbc350fe4,857,FALSE,3044,2187,Dire
d5ef2cf67b0431596f296507515f1ea3,1799,FALSE,2573,774,
e3b9445272c7b32751090c837599ca6d,1910,TRUE,2781,871,
2b4deabfd8f506009f7e95aada998695,394,FALSE,1944,1550,
185a71eb9eaea0ddd1e6a1123ce4df24,1319,FALSE,1531,212,
7a3b54184b951137e14fbc9c57c7df5d,1414,FALSE,1742,328,
09c1320720e8a654085cebed6c38b58f,2650,TRUE,3092,442,Radiant
adc617c9dab0fe2912e06c54d44c65b0,938,FALSE,1507,569,Dire
480fbfb6228c5b9e0c4560a59430b472,1216,TRUE,1463,247,Radiant
f134c1907eee6830c9aa7620bae1d00f,272,FALSE,2914,2642,Dire
43caf3867548fd3949ea052eca82dcf4,483,FALSE,1680,1197,
cf92ddd03cdfd7bf0d1d20838499579f,2483,FALSE,3643,1160,Radiant
0adb6c6f283d579920e9e63b4911d121,3300,TRUE,3352,52,
0ca6d6c4903960fc621235478b0de1bf,666,TRUE,1280,614,
fea611c4f05d4bbe51e3e3a6bc66c784,1296,TRUE,2997,1701,Dire
7ae2acf31ceaf063108b4415c1b96981,960,FALSE,3041,2081,Dire
1c634370685339a105b1884ef2a7c0ca,1485,FALSE,3115,1630,Dire
bfc2f19440eeef8b22015a636d15c81d,2164,FALSE,2274,110,
3889cd7de8706c64d7139bdd4aaa5c10,937,TRUE,1878,941,Radiant
9aa484aa676ded98d49d6031afffa89f,1618,TRUE,2403,785,Radiant
deb8157a95535b53334427a9d1d12530,58,TRUE,1869,1811,Radiant
c3cfab57a96c840ff88eaab7d2c4aaa6,1158,FALSE,2792,1634,Radiant
c56ca7f098092d8a9e602ef39081b36a,939,FALSE,2196,1257,Dire
f82e9e2638d7698d5d120ca78ec65103,107,FALSE,2252,2145,Dire
80786e9eeef422a956eee6c4daa8f135,847,TRUE,2540,1693,Radiant
1f8dc98577e3149911edb86d087393f7,515,TRUE,1477,962,
0abdc4a4415ab300bc472d30dfe36e46,2048,TRUE,2844,796,Radiant
9c07ff6d7088b3d21364df937cbcc68b,896,FALSE,3131,2235,Radiant
6189bea32bd45c11452234ee73abc8d1,161,TRUE,2398,2237,Dire
589473876cc22eb1ced1822b8d224b8a,2489,TRUE,2649,160,
49fb2ee734c6195e95fa6b701950ef7a,240,FALSE,2363,2123,Radiant
b95fae2e915651ca7a1ce7651848825e,1852,TRUE,2682,830,Dire
e57d411522b587129a97de2c2b46e5e1,1686,FALSE,2243,557,Radiant
ecf3584a8797edcdc42b0a042228e713,1958,FALSE,2786,828,Radiant
82f1a71259ae79eaa420f1a3aa5e1729,1736,TRUE,2043,307,
b33bf9dd241eaf91857abb540c4828e2,489,FALSE,3753,3264,Dire
bbf81e80e50c0145a5911cdc2f513a17,527,TRUE,1911,1384,Radiant
8a362931ec1610f63e88a2f0e2e5a976,1838,TRUE,2772,934,Radiant
59a7f4db363aede16abcd2aca61f2202,298,FALSE,2037,1739,Dire
ee744ad455316f2677024b700142a41a,370,FALSE,1850,1480,Dire
bac8da889920036964657f690e40ebda,48,TRUE,3979,3931,Radiant
3c0cf62e684bce5485ca15134f628fa4,274,TRUE,1513,1239,
0259c631c843900bafa71fed64045513,3114,TRUE,3626,512,
089a328bb1ad00c7b502548001d2a644,1415,FALSE,1933,518,Dire
34cb8832c0813667a8b7886edbae1f54,1889,TRUE,3156,1267,Radiant
6b14d4d3d6cea549fa3c4ce926ab84cb,1517,FALSE,2115,598,Dire
0ad7ebcd53b5650269e40f9f4b4714a6,620,FALSE,2523,1903,Radiant
11b80840cf515c7e2b8c343e635cc16b,478,FALSE,1024,546,
e58246e23f676c2de459262620e779a2,2413,FALSE,2960,547,Dire
6c82be674b206ed9567d6a3bd8db659b,1088,TRUE,1666,578,
a46994a55354ebbcd6d87a69567c9189,2307,TRUE,3429,1122,Dire
3d566d1c18f80afa418a96c961be36f1,2850,FALSE,4040,1190,Dire
ced246f904d05d10974996dd4ef89aef,727,TRUE,1971,1244,Radiant
2e0c1a618332d745cd88a0af95af4c24,1634,FALSE,1826,192,Dire
4488a37afcdb7d4315f7cd26c1179866,1694,FALSE,2615,921,
b9db151556f7b366a5649a04a801a4f3,2146,FALSE,2775,629,Dire
eafff0ff140314dbe2794b61e7c9d318,163,FALSE,1892,1729,Dire
2b1961ac8e48431e6387eb1f6050f37a,660,FALSE,2687,2027,Radiant
de2a5caa46a4c3839105d89458833625,2349,TRUE,2452,103,
5e13dc92033e4ed44d1acedc028f0616,240,TRUE,1865,1625,
4aec501f2a1e3ca06c5cd6d5616b0556,696,FALSE,1623,927,Dire
6fd7f4257513f82e918d63affe79f910,1347,TRUE,1899,552,Radiant
6ad345805059fad729b275826c7085e7,145,TRUE,2188,2043,Radiant
3b012c8c5b85f84f9646aa98a41ee937,2177,TRUE,2326,149,
7fc087897958b36a17af6a790704119b,373,FALSE,2972,2599,Dire
35de78ffa6c538c5cd1675457abd98a4,1657,TRUE,2040,383,Radiant
dbed598cc7c2753d2bd0741ec1839592,1781,TRUE,1922,141,
931da486a04ce74b8911f4faa590524a,1215,TRUE,2525,1310,Dire
6d944a71b40aca961ecf6dc9e59ca241,1791,FALSE,2265,474,
28d155c85802624ad64cbfb866e3262b,606,TRUE,2215,1609,Dire
4f3b2e6ac20a4d4b86c86d7a334987de,942,TRUE,1922,980,
bcf047b829e492cdad444203ec203d8d,3515,FALSE,4762,1247,Dire
6fb5f9582432c2852b7e1da5ad1fc34c,522,FALSE,2852,2330,Radiant
05306b29d81055bea0c72ad535964b94,98,FALSE,2535,2437,Dire
4e8a0ef9ec762991df44b802f5260ed2,1122,TRUE,2208,1086,Radiant
49724420bb716e75440198ae6ac73d5f,1342,TRUE,2140,798,
d534b3a38a5d7e6b88188c929a85c88b,1407,TRUE,2662,1255,Dire
050522fa2435fa11107c584526b6f901,1132,TRUE,1391,259,
a7de17c0edc9556b4f3a004f9647be0d,1408,FALSE,2124,716,Dire
a25ef4d4aedc878ff912059a89deac73,1242,TRUE,2307,1065,Radiant
fb6ed42157f33847cd5ddcd0a7991101,1979,FALSE,3017,1038,Dire
b877d7a345c707822043c4b33f71e98d,1414,TRUE,2097,683,
454192730a6a2629b0f6d989fd219461,2061,FALSE,3295,1234,Dire
36ffdffe7c166259f3c183bcb1080a2d,1043,FALSE,1890,847,
e6562149365912760307e8565fbf73d6,750,FALSE,2769,2019,Dire
485cf9d3c8ee558d278c47fae6c4c079,1207,TRUE,1992,785,Radiant
75c34f6cb92bceab9b60d177a14c9cd9,720,TRUE,2502,1782,Radiant
4c0465cb402ac82001f0e6d005e60fde,354,TRUE,1286,932,
8032395f2678f1865b89bb2d1544c378,2863,FALSE,2923,60,
ea40f3e88c6e4e96c36f6d9f4436c39c,128,TRUE,2411,2283,Radiant
6c4ff82667dd39610201ffd65d188293,23,TRUE,2964,2941,Radiant
02dc1b2b8680fcb90457ea07fa332fec,130,FALSE,1662,1532,Dire
bf792edeb588bb5a0f4705c0530f8e67,2188,FALSE,3611,1423,Radiant
88b74e741be9b4d88f201cf0d67d7a68,1020,FALSE,1733,713,
a8f79b974f7839c3f353caa2bbbcd70d,1019,TRUE,1218,199,Dire
51aca73a6d8852b55044e3aee4729385,2133,TRUE,2229,96,
807a9ed6cdce66686aaef3b261157570,2083,FALSE,2149,66,
cbc973cee5d1d6f8298c5b17946f503f,848,TRUE,1720,872,
09cd9538785ed2dc4df019576d5fdfae,231,FALSE,1966,1735,Dire
a19815015db883d4ae9e3e28ac98dc3f,874,FALSE,1962,1088,Radiant
434960de669bc4278789a163852e12a9,990,FALSE,2825,1835,Radiant
43bde9fbfc6df6a4f9f2b74554bc5341,2819,FALSE,3085,266,Dire
d0745170469a4199884131373b8baae4,2960,TRUE,3363,403,Radiant
63ee987f113f6017a3ac3ac4aab6ed86,2674,FALSE,2731,57,
a5cb761040ce5a817b1e8267727a4cb6,843,TRUE,2675,1832,Radiant
984f2244e71eeed584cb51068026fa69,601,TRUE,2656,2055,Radiant
21e5a08d59411169cc55c219c9fd1b82,500,TRUE,3779,3279,Dire
83ccc2a8b3e15f9f03c1f75bde38aeb4,742,TRUE,1742,1000,Radiant
e47006aa0dfff04b4da943fb93d1ab14,1929,TRUE,2350,421,Radiant
687dfbc7db9f23c84d78e53a553ea968,1672,TRUE,2514,842,
ca5afcd6247cde25bb96f56431abf4d1,1217,FALSE,2543,1326,Dire
12fd5880834927bd7f6ecbd848d75ad3,2803,TRUE,3372,569,
450acb82bad0e2a48b8afb2844bc1de9,157,TRUE,989,832,
90db2776139818e47b7b994123f1738a,1220,FALSE,3236,2016,Dire
43ff6b1c816d476751a7f65a9db2be76,1405,TRUE,2515,1110,Radiant
683b2863eac755943242ff934f5ee2a0,1064,TRUE,1115,51,
41ba62cf7390eebdd5a9f9f7ee270269,852,TRUE,2330,1478,Radiant
d5d64b6185af0394386b14c293e2fd12,1681,FALSE,2315,634,Radiant
fadfcff6cba65841aae65efd8ba96e7b,529,FALSE,2126,1597,
b32e0f0f510028379c967e08a6aa1475,2433,FALSE,2709,276,Dire
414c34d824e356228a01152271ee004e,763,FALSE,2956,2193,Radiant
b121d5a56c5abce4e91404c38eb608dc,1643,TRUE,2396,753,Radiant
44f5b1553739e39f94b00106a79dab1e,291,FALSE,994,703,
3bf0e97269e98e5e65eed304d0e3ec84,767,TRUE,2184,1417,Radiant
e358feabe300684efc63ab682aff5701,1565,TRUE,2655,1090,Dire
60d1214f12c3a7d98649ea2a9567e6d7,1492,TRUE,1548,56,
608a04552648399d66ad6cc1d6c6a045,370,TRUE,1688,1318,
4b46c3e93df68d8273761dd076c06a9a,905,TRUE,1824,919,
caf1f27f776bdbb6e3e60b69121d71b0,1531,FALSE,1583,52,
44f16d04ee19db4a9c84fd26dd20ea7c,383,FALSE,1521,1138,
878deae01535d2ab5da6dd50f6da36a5,771,TRUE,2544,1773,Radiant
c02f837055d32772b94615fcdaca30ac,1184,TRUE,2280,1096,
6ac693a2f087f79182cbfd7aa20983f2,1533,FALSE,2491,958,Dire
2235f03afdd8ebfe5cf965db3bc71d83,976,TRUE,1933,957,
38ceb184d648c904a4c4e3e6a0c2862e,1533,TRUE,2234,701,Dire
d4db704727acf32f8cc2520c5b358f9d,708,TRUE,1849,1141,
0af77aff3872f331d811be736798cceb,845,TRUE,1408,563,
3d72bc6cccae44b022fbd95a56ecff41,1105,TRUE,1745,640,Radiant
e9c5c1c7adcca308c84e8d6d36a9b46d,577,TRUE,1442,865,Dire
7e001d5b8094fceb6c581610c34d7d59,1081,TRUE,1176,95,
701770a1bfe3faf9a78084137e58e0f1,135,FALSE,1995,1860,Dire
cede2901e4f23301d6db431d3ff3f626,1318,FALSE,2038,720,
6d6e2efa75c348fd724f55e9f80d8204,582,FALSE,1319,737,Dire
4747993817692b32b0b75c48300c3e94,1917,TRUE,1975,58,
d656bb1169f7b822aa2ab3ae71a30574,2935,FALSE,3006,71,Dire
4e12da474ef37851a0f333d45f82a787,1061,FALSE,1959,898,Dire
bc5e5ea48b861bf0ae826265d8435d1a,1073,TRUE,3503,2430,Radiant
63f809cd9b35588b266eb00998326009,2191,FALSE,2636,445,Dire
978ba8071807ed03b8a9c71e09a7ce2c,1742,TRUE,3007,1265,Radiant
3a365a027c4c773c61fbe14d233b541a,935,TRUE,2490,1555,Radiant
804658ef4701ede8de6d95c4f3fd4370,1290,FALSE,1650,360,Dire
03f2f0403836fac07706d9965ecef12f,2421,TRUE,3452,1031,Radiant
5787eb676651259ae2695e80103785e5,2968,TRUE,3463,495,Radiant
43a4072dbdd17481969a236ab0785288,45,TRUE,2658,2613,Dire
60fd133a5ed37fc6540b08df41db501e,505,FALSE,1302,797,
c128dcc5d996822e16431a34e4317e82,1024,FALSE,1414,390,Dire
3388aad4b02e5ae18e4be1542de41512,1244,TRUE,2273,1029,
30c359d4d7a08abc9e9498192badfe91,1907,TRUE,3106,1199,Radiant
6d6d168b56109536465b962d75649a70,366,FALSE,2730,2364,Radiant
da59ae3fd1ae9f5ee1e81364215d193a,1585,FALSE,3134,1549,Radiant
f17be4cdddc5b25f54dc567a317c84c3,885,FALSE,2612,1727,Dire
55f73a9f9f939cf667abc1745ab55934,1116,TRUE,2835,1719,Radiant
7fc66f2b9c5f0727c5f63085b91915cf,2296,TRUE,2514,218,
284519adffb45a622ee7de9cf900bbc0,171,TRUE,2004,1833,Radiant
701f0ac123310a746093b02173e0edf9,2430,FALSE,2485,55,
45049be94772398daead315e8af9f27b,647,FALSE,3104,2457,Radiant
e45071c71f55266a35a9bfa6afc27551,177,FALSE,1638,1461,Dire
d11df3b59d08eac7fdb63d5fd5fe113a,1078,FALSE,1951,873,Dire
1661f1cb116acab568aaf7dc37eade38,840,FALSE,2482,1642,Dire
e43fb8cc48810931a0cff18132d4be87,156,TRUE,2690,2534,Radiant
71d561c302166138c915fec2bd707773,96,TRUE,3713,3617,Radiant
f6738ce1f5665b4676dfe66ce1ed2756,238,TRUE,2845,2607,Radiant
d1cd03544ab192edf2c0e8d1377681d0,909,FALSE,3221,2312,
b36d5439ae33244a35e9f4aa0e905e45,1940,TRUE,2194,254,
3601cff146e0073b2101bda0e89988b1,483,TRUE,1162,679,
d56666b50552f411a83b283cb1161537,430,FALSE,2430,2000,Dire
edc571458393f04b5c0ff60a7fb72652,781,TRUE,2809,2028,Radiant
876f176bc63fe9b5f410d46c66ede5da,1460,TRUE,2645,1185,Radiant
88e6705c7b3a08bfe958fb3b4086e10a,2270,FALSE,2809,539,
cec042ed17ca34c65ed7971ba385765b,1205,FALSE,1947,742,
3c12949f2978b3ac78dbfe45b3893db9,521,FALSE,1465,944,
f6b85aa58aa806bd53d9961e988e540c,643,TRUE,2842,2199,Dire
d16ed49ca1276da36d61afb8d475ace1,970,TRUE,1316,346,
727317edfa9f40c75b235656accda172,1698,TRUE,2317,619,Dire
59a532891410d42ac58efea8c0963590,2056,FALSE,2242,186,
914f8b93b660a81267850461e1b136e9,2488,TRUE,2521,33,
c3fc5c1b4e2e9784b4c1b47cbe4b71e7,2345,TRUE,3276,931,Radiant
238c64c42d7c0abe0c6b89e06da34158,989,FALSE,1348,359,
add5b1735d167285b113f554dbcaa493,1542,FALSE,2390,848,Dire
bc63363bc2364be2f1ae8e409f4139ee,723,FALSE,1378,655,Radiant
eed5db1a1c4a6c5fb60036d4dc3885bf,755,FALSE,2542,1787,Radiant
1ef101ca5c615b8c06c89209f93f223f,857,FALSE,2180,1323,
a6d2b9d2c68f634fa71ef7507fca0f5d,1360,FALSE,1852,492,Dire
4be6ccd903a0cda53fb25924c33fe9cd,468,TRUE,1633,1165,
40843cb3388547927c48c61ac252d3ad,1358,FALSE,2862,1504,Radiant
86c4ac999def177a4cefcea53fdc1ea0,2449,TRUE,4856,2407,Radiant
8e699c54afcb30224f07a81dccd7601b,464,FALSE,1641,1177,
a838fc1c27f7fe218f30e127cde0a9fb,876,TRUE,995,119,
369fb2eff62906c68c62403da0b13682,2299,FALSE,2449,150,
1d86652a77bd6db985dbaad8c5c67444,421,FALSE,1788,1367,Dire
9859270b0b137d9316d86a26eb233f31,1863,TRUE,2157,294,
6d6984d584c61e1e26c70afd4c3fb22f,1854,FALSE,2797,943,Dire
856ec4a424b1d905e30600a7389c69ab,20,FALSE,2013,1993,Radiant
5d19c75f1a6bf444db62dee23010f2c6,1515,FALSE,2191,676,
7652f0ecfcbc88b19d46d2dc218e1eaf,633,FALSE,1730,1097,
34129bfe74db9ae54cb92058ee5aedb9,745,FALSE,1910,1165,Dire
35fb32b9989b2385b81d3f5c09fa69bc,1510,FALSE,1794,284,
70426186a859a21f0fab46b99f467401,1147,TRUE,1214,67,
7488ff98cc5499cbbfd5182eab77eb1f,2574,FALSE,2962,388,Dire
82a2ae7d3338575e2b3ee9fd33565367,1762,TRUE,1890,128,
20a036cd0ec6a981293d38fb6063bdab,122,FALSE,1724,1602,Dire
52e2a7161662caba2701b6f9f51341fd,951,TRUE,1584,633,
6c5e4806d42f8bc87270207de76bac2e,1273,FALSE,2407,1134,Radiant
8531c1bf3eaa402b285f864e133ac4c8,587,TRUE,1174,587,
42024891790bf200fdb4503c26e83970,98,FALSE,2280,2182,Radiant
511c3ecf597af5fb70f1f9738d667b0b,1220,TRUE,1992,772,
5f2eee13d4b9e77ff3351318dd3a2fdf,1881,TRUE,2785,904,Radiant
d211c6e75a2cd2b6af2bd3591921d166,1467,TRUE,2314,847,Radiant
b4ee3e908b1499aff4bf9fbf356ad0d7,2952,TRUE,3411,459,Radiant
d49a7dd1f24ef0ed9f9db451f17d3d83,96,TRUE,1911,1815,Radiant
8449c41e1e1400df4eed747be389a62a,491,TRUE,2788,2297,Dire
9a8f8c091d4bd8bbf9a4dfe58aa5d0c7,346,TRUE,1199,853,
27246a1245c1df5449e07f0e30035445,1333,TRUE,3454,2121,Radiant
0c699cda34a1888b8c33824935e1730e,868,FALSE,3353,2485,Dire
896c2f7b10bdb3cff268099c3e00a60d,238,TRUE,1012,774,
bdd036151aa3c929d14f5cde3d01abd4,1369,TRUE,2973,1604,Radiant
cd83420bdd4a9a2534a76344a0d7f42a,1512,TRUE,1791,279,
6d07aea8c6369a316963e6fc6b59d710,452,TRUE,2320,1868,Dire
c898ac3537a754e2b9cba3fbb440083c,1741,TRUE,2309,568,Radiant
f36c3dcd110e600250b3a35d348e6993,559,TRUE,1906,1347,Radiant
a99140cf2536464561559f525779ece4,872,FALSE,2367,1495,
e95ec6526eb68cc9616e826866924374,2393,TRUE,2640,247,
0e7d4ef9be50a5d5d5f8dd0a3bf750db,820,TRUE,1572,752,
1a1bc384735ce1b6107f99078ee17af1,513,TRUE,2472,1959,Dire
f1f28ea98e142a6112d0507de9629de4,1910,FALSE,2637,727,Dire
e72b943fa2889e8e3e660d56a1b67199,275,TRUE,1270,995,Radiant
76714cd2540f64d5d31b39ab41296c51,799,FALSE,943,144,
a477ebd02e47335fec49f32a9bded2d8,76,FALSE,2180,2104,Dire
4a70da13a521bf425a9d2997e3781cab,1213,TRUE,1401,188,
37f935f9a00e5c02df9e0aa7332aff7e,770,FALSE,1346,576,
66a9a730a6c51628bdd69e1705feb186,1676,TRUE,2809,1133,Radiant
c952e3a419d3c438233becaa784f05c3,647,FALSE,2359,1712,Dire
12e9a504451fd0d421c5918d341b002c,877,FALSE,1311,434,
df5236cdc2d6c1cd6d72ffd13873655f,692,TRUE,3061,2369,Radiant
5fd35adb1dfcb2700f58d9f454b9da29,287,TRUE,2239,1952,Radiant
9e66d66af9ba6bf13ddab2d5357a4e0a,1058,TRUE,2134,1076,Radiant
9396cc5265db1592be616b8d1998cfbd,92,FALSE,2653,2561,Dire
9dc15d268776b16dcb750b8d772b0c52,721,TRUE,2636,1915,Radiant
e316096f7e2e148f5dd98398a9c26f1e,1167,TRUE,2507,1340,Radiant
af89c2613f482c4dcc74f9caaefd402d,1929,TRUE,2588,659,Radiant
0b426c030ac95d6ccdccf2b3e8e9d98d,2151,TRUE,2454,303,Radiant
207a5be9eb394176a5492c9f1d2fddeb,196,FALSE,2297,2101,
141dc7c7d8eef9b56fbfa671fc3458ad,968,FALSE,1305,337,Dire
6332a1c3d42ce8a7d2bcbbd727f33ea7,691,FALSE,1817,1126,
b96291815fb7b9ab5f96204a592bff2d,214,FALSE,2812,2598,Dire
1e37693d36f07502d4ee4639334c7be0,1732,FALSE,1883,151,
96e57777742c85d47672b0442cf7b1af,31,FALSE,1460,1429,Radiant
002686b2675f817fac1fea8dd016ebc0,1644,FALSE,2188,544,Dire
e7c8fc9cc39f8e45f75b52860079d153,1494,FALSE,2322,828,
fe222e7255871eaf2ac0ea796369d1a0,699,FALSE,2475,1776,Dire
08672512aca908029b4b3d4255f54890,318,FALSE,2991,2673,Dire
4e2247ccbfef305fe58b44b386bfd22f,1648,TRUE,3448,1800,Radiant
522e21d8258548e6955fc566c6b4db82,572,TRUE,1859,1287,
38aae6433936f71d65a70a9d2a1d61a1,932,FALSE,2820,1888,Dire
35356212450461cd91dfdc0d42fb277e,1334,TRUE,1685,351,
1092462703a28fa2404cb0882886290e,247,TRUE,1878,1631,
48e5d660e1b6100a70101a2811122ce4,376,FALSE,2291,1915,Dire
88b14b2eae12770254c9f6a6a95c9b67,481,FALSE,2650,2169,Dire
2ac941ed9e0a0eda391c9ebebacbd96f,691,TRUE,945,254,
53491de2127de557845beef2e26d0a19,1197,FALSE,2289,1092,Dire
e9ac5c91f0eb2c7a243d6278c7d0ed4a,458,TRUE,1634,1176,Radiant
4f0007e4fd536e43fce6c76036776ca6,1179,FALSE,1983,804,Radiant
55a8f2267e9ebf1778fe75b2a5030468,691,FALSE,1602,911,Dire
9f902438ed1aee965256fe261ab55f7a,1169,FALSE,1211,42,
d2e41055d7eb9ebce63719328ff7bc3b,1109,TRUE,4086,2977,Dire
8c5436cbc14401444e7a9496a3215fff,91,FALSE,1266,1175,Radiant
30cf286c13ed3163d38b40bba5da762b,316,TRUE,1473,1157,Radiant
46a272d9eb2d100724839fd83405f1e4,427,TRUE,1110,683,
b3ba4afe3601032cdae890912993fc52,551,FALSE,2700,2149,Dire
2cf2278b5a66bb9996f74179f363543a,1007,FALSE,1325,318,
bd738121f215325191ef0b27d094c7a0,1607,FALSE,2651,1044,Radiant
2950d10be1c12e65cb2d0ac95d40e0d6,351,TRUE,2580,2229,Dire
058d2de560f7864e870e3d9932bcad76,525,TRUE,2621,2096,Radiant
d84abbdc6ad151ad55e2222ff6014ca0,1293,FALSE,2099,806,
5e2e1e09429603accbc599cc85707fc5,1217,FALSE,1904,687,Dire
23b4bf034f7925690b250245c7efe19e,763,TRUE,1165,402,Radiant
f95f3d5c961565595f16b1ee5379a7c4,139,TRUE,1708,1569,Radiant
1ebbecf19587ccc08b812b7e15f76c2d,1163,TRUE,1872,709,Radiant
69e2d8b41abcfa938e72216f8b8212eb,269,TRUE,2033,1764,
e9467ba3ea7a0c7e53b8a85286a6c3ab,1896,FALSE,2435,539,
1699a2eb7c9745b379c87363cea100de,1662,FALSE,1860,198,Dire
4d84c063c4d8d8bf9af8702a470412fa,1013,FALSE,1933,920,
3cf8c1f0cabb4b55a22978468725e99b,1370,TRUE,1779,409,Radiant
328a577f7752231af7900983a97907f4,1925,FALSE,2891,966,Dire
b77c9c44ef46ee93fa43b489016d84bf,1854,TRUE,2057,203,Radiant
40aefd07e8ff6be13d8453ba82da7f9b,1948,TRUE,2534,586,
9bed9a2489c233c31c04a1bb7bac72b7,1869,FALSE,2053,184,
97e25046dfb2c9d24da4a0e8d47bfaad,461,TRUE,2376,1915,Radiant
dd79a2440bf527c4ba222b03329a8b08,1540,TRUE,3615,2075,Radiant
c2c36920c506cf448c35c452addafc69,757,FALSE,3556,2799,Radiant
f7ddb0895796e0202f3fedbaeb480480,802,FALSE,1509,707,Dire
b7a3d9b16a624897e53d8154e1058204,1167,TRUE,3330,2163,Radiant
9e5b71c7903650c286eacbf0f595c2ab,143,FALSE,2250,2107,Radiant
a9ca6226f3d750c056302d3c46e03f06,1450,TRUE,1504,54,
66dee79f8bec69c0a3bbc25830c8686e,591,TRUE,1613,1022,Radiant
a53377df7eded3a8e00b7ae0e12f36ad,1496,FALSE,3318,1822,Radiant
81f9940ca58eb679d5ffb76be71a3c4f,1705,FALSE,1761,56,
0c1d5f10a55ac235ea796d8359c8f03b,0,TRUE,1561,1561,
5192f022cffd54e909b7623be67d7b48,898,TRUE,2218,1320,Radiant
cd318531a9016b3da290b62255b8b19e,805,FALSE,2237,1432,Dire
6530d968ceafdffc9080a6be63cbb552,1077,TRUE,2475,1398,Radiant
2c8e744bfbcc2a7f6c1c6da37c86fe2f,316,FALSE,3185,2869,Radiant
3d7b12f9c25db5e2415861ff439c8804,2370,FALSE,2737,367,
4928d4d50f47ab2bbe37c44bc1776ab0,1391,TRUE,2284,893,Dire
4706f902ea00df5a2a66a20b11374079,755,FALSE,1937,1182,Dire
0033b23e6ff50ae2a5ed9cee18eab7d1,545,FALSE,1258,713,Dire
382b2dfd6f36d741ad6cb29c39f62efe,2133,TRUE,2466,333,
f4eb1ba37bcc7a7ba09ead01342617d6,3024,TRUE,3463,439,Radiant
04c9b8ab6ba774087642d7e06097d329,479,TRUE,2474,1995,
52d74e744a1bf28a6b438d3484016f2f,268,FALSE,2755,2487,Dire
c9b04cc4ccb9a16c863898f87949fac4,1396,FALSE,1450,54,
f84e36257ba9c4b0a8929f25807f613f,898,TRUE,2959,2061,
38bedde234074b2e6ad856af818ba4c6,1083,FALSE,2695,1612,Radiant
8d82122aeff4846fae08fcc5169380d1,1034,TRUE,2373,1339,Radiant
c4c4ab1f969ee8db9f91772156984c48,791,FALSE,2173,1382,Dire
bb30627cba8151a8db189351872af43a,342,FALSE,2078,1736,Dire
7509097762b88ab25ad58abed322144f,372,TRUE,2183,1811,Radiant
cb3817e13039a145db24a80c9b54915d,71,FALSE,3274,3203,Dire
2abe909518f720f3c8965712ea858e75,1701,FALSE,2056,355,
19d35774d9c66364dcc70064563c9cae,422,TRUE,2509,2087,Radiant
66d20fe7479332c5dab84a6f7be43a13,2020,FALSE,2120,100,
82a3ba18505ac973553e5625edd5f7c1,2993,TRUE,3143,150,
d80719bd7621b665a8259319dc6e63e8,1558,TRUE,1838,280,
334696d27dd0708fab11b0d65a431ea2,177,TRUE,1720,1543,
7cc5e4a8c8dec1b34c717abb790e6819,168,TRUE,2333,2165,Radiant
50e3362af06ca367c5f5505845663ebd,1375,FALSE,2179,804,Dire
07d6f691c7c855bcde51aea7fada9a41,2224,TRUE,2430,206,
b204b0552cbda0c14f7e2214ed9d517c,471,FALSE,1219,748,
620acf6177063678df518bffde138e2f,3082,TRUE,4302,1220,Radiant
07d327b34d9609b1d56f5f6d97c29bdd,2877,TRUE,3241,364,Radiant
bc1363bd7f29cc9d00e763582c717f33,1029,FALSE,2542,1513,Dire
3bca890694d076e672a7d968ae0a08bd,1432,FALSE,3454,2022,Radiant
dc9686ddb27ce1b5f33da6688a7f6245,311,TRUE,1891,1580,
be2a1bcb0ab2c76f33451da07ddfac74,231,TRUE,2827,2596,Dire
64000d7adf9afa7e00a2b58c4fdf0e9b,420,FALSE,1974,1554,
d685aa1c28c9f977d16d65397bbff8c9,1742,TRUE,1797,55,
e96c16572c42cb77360ec617d8e59271,3075,FALSE,3800,725,Dire
ce6e3bc5c96455c55a19d0bd5618e69e,1596,FALSE,2767,1171,Radiant
e821599fc3607284f4958c918eea13ae,24,FALSE,1333,1309,Radiant
6e7f0fd458f2e65847ecff5f9799b6c3,787,FALSE,3533,2746,Radiant
fde7f685944ad6f092d758ae8ee894dc,25,FALSE,2529,2504,Dire
6cbc72210d379b4c03a885dc994cbbd9,1963,FALSE,2024,61,
c6f943899401fb722b6889cbe10bcaea,60,TRUE,2815,2755,Radiant
3eb72803bf9b072f8b61760386951a22,2031,FALSE,2478,447,Dire
75df190c0089ddc6f28ffaf44e7ff8eb,2065,FALSE,2353,288,
991cd9b82541590cc808a79810c45992,1617,TRUE,1745,128,
f9dd81523821d3d9644be320ab3982d6,2737,TRUE,3082,345,
8e5d0ea9e5739865818e5476cc213220,1784,TRUE,1885,101,
bca80fb914cc82326b6c798156df6d73,509,FALSE,1094,585,
0dd3f40a0b616d7ce4caf2ec90d5e0f1,850,TRUE,2127,1277,
5f9612b8241e84fac132f6f839aad695,908,TRUE,2614,1706,Radiant
b65f32d086906b8cdd5727b14d238590,2840,TRUE,3176,336,
1d191a95e0377d820a5c25c9588b6c54,1529,TRUE,2465,936,Radiant
0777e0e22b908803e85b00807eaca165,939,TRUE,2526,1587,Radiant
3d3e48d6bc36834d8273f12675855bc6,2166,TRUE,2797,631,Dire
2011395b1a3b3cab6bd9953b06b7d883,683,TRUE,1930,1247,Radiant
fb9501f71601719bda55fc5e4c65cf76,1773,FALSE,1926,153,
fd7d123ee7670da796593af6cdbe2092,106,TRUE,1553,1447,Radiant
7db3cb6166cdc35b326ed7e210d48ac3,1438,FALSE,1484,46,
23ade61f698946c2fa8d88851640261b,919,TRUE,1986,1067,Radiant
a83ce23e9c850605153344d1025f0e7e,2380,FALSE,2557,177,Dire
1bc42deb8ab0f34ed319d0560cbc45d0,1578,FALSE,1955,377,
2d917fc01d66f07e4172486e6fab796a,1218,TRUE,1809,591,Radiant
f6ec7abaf8c69166bfcb1eb4a0794812,1678,TRUE,2573,895,Radiant
b93a8ef3e0f2d194e302df0c0a116d0b,1367,TRUE,3752,2385,Dire
f3e3f105e3d4379dec58cea2a77d09fc,1808,FALSE,2491,683,Dire
7779d70b77ffb346da4ed0e53f7e3521,846,FALSE,1953,1107,
7342e122aa5a33e504016989d17bd564,1854,TRUE,2075,221,Radiant
d2cd6bada16878bf9a3331682e099f03,2067,TRUE,2461,394,
b2bde4f01c0d0b378cfc42e050a2e5d2,1656,FALSE,3078,1422,Radiant
a88063eecede68938c1ae2752c6cc0ce,1468,TRUE,3020,1552,Radiant
b0838f3062f9cb1ec9e9bad11f46f0a4,2101,TRUE,3104,1003,Radiant
bd0cbbe44220321cbbc2db10e7496635,544,FALSE,2401,1857,Radiant
c8a7f078843811ce3505663797666b51,1371,FALSE,1577,206,Dire
2e2de89e23bbf0cd5b24cefe8d3a2a7c,446,TRUE,2816,2370,Radiant
edb2d9a23052987a10a2217c1d696849,877,FALSE,2466,1589,Dire
09fbe968400e912f74c437ab790d1b42,899,FALSE,2093,1194,Dire
73d3dda88e521b8c8564934d6a27fe27,1519,TRUE,2025,506,Dire
6100bb4fbceb3753139bc2490f82677d,174,TRUE,1396,1222,
7579c60b70b500a129c19a8984f9ca28,1772,TRUE,1893,121,
b6280f658de97419865de613e79f8b09,188,TRUE,3439,3251,Radiant
babc42a3b24309112f536b0e1321a8e6,877,TRUE,1569,692,Radiant
923f5ac3e8a39f406d07248923d3a9af,355,FALSE,2003,1648,Dire
283f125e3e03a52e5e5e3a7c0ac28576,749,FALSE,1652,903,
4a44e8a0ca7dc23b87307f22e055ee16,1286,TRUE,2459,1173,Radiant
5f66b830690f0a9688e28e6ad99c194c,191,TRUE,2522,2331,Dire
cca3b5d4d6cb3b884ccf734b25d46e3d,2204,FALSE,2783,579,Radiant
bd3fc0bb718f9aa23891052bad90e847,1030,TRUE,2144,1114,Radiant
db8398477f49d4acc4a674bbab2903da,1224,TRUE,2062,838,
c91544c7227aa730451dbfedc0c8b7b9,1663,TRUE,2214,551,Dire
ab8242aa4a86ef06b11951f2248eb8cd,456,TRUE,2298,1842,
8d445d6de4ec98f7d888ef76a3974173,1544,FALSE,3151,1607,Radiant
ab5b5de427dea844787807f9bcb93894,1195,FALSE,3679,2484,Radiant
4e5c0e98ecba3742861a926d68e1b14a,80,FALSE,2061,1981,Dire
2658cf6be17e44600a04c2150e112c1d,789,TRUE,1920,1131,
50db37a8f149387ce2196cd0ad33f460,1387,TRUE,2051,664,Radiant
58126c68a9e2c72741051b61a96e7c6b,128,TRUE,3491,3363,Dire
5e667c1bbee745ea5744975136128894,1279,FALSE,1761,482,Dire
ab7bd9db26d9c535d60ffb2699d503bd,1624,FALSE,2437,813,Dire
33820b931e21f3ca78bab8be79636e01,1035,TRUE,1343,308,
8e335b8da23ac44d8075b51cb7cc5139,1194,TRUE,1416,222,
0d51247bf85b7ed466156c85a23fb9c2,3101,FALSE,3553,452,
2f8d10ef9f8b92343b6e3c82dc1c8fed,1698,FALSE,2285,587,Dire
81d00910ab87c464ba5ba54b7009a835,969,TRUE,2784,1815,Radiant
02687e0fc1598a35d9ced9cd3ba21a21,814,FALSE,2933,2119,Dire
31c764461d887232b87b2609fe804df2,1526,TRUE,1968,442,Radiant
17ef76aaf968570ad7f0f807c867ddd6,2053,FALSE,2915,862,Dire
fa3b1964248060e0aaaaa5cce0dcd4cb,1964,FALSE,3071,1107,Dire
d5d3c5ca774d9d81033a66cf7f0fae59,589,FALSE,2353,1764,Dire
2abe9242de1d9f90279811b81b429e93,3225,FALSE,3995,770,Dire
75364f6f7f6efdb7a3a0e486c89255cb,1412,FALSE,1990,578,Dire
00aa313bd7eee816ad73364ce209ee81,1276,FALSE,2272,996,Dire
1883962f885c47e9788368c1cce61de4,1623,FALSE,1764,141,
c588cd61d51c89b96337b3c4105b5b04,988,FALSE,2414,1426,Dire
9b901988ea50714fda21a8e4d547b7a6,501,TRUE,2984,2483,Radiant
98a1bc8247aa30ae5f24d14634c31355,515,FALSE,2153,1638,Radiant
53789f92bfee3951d079dd74b63752e1,42,FALSE,1673,1631,
36655272c2ec8cd83b872fc8639616ba,1222,FALSE,2414,1192,Dire
cfc90657851adb9069d1eef0040d1447,640,TRUE,1940,1300,Dire
162d70ac3aed3e8e248e161a11369565,539,TRUE,2999,2460,Dire
682c4360542f95e1d832aa7a177931fe,1826,TRUE,2531,705,Radiant
34752558f98d1c319dbd542a227d9daa,583,FALSE,1362,779,Dire
43fcb6120134cf497a93f28c798ed5d6,3137,FALSE,3273,136,
7e43eacd00c60407cfc512845683fc40,92,TRUE,2155,2063,Radiant
3a6bb84221b136f92d4fe0debeaaf5f8,493,TRUE,2017,1524,Radiant
cd1873043e2c50f46e6d2ee094698ce6,550,TRUE,2817,2267,Dire
181645ee7c3a72f8b31e2787dae9e785,1219,TRUE,2045,826,Radiant
44d5ae27fd2c5bb6b5dc60a7b8c93183,682,TRUE,3620,2938,Dire
3ea0905767e741a768c2162619e87aa2,386,TRUE,3661,3275,
705dc80c8f17a7b4e33fddbebda3593a,806,FALSE,3463,2657,Radiant
77f92ab2f8d5aa6c1c0d271014bae063,2431,FALSE,2900,469,
ff5ecd47e2e749b6886743a9f8d0ff94,1823,FALSE,1985,162,Dire
08c9559f6310d6bd8d5782701c9f9cf4,1230,TRUE,2331,1101,Radiant
f53d3cb110b6f51661df1b899babd79a,1712,TRUE,3688,1976,Radiant
bea6e97d51263b7e2c8013278dca5db1,689,TRUE,1860,1171,
fe0d1795c2cd6ca5aae5d4689e828480,1414,FALSE,2372,958,Dire
0d17eaddb42f1f533376ea7eb2387008,117,TRUE,2295,2178,Radiant
aeec86e628f6a46c959314b7c7ab356f,108,TRUE,1809,1701,Radiant
2b40610368c4a0d2c0dc547d95391a59,416,TRUE,1195,779,Radiant
b8db8e9ae34912c2e07f1c68b93d38eb,1152,FALSE,1797,645,Radiant
9380b7b9b7a4839165e89ef02721da29,786,FALSE,2013,1227,
7e9c34342fda78f2c1202549b85a71e2,805,TRUE,1793,988,
36f2d05f1ad960f6b38bf19d21f15674,3451,FALSE,3646,195,
1995e3ec3b0d220197ce103f4a37bfbe,181,TRUE,1668,1487,Radiant
87cfe31d79b5ea9793d47a396f660097,973,TRUE,1468,495,
63efe43389426a9b8900fbe823552e89,614,TRUE,2181,1567,Radiant
151878fb35fcf5ab8a4fbb9876acdf5b,700,TRUE,1650,950,
7e740ea68647c7dad93b7143669036d5,3349,FALSE,3447,98,
7889571fe913a54a74c0172bcd9f6a05,853,FALSE,3388,2535,Radiant
61525569c77cda95927e3806b1c207e4,67,TRUE,3405,3338,Dire
ad12d9d627918a4fbfc95bd328b942fb,1268,FALSE,2990,1722,Radiant
32d40705b057739d1531ce6c6f3ad40f,1599,FALSE,1995,396,Dire
bd64ae17cf5d5402177f77b7ca8e8f42,733,FALSE,1694,961,
b636885088801956a1bf10b75b415f47,1051,FALSE,2200,1149,Dire
d330e1582dba660744740766c70f3bf9,1240,TRUE,2423,1183,
bc015d7f1efb3c0655ab9911bb3814a5,1081,FALSE,2456,1375,
f3cf57c4a537798098863944d635e6d4,658,FALSE,4187,3529,Dire
d9237286fd33bce5e15db7a9cedcb7b6,515,TRUE,1353,838,Radiant
9c919592cabc49701fbaf0f187148607,1291,FALSE,2224,933,Dire
59fce9949876be5c5ebf977fa34b0dd2,2286,FALSE,2628,342,
6eeee150ef79a257fee48b8081c2f8fd,1224,FALSE,1457,233,
5a005a9de2caae34a60e4bf1b46cbe05,1702,FALSE,2031,329,
922eec0e94b8cf84ce0d334ba2afbeed,1745,FALSE,1909,164,
c6419fde9b09eedb2784017375d23d64,2076,FALSE,2779,703,Radiant
87a0698cd172fffcf16ba83bdc65dce4,1592,FALSE,2126,534,
0d38ee05f91271f47bd0e780ed6d6c76,2058,TRUE,2546,488,Radiant
a071d3bb030a31ad901f0b6b022cc537,1021,TRUE,2530,1509,Radiant
f6625bc8b188dabf912d3d07e24455c9,1029,TRUE,2974,1945,Radiant
60420a092e382323bd04151daa76e968,759,TRUE,3154,2395,Dire
fd65115246508f9c8633413c8224793a,825,TRUE,3065,2240,Radiant
c8cee50ec6ea89deeea505fe59674772,77,TRUE,1422,1345,
858398617dca2e428cb667d55cd8b6f6,2658,TRUE,2878,220,
b1c46bbbc80060b6692160372c5e3c98,424,TRUE,2007,1583,Dire
89b6044dd33828cfdaefae6c92a6d8cc,827,FALSE,2000,1173,Dire
e9a747bb8526562f0a7944198d5449d8,1523,FALSE,1945,422,Dire
b369614ad91886b6e878750837dfd2af,716,FALSE,2307,1591,Dire
93518e742216814a95283c14160c43e8,397,TRUE,1507,1110,Radiant
26a99da4c4c9ceb8644cef964e22757a,1116,TRUE,2691,1575,Dire
5dc18d047430091c572d66f5a4fba017,108,TRUE,3599,3491,Radiant
bd7f88d73791b2811e69edc2eb5154bb,692,TRUE,1619,927,Radiant
0da4ff30a4457d429a74f158c664bfd1,823,FALSE,3354,2531,Dire
b085b042582a417d443c8e7016185b1f,2212,TRUE,3066,854,Dire
a54151dabc3ce8a17f752d7c8d800f7d,767,TRUE,2624,1857,
4b4eb67b18a7d198a1a724c61d1accd8,1258,FALSE,2119,861,Radiant
87d51e30fe5ba920d8b10a19b49402dc,28,TRUE,2547,2519,Dire
6f61ab914eeaf885654c3e77e392afed,2237,FALSE,2772,535,
0e0fe56c313f5217666de9158e97cc50,870,TRUE,2780,1910,Dire
051e6b69083cf47673cdae27b5aca614,1447,TRUE,2102,655,Dire
e54841238074465de3d267b86a03a9d4,411,FALSE,1927,1516,
2880e32a4cd0084efa8628c49f00749e,393,FALSE,2133,1740,Dire
5cba2cacf5302abbebfc695c6d8c224b,1980,FALSE,3088,1108,Dire
78b0f2887b65ab8e039f09796e1f7221,2368,TRUE,2804,436,
1bc5e918312f394d7c6a31b6fba66ca6,1045,TRUE,1360,315,
230ef1d1b05e637f580b1bc062cd03e9,1970,FALSE,2642,672,Dire
587f2bc002136652e94c9d9f7331551a,529,TRUE,2187,1658,Radiant
ca2cffa2cfee670a6f16a5542673264b,1052,FALSE,1687,635,
2c0e2edc60ab54ebb7f4dc0c0e3e4afe,1567,TRUE,2161,594,Radiant
8aea15ad2b27faec5e9342fd3d1ef86a,334,FALSE,2025,1691,Dire
5b34906fc98ec1b9f574e13a9ad625ab,955,TRUE,1716,761,
217305e6abc4abfaed07a71134a4beb8,426,FALSE,1267,841,Dire
49c1a7879344adc5acb9ed21661878fc,2332,TRUE,2445,113,
9cc5f43fa5bb1c4a235cac8c882be861,1727,TRUE,2596,869,Dire
0543b075cd727f9e8b8a48f29480c6c6,652,TRUE,1885,1233,
f83faf0a26f968ddaadd82d280ea8f78,499,FALSE,2719,2220,
93bf5b81057d16ada788bdfa2a35916c,1819,FALSE,2834,1015,Dire
0f51e541ce413ba8ffd49a63bc12643b,41,TRUE,2525,2484,
06d1c713bc70c0a7b43292d98a524e5d,1574,FALSE,2326,752,Dire
bc11c1e61dc80517594685332fb6b01d,930,TRUE,2793,1863,Radiant
95d39ec6ae1215bf297a05e09a9534c5,2090,TRUE,2967,877,Radiant
1cda4206beee897add22652c7d29b5d6,1449,FALSE,2101,652,Dire
db938d0d2184c2c2b4919105f99dcf70,3117,TRUE,3490,373,
06be291657c94acb3a3a05b74d8360fe,2159,TRUE,2874,715,Radiant
cd42202dcb58ff33b103be75823039e6,843,FALSE,1317,474,
2ec8dd94c27d0a3310b3def096aaeafd,986,TRUE,1802,816,Radiant
10cf59bfcff17523dffebc2ad9e24390,462,FALSE,3866,3404,Dire
7aec275cdafea0a6f2de0c156f0fb855,897,FALSE,1395,498,
ff5375759155101439d55ef826ffde07,1867,TRUE,2264,397,Radiant
d5ae1e640f95d04d83381abadc04d304,812,TRUE,2069,1257,Dire
819c706bae82878588aa2f4aeff3c127,348,TRUE,2620,2272,Radiant
1d5c8a551bc6c23d737a91dacf9cf2a3,2600,FALSE,2809,209,
a7f89ffda7ec2764d85e5d6d21c5e9a5,258,FALSE,3658,3400,Radiant
890f95cffb74f8f95d4409c9afc3033f,334,TRUE,1870,1536,
25099628dd1f0bb644395864d15b70e1,479,TRUE,1363,884,
20b24f19de34442a6e166a699e98a61f,359,FALSE,2472,2113,
d72a92ab2287011139061e8399843678,1867,TRUE,2302,435,Radiant
bef1b81101ad520525dacbf0a58b0c67,2920,TRUE,3163,243,Radiant
ccd999f848acfe426301f02bf456c103,127,TRUE,3529,3402,Radiant
efe8b7dbd0494887893267be5b9adbae,1463,TRUE,2196,733,Radiant
928b631b7370d8e966cf3679a05fb762,240,FALSE,1750,1510,
c3eb91327835eff2023a688906ef7809,3400,FALSE,3838,438,
3c73993066eb437379e4c4497a86d8cb,2128,FALSE,3091,963,Dire
21c7fdfd0b71743d8ab554608ed862e2,2360,TRUE,2612,252,Radiant
d1e4eca30049b1277c7e273575d3dd3f,1341,FALSE,2334,993,Dire
054c320b5a82a0648e24b6dc3fec4240,96,TRUE,1974,1878,Radiant
8c8ae1ce7eb382c1a69a6bcc9014c290,1376,TRUE,1875,499,Radiant
8be977dafef34618e543aa3cf874e61f,785,TRUE,1887,1102,
e38946275a7cef65386ab5482df84d17,433,TRUE,1556,1123,Radiant
502535071a05713085ea60e4aa22dfee,461,FALSE,3417,2956,Dire
38e5df045d467abb6f3a85bd9efd62d2,395,TRUE,3792,3397,Dire
b0519c939da9fcb6904b028c425add2c,690,FALSE,1125,435,
85112e462d7fc71bb78c098f18b8451d,696,TRUE,2159,1463,Radiant
4fc93877459b90a963fba8444a6d0ac4,2018,FALSE,2200,182,
59d6aa7ee4ac4c42d4353c30049a3254,1047,TRUE,3835,2788,Dire
5c64483d0f2934b7ec4d6356cac466a5,990,TRUE,2575,1585,Dire
5272d4f6413c2b1058167811fb8ea13c,1684,TRUE,4079,2395,Dire
afba16053073f7825cd56dab1835aa17,1348,TRUE,2219,871,
325ebcbfbbeb578ad09fbd097d4a20b8,806,TRUE,952,146,
59047c4eddb450daeb751a773dd787ae,58,FALSE,2304,2246,Dire
3f3c7b1fda672ca2d8777bf4977fbb2d,808,FALSE,2155,1347,
e6d321ff96bc908ff3650d08db9de6c4,671,TRUE,3552,2881,Dire
93bfe81f9b85f907c0ff5cb90dc0a1f5,1823,TRUE,2040,217,
e8433ffba34b33c67bb386a65e5699c4,681,TRUE,2244,1563,
05dfbbd85c2e9ecc666d8ee056a45327,996,FALSE,2306,1310,Dire
2820af43e6191fe63d8cb68938f9b439,1270,FALSE,2371,1101,Dire
769f6612d51f773eeb20c6d053ffb9d0,2151,FALSE,2834,683,
88c79f7060fba12edd4adadc25524e28,159,TRUE,1897,1738,Radiant
f21185ebd38e1336ad97e5fd13067d25,238,FALSE,1929,1691,
b6aa05bc8b006ca32cb3dec97b72cb11,237,TRUE,1847,1610,Radiant
8fae96974dda975301954c5be78a8007,1154,FALSE,2568,1414,Radiant
91b17db4390ed993cf0e0e314eba5116,1746,TRUE,2393,647,Dire
cd41ad83e5eab5a35c4b8c3680fb1d66,1495,TRUE,2877,1382,Radiant
c1552bb4d2da6cc67a1f801857863a3d,600,FALSE,2471,1871,Dire
74da363b4d70eb56b1d286cb7a45283b,1056,TRUE,3680,2624,Radiant
b57ce20e0aa39ffe8fa0d6d6b5456dab,1868,FALSE,2768,900,Dire
ea7c2cf760cd5e879cded6a418f61f6c,2187,TRUE,2527,340,Radiant
cd2d900f2886f4370698cdc6c38e165b,1103,TRUE,3764,2661,Radiant
7d274c0da8034ff4044218f1baaf472f,3593,TRUE,3991,398,Radiant
c649cad7020e973f9aa92214566d7f2a,1363,TRUE,2461,1098,Radiant
c15c490b33387cc321dd63ef8e29f86b,1621,FALSE,2626,1005,Dire
a2dcf9e5ce778fa3a2fc73cfdf24ca4e,404,TRUE,1796,1392,Dire
f834f79514ece20226fe285cfcc29eff,735,TRUE,1481,746,Dire
61ea230f1a1a6c7f2ab970885d41e96e,1938,FALSE,2110,172,
1e39699b67acc858182991fb8401d949,1654,TRUE,2276,622,
0f5183a43cc9b51afed8e430e8a65d2d,1974,TRUE,2229,255,
9ccbdec4c38543cd3682ee6a05e096ad,1530,TRUE,2084,554,Radiant
1385192cc33f50141e69aaed88209a12,2292,FALSE,3028,736,Dire
7894938285113b1b303343781a6b4876,111,TRUE,1999,1888,
a74669878d63ed6be402c152f17fa8a9,859,FALSE,2186,1327,
55f3d04ac9064918537a736b8cdec223,132,FALSE,1230,1098,
65c6eb906bb61a3b42586d9616f4dee8,211,FALSE,1437,1226,
b31c089780e58ced730afafd39097356,0,TRUE,2249,2249,Radiant
5b2244ad48ed4752733ca0b7bd0a3bbe,363,TRUE,2832,2469,Radiant
34c47d7b4b7fb59e5538946fd7ec4499,166,TRUE,1380,1214,Radiant
6445f5e7df2d846c05a98cb5beefb955,2096,FALSE,2817,721,Dire
85dee4c3bd8987381b9c30da10ff55f7,1351,TRUE,2362,1011,Radiant
7f247202b52d01f7cf5b0224e65e4c91,1007,FALSE,2150,1143,Dire
ba9fa5a9c34a7d44c54224355e032a4c,633,FALSE,2448,1815,Radiant
de81a39e59baea16c4ab088c1417a394,551,FALSE,1206,655,Dire
a33050c207234242a7d60ffa29fb0896,978,FALSE,2361,1383,Dire
9240cd9049f8c6ce742c1228b39a3257,316,TRUE,1063,747,
57c95b59d47cdba0faad703f25bcd1bc,1294,TRUE,1533,239,
9ef5afb4dabbe0655e1ffcb37914f6d5,2348,TRUE,2419,71,
5a8509a2075d4fb03f2a4ca5faa298c4,1805,TRUE,2564,759,
46116f2d79cdab0594004b19606fbc15,2682,TRUE,3145,463,
a00ed1046b5ca754a2c6abe45fe9d4d4,360,FALSE,2218,1858,Dire
13464bfc4f962a4c13cc3195f6d495af,917,FALSE,3477,2560,Radiant
a43d121d7112f2da6a84266fbb1e6034,2152,FALSE,2941,789,Dire
d0c9e8d4f77f22134560b46be4cf67cc,401,FALSE,1945,1544,Dire
1d1797a3b83306e261604ef18143fa44,1677,TRUE,2104,427,
807c89ba0b6b8794ab9d2be0fdc4205e,1795,FALSE,1974,179,
fd22a823f18c091e8bab821651cd55e8,1393,FALSE,2307,914,Dire
9b7a8f46b19b82affdfc9c954ae2fc7e,474,FALSE,3411,2937,Dire
36c5f0ab2c92288fcdafca84726081f6,2203,FALSE,2308,105,
7b8d3c44a367107f24323d27c96e9212,1055,FALSE,2267,1212,
